1100,서울특별시,종로구가선거구,6110101,1101,종로구,합계,,33865,19850,5117,4050,6285,3033,18485,1365,14015
1100,서울특별시,종로구가선거구,6110101,1101,종로구,거소투표,,44,43,13,8,14,5,40,3,1
1100,서울특별시,종로구가선거구,6110101,1101,종로구,관외사전투표,,2044,2042,619,393,659,218,1889,153,2
1100,서울특별시,종로구가선거구,6110101,1101,종로구,청운효자동,계,9179,4884,1433,1132,1330,663,4558,326,4295
1100,서울특별시,종로구가선거구,6110101,1101,종로구,청운효자동,관내사전투표,1732,1730,575,418,411,205,1609,121,2
1100,서울특별시,종로구가선거구,6110101,1101,종로구,청운효자동,선거일투표,7447,3154,858,714,919,458,2949,205,4293
1100,서울특별시,종로구가선거구,6110101,1101,종로구,사직동,계,8057,4446,934,947,1540,702,4123,323,3611
1100,서울특별시,종로구가선거구,6110101,1101,종로구,사직동,관내사전투표,1699,1696,423,454,469,235,1581,115,3
1100,서울특별시,종로구가선거구,6110101,1101,종로구,사직동,선거일투표,6358,2750,511,493,1071,467,2542,208,3608
1100,서울특별시,종로구가선거구,6110101,1101,종로구,무악동,계,6417,3796,942,717,1315,561,3535,261,2621
1100,서울특별시,종로구가선거구,6110101,1101,종로구,무악동,관내사전투표,1540,1540,415,313,480,204,1412,128,0
1100,서울특별시,종로구가선거구,6110101,1101,종로구,무악동,선거일투표,4877,2256,527,404,835,357,2123,133,2621
1100,서울특별시,종로구가선거구,6110101,1101,종로구,교남동,계,8124,4631,1174,852,1427,881,4334,297,3493
1100,서울특별시,종로구가선거구,6110101,1101,종로구,교남동,관내사전투표,1683,1680,480,351,452,282,1565,115,3
1100,서울특별시,종로구가선거구,6110101,1101,종로구,교남동,선거일투표,6441,2951,694,501,975,599,2769,182,3490
1100,서울특별시,종로구가선거구,6110101,1101,종로구,잘못 투입·구분된 투표지,,0,8,2,1,0,3,6,2,-8
1100,서울특별시,종로구나선거구,6110102,1101,종로구,합계,,29875,16955,7358,7519,1759,16636,319,12920
1100,서울특별시,종로구나선거구,6110102,1101,종로구,거소투표,,35,35,11,15,4,30,5,0
1100,서울특별시,종로구나선거구,6110102,1101,종로구,관외사전투표,,1931,1931,954,784,153,1891,40,0
1100,서울특별시,종로구나선거구,6110102,1101,종로구,삼청동,계,1962,1000,433,456,93,982,18,962
1100,서울특별시,종로구나선거구,6110102,1101,종로구,삼청동,관내사전투표,319,315,166,123,20,309,6,4
1100,서울특별시,종로구나선거구,6110102,1101,종로구,삼청동,선거일투표,1643,685,267,333,73,673,12,958
1100,서울특별시,종로구나선거구,6110102,1101,종로구,부암동,계,7693,4132,2004,1644,414,4062,70,3561
1100,서울특별시,종로구나선거구,6110102,1101,종로구,부암동,관내사전투표,1233,1230,646,452,106,1204,26,3
1100,서울특별시,종로구나선거구,6110102,1101,종로구,부암동,선거일투표,6460,2902,1358,1192,308,2858,44,3558
1100,서울특별시,종로구나선거구,6110102,1101,종로구,평창동,계,14730,7928,3008,3864,911,7783,145,6802
1100,서울특별시,종로구나선거구,6110102,1101,종로구,평창동,관내사전투표,2449,2448,1073,1078,240,2391,57,1
1100,서울특별시,종로구나선거구,6110102,1101,종로구,평창동,선거일투표,12281,5480,1935,2786,671,5392,88,6801
1100,서울특별시,종로구나선거구,6110102,1101,종로구,가회동,계,3524,1917,943,750,183,1876,41,1607
1100,서울특별시,종로구나선거구,6110102,1101,종로구,가회동,관내사전투표,884,882,475,306,80,861,21,2
1100,서울특별시,종로구나선거구,6110102,1101,종로구,가회동,선거일투표,2640,1035,468,444,103,1015,20,1605
1100,서울특별시,종로구나선거구,6110102,1101,종로구,잘못 투입·구분된 투표지,,0,12,5,6,1,12,0,-12
1100,서울특별시,종로구다선거구,6110103,1101,종로구,합계,,28555,14948,3807,3583,3782,2739,13911,1037,13607
1100,서울특별시,종로구다선거구,6110103,1101,종로구,거소투표,,42,40,7,7,10,6,30,10,2
1100,서울특별시,종로구다선거구,6110103,1101,종로구,관외사전투표,,1937,1935,534,383,600,272,1789,146,2
1100,서울특별시,종로구다선거구,6110103,1101,종로구,종로1·2·3·4가동,계,6253,2471,665,381,839,395,2280,191,3782
1100,서울특별시,종로구다선거구,6110103,1101,종로구,종로1·2·3·4가동,관내사전투표,857,855,241,149,249,114,753,102,2
1100,서울특별시,종로구다선거구,6110103,1101,종로구,종로1·2·3·4가동,선거일투표,5396,1616,424,232,590,281,1527,89,3780
1100,서울특별시,종로구다선거구,6110103,1101,종로구,이화동,계,6313,3082,819,771,560,748,2898,184,3231
1100,서울특별시,종로구다선거구,6110103,1101,종로구,이화동,관내사전투표,1162,1161,324,309,170,272,1075,86,1
1100,서울특별시,종로구다선거구,6110103,1101,종로구,이화동,선거일투표,5151,1921,495,462,390,476,1823,98,3230
1100,서울특별시,종로구다선거구,6110103,1101,종로구,혜화동,계,14010,7406,1775,2040,1771,1315,6901,505,6604
1100,서울특별시,종로구다선거구,6110103,1101,종로구,혜화동,관내사전투표,2905,2898,699,891,643,487,2720,178,7
1100,서울특별시,종로구다선거구,6110103,1101,종로구,혜화동,선거일투표,11105,4508,1076,1149,1128,828,4181,327,6597
1100,서울특별시,종로구다선거구,6110103,1101,종로구,잘못 투입·구분된 투표지,,0,14,7,1,2,3,13,1,-14
1100,서울특별시,종로구라선거구,6110104,1101,종로구,합계,,37521,18887,6305,3295,5555,2377,17532,1355,18634
1100,서울특별시,종로구라선거구,6110104,1101,종로구,거소투표,,33,29,8,0,14,1,23,6,4
1100,서울특별시,종로구라선거구,6110104,1101,종로구,관외사전투표,,2157,2156,786,355,700,175,2016,140,1
1100,서울특별시,종로구라선거구,6110104,1101,종로구,종로5·6가동,계,4426,1917,627,251,624,248,1750,167,2509
1100,서울특별시,종로구라선거구,6110104,1101,종로구,종로5·6가동,관내사전투표,657,654,249,91,188,67,595,59,3
1100,서울특별시,종로구라선거구,6110104,1101,종로구,종로5·6가동,선거일투표,3769,1263,378,160,436,181,1155,108,2506
1100,서울특별시,종로구라선거구,6110104,1101,종로구,창신제1동,계,4952,2659,852,451,638,501,2442,217,2293
1100,서울특별시,종로구라선거구,6110104,1101,종로구,창신제1동,관내사전투표,1406,1403,488,247,323,220,1278,125,3
1100,서울특별시,종로구라선거구,6110104,1101,종로구,창신제1동,선거일투표,3546,1256,364,204,315,281,1164,92,2290
1100,서울특별시,종로구라선거구,6110104,1101,종로구,창신제2동,계,6772,3042,1237,503,801,326,2867,175,3730
1100,서울특별시,종로구라선거구,6110104,1101,종로구,창신제2동,관내사전투표,794,794,357,147,171,71,746,48,0
1100,서울특별시,종로구라선거구,6110104,1101,종로구,창신제2동,선거일투표,5978,2248,880,356,630,255,2121,127,3730
1100,서울특별시,종로구라선거구,6110104,1101,종로구,창신제3동,계,5484,2947,884,580,870,411,2745,202,2537
1100,서울특별시,종로구라선거구,6110104,1101,종로구,창신제3동,관내사전투표,1214,1205,386,271,306,153,1116,89,9
1100,서울특별시,종로구라선거구,6110104,1101,종로구,창신제3동,선거일투표,4270,1742,498,309,564,258,1629,113,2528
1100,서울특별시,종로구라선거구,6110104,1101,종로구,숭인제1동,계,4987,2440,647,551,709,374,2281,159,2547
1100,서울특별시,종로구라선거구,6110104,1101,종로구,숭인제1동,관내사전투표,1028,1027,267,275,270,132,944,83,1
1100,서울특별시,종로구라선거구,6110104,1101,종로구,숭인제1동,선거일투표,3959,1413,380,276,439,242,1337,76,2546
1100,서울특별시,종로구라선거구,6110104,1101,종로구,숭인제2동,계,8710,3679,1259,599,1197,336,3391,288,5031
1100,서울특별시,종로구라선거구,6110104,1101,종로구,숭인제2동,관내사전투표,1389,1388,489,248,407,122,1266,122,1
1100,서울특별시,종로구라선거구,6110104,1101,종로구,숭인제2동,선거일투표,7321,2291,770,351,790,214,2125,166,5030
1100,서울특별시,종로구라선거구,6110104,1101,종로구,잘못 투입·구분된 투표지,,0,18,5,5,2,5,17,1,-18
1100,서울특별시,중구가선거구,6110201,1102,중구,검색된 결과가 없습니다.
1100,서울특별시,중구나선거구,6110202,1102,중구,합계,,30134,15673,3731,4280,7175,15186,487,14461
1100,서울특별시,중구나선거구,6110202,1102,중구,거소투표,,19,19,2,3,10,15,4,0
1100,서울특별시,중구나선거구,6110202,1102,중구,관외사전투표,,1640,1636,426,404,763,1593,43,4
1100,서울특별시,중구나선거구,6110202,1102,중구,신당제5동,계,8896,4361,1053,1389,1794,4236,125,4535
1100,서울특별시,중구나선거구,6110202,1102,중구,신당제5동,관내사전투표,1894,1891,436,664,729,1829,62,3
1100,서울특별시,중구나선거구,6110202,1102,중구,신당제5동,선거일투표,7002,2470,617,725,1065,2407,63,4532
1100,서울특별시,중구나선거구,6110202,1102,중구,동화동,계,8502,4830,1026,1261,2429,4716,114,3672
1100,서울특별시,중구나선거구,6110202,1102,중구,동화동,관내사전투표,1907,1905,438,548,877,1863,42,2
1100,서울특별시,중구나선거구,6110202,1102,중구,동화동,선거일투표,6595,2925,588,713,1552,2853,72,3670
1100,서울특별시,중구나선거구,6110202,1102,중구,황학동,계,11077,4808,1221,1215,2172,4608,200,6269
1100,서울특별시,중구나선거구,6110202,1102,중구,황학동,관내사전투표,1513,1504,400,412,619,1431,73,9
1100,서울특별시,중구나선거구,6110202,1102,중구,황학동,선거일투표,9564,3304,821,803,1553,3177,127,6260
1100,서울특별시,중구나선거구,6110202,1102,중구,잘못 투입·구분된 투표지,,0,19,3,8,7,18,1,-19
1100,서울특별시,중구다선거구,6110203,1102,중구,합계,,25350,13181,4321,1831,6623,12775,406,12169
1100,서울특별시,중구다선거구,6110203,1102,중구,거소투표,,26,26,7,6,12,25,1,0
1100,서울특별시,중구다선거구,6110203,1102,중구,관외사전투표,,2030,2028,774,299,893,1966,62,2
1100,서울특별시,중구다선거구,6110203,1102,중구,회현동,계,4266,2003,494,246,1191,1931,72,2263
1100,서울특별시,중구다선거구,6110203,1102,중구,회현동,관내사전투표,711,711,177,100,418,695,16,0
1100,서울특별시,중구다선거구,6110203,1102,중구,회현동,선거일투표,3555,1292,317,146,773,1236,56,2263
1100,서울특별시,중구다선거구,6110203,1102,중구,필동,계,3612,1846,612,241,951,1804,42,1766
1100,서울특별시,중구다선거구,6110203,1102,중구,필동,관내사전투표,791,789,278,120,373,771,18,2
1100,서울특별시,중구다선거구,6110203,1102,중구,필동,선거일투표,2821,1057,334,121,578,1033,24,1764
1100,서울특별시,중구다선거구,6110203,1102,중구,장충동,계,4025,1865,631,240,939,1810,55,2160
1100,서울특별시,중구다선거구,6110203,1102,중구,장충동,관내사전투표,641,640,263,84,271,618,22,1
1100,서울특별시,중구다선거구,6110203,1102,중구,장충동,선거일투표,3384,1225,368,156,668,1192,33,2159
1100,서울특별시,중구다선거구,6110203,1102,중구,다산동,계,11391,5406,1799,798,2635,5232,174,5985
1100,서울특별시,중구다선거구,6110203,1102,중구,다산동,관내사전투표,1772,1772,625,274,811,1710,62,0
1100,서울특별시,중구다선거구,6110203,1102,중구,다산동,선거일투표,9619,3634,1174,524,1824,3522,112,5985
1100,서울특별시,중구다선거구,6110203,1102,중구,잘못 투입·구분된 투표지,,0,7,4,1,2,7,0,-7
1100,서울특별시,중구라선거구,6110204,1102,중구,합계,,27140,16027,5209,2546,7790,15545,482,11113
1100,서울특별시,중구라선거구,6110204,1102,중구,거소투표,,90,84,14,9,55,78,6,6
1100,서울특별시,중구라선거구,6110204,1102,중구,관외사전투표,,1791,1789,666,249,825,1740,49,2
1100,서울특별시,중구라선거구,6110204,1102,중구,약수동,계,13983,7736,2522,1098,3895,7515,221,6247
1100,서울특별시,중구라선거구,6110204,1102,중구,약수동,관내사전투표,2248,2238,797,337,1052,2186,52,10
1100,서울특별시,중구라선거구,6110204,1102,중구,약수동,선거일투표,11735,5498,1725,761,2843,5329,169,6237
1100,서울특별시,중구라선거구,6110204,1102,중구,청구동,계,11276,6404,2001,1188,3009,6198,206,4872
1100,서울특별시,중구라선거구,6110204,1102,중구,청구동,관내사전투표,1663,1662,576,376,665,1617,45,1
1100,서울특별시,중구라선거구,6110204,1102,중구,청구동,선거일투표,9613,4742,1425,812,2344,4581,161,4871
1100,서울특별시,중구라선거구,6110204,1102,중구,잘못 투입·구분된 투표지,,0,14,6,2,6,14,0,-14
1100,서울특별시,용산구가선거구,6110301,1103,용산구,검색된 결과가 없습니다.
1100,서울특별시,용산구나선거구,6110302,1103,용산구,합계,,36745,20255,7223,10529,2005,19757,498,16490
1100,서울특별시,용산구나선거구,6110302,1103,용산구,거소투표,,35,33,7,16,7,30,3,2
1100,서울특별시,용산구나선거구,6110302,1103,용산구,관외사전투표,,2373,2364,927,1216,186,2329,35,9
1100,서울특별시,용산구나선거구,6110302,1103,용산구,원효로제1동,계,13195,6569,2232,3522,664,6418,151,6626
1100,서울특별시,용산구나선거구,6110302,1103,용산구,원효로제1동,관내사전투표,2290,2289,918,1142,212,2272,17,1
1100,서울특별시,용산구나선거구,6110302,1103,용산구,원효로제1동,선거일투표,10905,4280,1314,2380,452,4146,134,6625
1100,서울특별시,용산구나선거구,6110302,1103,용산구,원효로제2동,계,11107,5829,2032,3021,610,5663,166,5278
1100,서울특별시,용산구나선거구,6110302,1103,용산구,원효로제2동,관내사전투표,1823,1823,723,879,190,1792,31,0
1100,서울특별시,용산구나선거구,6110302,1103,용산구,원효로제2동,선거일투표,9284,4006,1309,2142,420,3871,135,5278
1100,서울특별시,용산구나선거구,6110302,1103,용산구,용문동,계,10035,5447,2021,2747,537,5305,142,4588
1100,서울특별시,용산구나선거구,6110302,1103,용산구,용문동,관내사전투표,2093,2093,883,988,182,2053,40,0
1100,서울특별시,용산구나선거구,6110302,1103,용산구,용문동,선거일투표,7942,3354,1138,1759,355,3252,102,4588
1100,서울특별시,용산구나선거구,6110302,1103,용산구,잘못 투입·구분된 투표지,,0,13,4,7,1,12,1,-13
1100,서울특별시,용산구다선거구,6110303,1103,용산구,합계,,48139,27838,6927,18956,1369,27252,586,20301
1100,서울특별시,용산구다선거구,6110303,1103,용산구,거소투표,,30,28,6,19,1,26,2,2
1100,서울특별시,용산구다선거구,6110303,1103,용산구,관외사전투표,,3086,3078,1050,1867,118,3035,43,8
1100,서울특별시,용산구다선거구,6110303,1103,용산구,한강로동,계,17707,8865,2399,5892,393,8684,181,8842
1100,서울특별시,용산구다선거구,6110303,1103,용산구,한강로동,관내사전투표,2078,2077,592,1366,79,2037,40,1
1100,서울특별시,용산구다선거구,6110303,1103,용산구,한강로동,선거일투표,15629,6788,1807,4526,314,6647,141,8841
1100,서울특별시,용산구다선거구,6110303,1103,용산구,이촌제1동,계,20422,11820,2220,8826,553,11599,221,8602
1100,서울특별시,용산구다선거구,6110303,1103,용산구,이촌제1동,관내사전투표,4253,4242,961,3077,172,4210,32,11
1100,서울특별시,용산구다선거구,6110303,1103,용산구,이촌제1동,선거일투표,16169,7578,1259,5749,381,7389,189,8591
1100,서울특별시,용산구다선거구,6110303,1103,용산구,이촌제2동,계,6894,4022,1243,2339,303,3885,137,2872
1100,서울특별시,용산구다선거구,6110303,1103,용산구,이촌제2동,관내사전투표,1299,1297,464,711,89,1264,33,2
1100,서울특별시,용산구다선거구,6110303,1103,용산구,이촌제2동,선거일투표,5595,2725,779,1628,214,2621,104,2870
1100,서울특별시,용산구다선거구,6110303,1103,용산구,잘못 투입·구분된 투표지,,0,25,9,13,1,23,2,-25
1100,서울특별시,용산구라선거구,6110304,1103,용산구,합계,,31994,16175,6804,7117,1899,15820,355,15819
1100,서울특별시,용산구라선거구,6110304,1103,용산구,거소투표,,37,36,13,14,5,32,4,1
1100,서울특별시,용산구라선거구,6110304,1103,용산구,관외사전투표,,2038,2033,956,898,139,1993,40,5
1100,서울특별시,용산구라선거구,6110304,1103,용산구,후암동,계,13814,6748,2823,2686,1102,6611,137,7066
1100,서울특별시,용산구라선거구,6110304,1103,용산구,후암동,관내사전투표,2547,2546,1153,935,398,2486,60,1
1100,서울특별시,용산구라선거구,6110304,1103,용산구,후암동,선거일투표,11267,4202,1670,1751,704,4125,77,7065
1100,서울특별시,용산구라선거구,6110304,1103,용산구,용산2가동,계,8328,3902,1698,1682,437,3817,85,4426
1100,서울특별시,용산구라선거구,6110304,1103,용산구,용산2가동,관내사전투표,1589,1587,730,656,175,1561,26,2
1100,서울특별시,용산구라선거구,6110304,1103,용산구,용산2가동,선거일투표,6739,2315,968,1026,262,2256,59,4424
1100,서울특별시,용산구라선거구,6110304,1103,용산구,이태원제2동,계,7777,3447,1310,1834,216,3360,87,4330
1100,서울특별시,용산구라선거구,6110304,1103,용산구,이태원제2동,관내사전투표,1133,1131,525,513,77,1115,16,2
1100,서울특별시,용산구라선거구,6110304,1103,용산구,이태원제2동,선거일투표,6644,2316,785,1321,139,2245,71,4328
1100,서울특별시,용산구라선거구,6110304,1103,용산구,잘못 투입·구분된 투표지,,0,9,4,3,0,7,2,-9
1100,서울특별시,용산구마선거구,6110305,1103,용산구,합계,,47895,23401,4645,2299,9103,3890,2388,110,22435,966,24494
1100,서울특별시,용산구마선거구,6110305,1103,용산구,거소투표,,52,47,13,3,17,5,3,0,41,6,5
1100,서울특별시,용산구마선거구,6110305,1103,용산구,관외사전투표,,3217,3194,726,304,1287,477,208,9,3011,183,23
1100,서울특별시,용산구마선거구,6110305,1103,용산구,이태원제1동,계,5623,2534,502,235,955,431,305,7,2435,99,3089
1100,서울특별시,용산구마선거구,6110305,1103,용산구,이태원제1동,관내사전투표,733,733,162,102,231,112,95,2,704,29,0
1100,서울특별시,용산구마선거구,6110305,1103,용산구,이태원제1동,선거일투표,4890,1801,340,133,724,319,210,5,1731,70,3089
1100,서울특별시,용산구마선거구,6110305,1103,용산구,한남동,계,16788,6830,1251,582,2834,1224,610,38,6539,291,9958
1100,서울특별시,용산구마선거구,6110305,1103,용산구,한남동,관내사전투표,1813,1813,404,194,694,261,166,9,1728,85,0
1100,서울특별시,용산구마선거구,6110305,1103,용산구,한남동,선거일투표,14975,5017,847,388,2140,963,444,29,4811,206,9958
1100,서울특별시,용산구마선거구,6110305,1103,용산구,서빙고동,계,10145,5194,824,394,2292,997,473,27,5007,187,4951
1100,서울특별시,용산구마선거구,6110305,1103,용산구,서빙고동,관내사전투표,1208,1207,251,143,482,154,132,5,1167,40,1
1100,서울특별시,용산구마선거구,6110305,1103,용산구,서빙고동,선거일투표,8937,3987,573,251,1810,843,341,22,3840,147,4950
1100,서울특별시,용산구마선거구,6110305,1103,용산구,보광동,계,12070,5578,1323,779,1708,752,788,29,5379,199,6492
1100,서울특별시,용산구마선거구,6110305,1103,용산구,보광동,관내사전투표,2184,2183,526,344,664,267,295,5,2101,82,1
1100,서울특별시,용산구마선거구,6110305,1103,용산구,보광동,선거일투표,9886,3395,797,435,1044,485,493,24,3278,117,6491
1100,서울특별시,용산구마선거구,6110305,1103,용산구,잘못 투입·구분된 투표지,,0,24,6,2,10,4,1,0,23,1,-24
1100,서울특별시,성동구가선거구,6110401,1104,성동구,합계,,67367,38077,9782,7157,12959,5543,35441,2636,29290
1100,서울특별시,성동구가선거구,6110401,1104,성동구,거소투표,,42,38,12,3,11,8,34,4,4
1100,서울특별시,성동구가선거구,6110401,1104,성동구,관외사전투표,,3832,3829,1165,624,1307,442,3538,291,3
1100,서울특별시,성동구가선거구,6110401,1104,성동구,금호1가동,계,12053,6343,1787,1218,1952,980,5937,406,5710
1100,서울특별시,성동구가선거구,6110401,1104,성동구,금호1가동,관내사전투표,1779,1771,559,393,500,221,1673,98,8
1100,서울특별시,성동구가선거구,6110401,1104,성동구,금호1가동,선거일투표,10274,4572,1228,825,1452,759,4264,308,5702
1100,서울특별시,성동구가선거구,6110401,1104,성동구,금호2·3가동,계,18399,9510,2621,1932,2949,1339,8841,669,8889
1100,서울특별시,성동구가선거구,6110401,1104,성동구,금호2·3가동,관내사전투표,3054,3041,942,687,852,343,2824,217,13
1100,서울특별시,성동구가선거구,6110401,1104,성동구,금호2·3가동,선거일투표,15345,6469,1679,1245,2097,996,6017,452,8876
1100,서울특별시,성동구가선거구,6110401,1104,성동구,금호4가동,계,12087,6825,1861,1263,2208,1012,6344,481,5262
1100,서울특별시,성동구가선거구,6110401,1104,성동구,금호4가동,관내사전투표,2617,2614,832,541,712,333,2418,196,3
1100,서울특별시,성동구가선거구,6110401,1104,성동구,금호4가동,선거일투표,9470,4211,1029,722,1496,679,3926,285,5259
1100,서울특별시,성동구가선거구,6110401,1104,성동구,옥수동,계,20954,11501,2329,2110,4527,1756,10722,779,9453
1100,서울특별시,성동구가선거구,6110401,1104,성동구,옥수동,관내사전투표,3076,3073,689,624,1143,419,2875,198,3
1100,서울특별시,성동구가선거구,6110401,1104,성동구,옥수동,선거일투표,17878,8428,1640,1486,3384,1337,7847,581,9450
1100,서울특별시,성동구가선거구,6110401,1104,성동구,잘못 투입·구분된 투표지,,0,31,7,7,5,6,25,6,-31
1100,서울특별시,성동구나선거구,6110402,1104,성동구,합계,,69763,40155,9347,7191,11729,5635,4263,38165,1990,29608
1100,서울특별시,성동구나선거구,6110402,1104,성동구,거소투표,,70,65,19,12,20,6,2,59,6,5
1100,서울특별시,성동구나선거구,6110402,1104,성동구,관외사전투표,,4446,4434,1189,860,1360,487,320,4216,218,12
1100,서울특별시,성동구나선거구,6110402,1104,성동구,왕십리도선동,계,21626,11195,2636,1815,3586,1649,903,10589,606,10431
1100,서울특별시,성동구나선거구,6110402,1104,성동구,왕십리도선동,관내사전투표,3200,3198,803,572,957,402,289,3023,175,2
1100,서울특별시,성동구나선거구,6110402,1104,성동구,왕십리도선동,선거일투표,18426,7997,1833,1243,2629,1247,614,7566,431,10429
1100,서울특별시,성동구나선거구,6110402,1104,성동구,왕십리제2동,계,13834,7492,1979,1403,1949,950,858,7139,353,6342
1100,서울특별시,성동구나선거구,6110402,1104,성동구,왕십리제2동,관내사전투표,2647,2639,772,604,566,309,275,2526,113,8
1100,서울특별시,성동구나선거구,6110402,1104,성동구,왕십리제2동,선거일투표,11187,4853,1207,799,1383,641,583,4613,240,6334
1100,서울특별시,성동구나선거구,6110402,1104,성동구,행당제1동,계,11433,6282,1405,1127,2025,910,527,5994,288,5151
1100,서울특별시,성동구나선거구,6110402,1104,성동구,행당제1동,관내사전투표,2027,2024,490,427,586,263,160,1926,98,3
1100,서울특별시,성동구나선거구,6110402,1104,성동구,행당제1동,선거일투표,9406,4258,915,700,1439,647,367,4068,190,5148
1100,서울특별시,성동구나선거구,6110402,1104,성동구,행당제2동,계,18354,10654,2113,1966,2778,1630,1650,10137,517,7700
1100,서울특별시,성동구나선거구,6110402,1104,성동구,행당제2동,관내사전투표,3412,3404,739,703,809,495,492,3238,166,8
1100,서울특별시,성동구나선거구,6110402,1104,성동구,행당제2동,선거일투표,14942,7250,1374,1263,1969,1135,1158,6899,351,7692
1100,서울특별시,성동구나선거구,6110402,1104,성동구,잘못 투입·구분된 투표지,,0,33,6,8,11,3,3,31,2,-33
1100,서울특별시,성동구다선거구,6110403,1104,성동구,합계,,51928,26625,9712,4190,8015,2822,24739,1886,25303
1100,서울특별시,성동구다선거구,6110403,1104,성동구,거소투표,,58,57,31,10,10,3,54,3,1
1100,서울특별시,성동구다선거구,6110403,1104,성동구,관외사전투표,,3430,3429,1376,494,1079,230,3179,250,1
1100,서울특별시,성동구다선거구,6110403,1104,성동구,마장동,계,18801,9819,3701,1458,3000,984,9143,676,8982
1100,서울특별시,성동구다선거구,6110403,1104,성동구,마장동,관내사전투표,2841,2833,1159,491,742,252,2644,189,8
1100,서울특별시,성동구다선거구,6110403,1104,성동구,마장동,선거일투표,15960,6986,2542,967,2258,732,6499,487,8974
1100,서울특별시,성동구다선거구,6110403,1104,성동구,사근동,계,10310,4407,1497,644,1220,741,4102,305,5903
1100,서울특별시,성동구다선거구,6110403,1104,성동구,사근동,관내사전투표,1397,1392,488,258,311,245,1302,90,5
1100,서울특별시,성동구다선거구,6110403,1104,성동구,사근동,선거일투표,8913,3015,1009,386,909,496,2800,215,5898
1100,서울특별시,성동구다선거구,6110403,1104,성동구,송정동,계,9036,4224,1512,571,1430,398,3911,313,4812
1100,서울특별시,성동구다선거구,6110403,1104,성동구,송정동,관내사전투표,1491,1479,552,229,457,135,1373,106,12
1100,서울특별시,성동구다선거구,6110403,1104,성동구,송정동,선거일투표,7545,2745,960,342,973,263,2538,207,4800
1100,서울특별시,성동구다선거구,6110403,1104,성동구,용답동,계,10293,4658,1582,1008,1265,465,4320,338,5635
1100,서울특별시,성동구다선거구,6110403,1104,성동구,용답동,관내사전투표,1838,1835,678,422,442,162,1704,131,3
1100,서울특별시,성동구다선거구,6110403,1104,성동구,용답동,선거일투표,8455,2823,904,586,823,303,2616,207,5632
1100,서울특별시,성동구다선거구,6110403,1104,성동구,잘못 투입·구분된 투표지,,0,31,13,5,11,1,30,1,-31
1100,서울특별시,성동구라선거구,6110404,1104,성동구,합계,,62932,34880,7459,7767,9947,5924,1178,612,32887,1993,28052
1100,서울특별시,성동구라선거구,6110404,1104,성동구,거소투표,,67,66,17,15,17,6,3,0,58,8,1
1100,서울특별시,성동구라선거구,6110404,1104,성동구,관외사전투표,,3434,3432,813,757,1041,485,74,33,3203,229,2
1100,서울특별시,성동구라선거구,6110404,1104,성동구,응봉동,계,11984,6688,1474,1627,1823,1151,119,101,6295,393,5296
1100,서울특별시,성동구라선거구,6110404,1104,성동구,응봉동,관내사전투표,2413,2413,601,626,645,330,43,32,2277,136,0
1100,서울특별시,성동구라선거구,6110404,1104,성동구,응봉동,선거일투표,9571,4275,873,1001,1178,821,76,69,4018,257,5296
1100,서울특별시,성동구라선거구,6110404,1104,성동구,성수1가제1동,계,13170,6494,1341,1319,1970,1134,245,128,6137,357,6676
1100,서울특별시,성동구라선거구,6110404,1104,성동구,성수1가제1동,관내사전투표,1890,1888,456,426,529,244,75,55,1785,103,2
1100,서울특별시,성동구라선거구,6110404,1104,성동구,성수1가제1동,선거일투표,11280,4606,885,893,1441,890,170,73,4352,254,6674
1100,서울특별시,성동구라선거구,6110404,1104,성동구,성수1가제2동,계,11131,6476,1344,1559,1757,1148,213,108,6129,347,4655
1100,서울특별시,성동구라선거구,6110404,1104,성동구,성수1가제2동,관내사전투표,2378,2378,535,594,626,392,75,37,2259,119,0
1100,서울특별시,성동구라선거구,6110404,1104,성동구,성수1가제2동,선거일투표,8753,4098,809,965,1131,756,138,71,3870,228,4655
1100,서울특별시,성동구라선거구,6110404,1104,성동구,성수2가제1동,계,13848,6870,1523,1415,1947,1087,415,101,6488,382,6978
1100,서울특별시,성동구라선거구,6110404,1104,성동구,성수2가제1동,관내사전투표,2902,2900,708,626,786,417,158,44,2739,161,2
1100,서울특별시,성동구라선거구,6110404,1104,성동구,성수2가제1동,선거일투표,10946,3970,815,789,1161,670,257,57,3749,221,6976
1100,서울특별시,성동구라선거구,6110404,1104,성동구,성수2가제3동,계,9298,4846,945,1075,1388,913,109,141,4571,275,4452
1100,서울특별시,성동구라선거구,6110404,1104,성동구,성수2가제3동,관내사전투표,1829,1828,395,479,496,273,34,47,1724,104,1
1100,서울특별시,성동구라선거구,6110404,1104,성동구,성수2가제3동,선거일투표,7469,3018,550,596,892,640,75,94,2847,171,4451
1100,서울특별시,성동구라선거구,6110404,1104,성동구,잘못 투입·구분된 투표지,,0,8,2,0,4,0,0,0,6,2,-8
1100,서울특별시,광진구가선거구,6110501,1105,광진구,합계,,74173,36587,10298,4999,9213,5049,5220,34779,1808,37586
1100,서울특별시,광진구가선거구,6110501,1105,광진구,거소투표,,74,70,17,7,18,7,10,59,11,4
1100,서울특별시,광진구가선거구,6110501,1105,광진구,관외사전투표,,3732,3722,1282,518,1075,331,317,3523,199,10
1100,서울특별시,광진구가선거구,6110501,1105,광진구,중곡제1동,계,13402,5959,1906,871,1563,849,484,5673,286,7443
1100,서울특별시,광진구가선거구,6110501,1105,광진구,중곡제1동,관내사전투표,2166,2149,733,337,509,300,167,2046,103,17
1100,서울특별시,광진구가선거구,6110501,1105,광진구,중곡제1동,선거일투표,11236,3810,1173,534,1054,549,317,3627,183,7426
1100,서울특별시,광진구가선거구,6110501,1105,광진구,중곡제2동,계,18232,8149,2311,1193,1971,1361,931,7767,382,10083
1100,서울특별시,광진구가선거구,6110501,1105,광진구,중곡제2동,관내사전투표,2932,2921,875,477,643,473,321,2789,132,11
1100,서울특별시,광진구가선거구,6110501,1105,광진구,중곡제2동,선거일투표,15300,5228,1436,716,1328,888,610,4978,250,10072
1100,서울특별시,광진구가선거구,6110501,1105,광진구,중곡제3동,계,14051,6430,1807,934,1730,1006,606,6083,347,7621
1100,서울특별시,광진구가선거구,6110501,1105,광진구,중곡제3동,관내사전투표,2200,2197,664,334,547,344,181,2070,127,3
1100,서울특별시,광진구가선거구,6110501,1105,광진구,중곡제3동,선거일투표,11851,4233,1143,600,1183,662,425,4013,220,7618
1100,서울특별시,광진구가선거구,6110501,1105,광진구,중곡제4동,계,24682,12213,2964,1469,2844,1491,2865,11633,580,12469
1100,서울특별시,광진구가선거구,6110501,1105,광진구,중곡제4동,관내사전투표,4282,4274,1124,506,969,468,980,4047,227,8
1100,서울특별시,광진구가선거구,6110501,1105,광진구,중곡제4동,선거일투표,20400,7939,1840,963,1875,1023,1885,7586,353,12461
1100,서울특별시,광진구가선거구,6110501,1105,광진구,잘못 투입·구분된 투표지,,0,44,11,7,12,4,7,41,3,-44
1100,서울특별시,광진구나선거구,6110502,1105,광진구,합계,,78739,41997,12058,6019,13580,6139,2106,39902,2095,36742
1100,서울특별시,광진구나선거구,6110502,1105,광진구,거소투표,,86,83,20,10,33,12,1,76,7,3
1100,서울특별시,광진구나선거구,6110502,1105,광진구,관외사전투표,,4880,4866,1621,694,1565,505,251,4636,230,14
1100,서울특별시,광진구나선거구,6110502,1105,광진구,능동,계,9956,4852,1564,677,1489,500,352,4582,270,5104
1100,서울특별시,광진구나선거구,6110502,1105,광진구,능동,관내사전투표,1703,1700,594,285,447,170,112,1608,92,3
1100,서울특별시,광진구나선거구,6110502,1105,광진구,능동,선거일투표,8253,3152,970,392,1042,330,240,2974,178,5101
1100,서울특별시,광진구나선거구,6110502,1105,광진구,구의제2동,계,21542,10556,3361,1647,3271,1234,462,9975,581,10986
1100,서울특별시,광진구나선거구,6110502,1105,광진구,구의제2동,관내사전투표,2883,2842,995,540,743,297,106,2681,161,41
1100,서울특별시,광진구나선거구,6110502,1105,광진구,구의제2동,선거일투표,18659,7714,2366,1107,2528,937,356,7294,420,10945
1100,서울특별시,광진구나선거구,6110502,1105,광진구,광장동,계,25293,14046,3186,1956,4611,3167,483,13403,643,11247
1100,서울특별시,광진구나선거구,6110502,1105,광진구,광장동,관내사전투표,3580,3567,917,541,1059,765,133,3415,152,13
1100,서울특별시,광진구나선거구,6110502,1105,광진구,광장동,선거일투표,21713,10479,2269,1415,3552,2402,350,9988,491,11234
1100,서울특별시,광진구나선거구,6110502,1105,광진구,군자동,계,16982,7512,2280,1020,2590,711,551,7152,360,9470
1100,서울특별시,광진구나선거구,6110502,1105,광진구,군자동,관내사전투표,2376,2368,830,349,739,188,160,2266,102,8
1100,서울특별시,광진구나선거구,6110502,1105,광진구,군자동,선거일투표,14606,5144,1450,671,1851,523,391,4886,258,9462
1100,서울특별시,광진구나선거구,6110502,1105,광진구,잘못 투입·구분된 투표지,,0,82,26,15,21,10,6,78,4,-82
1100,서울특별시,광진구다선거구,6110503,1105,광진구,합계,,88363,46703,10595,11078,14149,6786,42608,4095,41660
1100,서울특별시,광진구다선거구,6110503,1105,광진구,거소투표,,79,78,15,18,30,5,68,10,1
1100,서울특별시,광진구다선거구,6110503,1105,광진구,관외사전투표,,5091,5085,1351,1176,1593,606,4726,359,6
1100,서울특별시,광진구다선거구,6110503,1105,광진구,구의제1동,계,20343,9632,2411,2367,2790,1274,8842,790,10711
1100,서울특별시,광진구다선거구,6110503,1105,광진구,구의제1동,관내사전투표,3746,3742,991,1001,1001,464,3457,285,4
1100,서울특별시,광진구다선거구,6110503,1105,광진구,구의제1동,선거일투표,16597,5890,1420,1366,1789,810,5385,505,10707
1100,서울특별시,광진구다선거구,6110503,1105,광진구,구의제3동,계,23468,12848,2535,2682,4369,2191,11777,1071,10620
1100,서울특별시,광진구다선거구,6110503,1105,광진구,구의제3동,관내사전투표,4063,4053,921,961,1188,621,3691,362,10
1100,서울특별시,광진구다선거구,6110503,1105,광진구,구의제3동,선거일투표,19405,8795,1614,1721,3181,1570,8086,709,10610
1100,서울특별시,광진구다선거구,6110503,1105,광진구,자양제1동,계,19691,9280,2101,2527,2438,1268,8334,946,10411
1100,서울특별시,광진구다선거구,6110503,1105,광진구,자양제1동,관내사전투표,3873,3869,922,1171,902,514,3509,360,4
1100,서울특별시,광진구다선거구,6110503,1105,광진구,자양제1동,선거일투표,15818,5411,1179,1356,1536,754,4825,586,10407
1100,서울특별시,광진구다선거구,6110503,1105,광진구,자양제2동,계,19691,9737,2171,2300,2915,1436,8822,915,9954
1100,서울특별시,광진구다선거구,6110503,1105,광진구,자양제2동,관내사전투표,2794,2788,693,725,747,355,2520,268,6
1100,서울특별시,광진구다선거구,6110503,1105,광진구,자양제2동,선거일투표,16897,6949,1478,1575,2168,1081,6302,647,9948
1100,서울특별시,광진구다선거구,6110503,1105,광진구,잘못 투입·구분된 투표지,,0,43,11,8,14,6,39,4,-43
1100,서울특별시,광진구라선거구,6110504,1105,광진구,합계,,64187,31677,7512,4549,9480,5393,3049,29983,1694,32510
1100,서울특별시,광진구라선거구,6110504,1105,광진구,거소투표,,64,60,21,3,19,10,2,55,5,4
1100,서울특별시,광진구라선거구,6110504,1105,광진구,관외사전투표,,3346,3336,983,549,987,456,184,3159,177,10
1100,서울특별시,광진구라선거구,6110504,1105,광진구,자양제3동,계,22424,12774,2491,1591,3938,2472,1609,12101,673,9650
1100,서울특별시,광진구라선거구,6110504,1105,광진구,자양제3동,관내사전투표,4387,4385,976,676,1183,795,492,4122,263,2
1100,서울특별시,광진구라선거구,6110504,1105,광진구,자양제3동,선거일투표,18037,8389,1515,915,2755,1677,1117,7979,410,9648
1100,서울특별시,광진구라선거구,6110504,1105,광진구,자양제4동,계,16578,7799,1938,1218,2307,1388,514,7365,434,8779
1100,서울특별시,광진구라선거구,6110504,1105,광진구,자양제4동,관내사전투표,2810,2806,760,544,780,449,129,2662,144,4
1100,서울특별시,광진구라선거구,6110504,1105,광진구,자양제4동,선거일투표,13768,4993,1178,674,1527,939,385,4703,290,8775
1100,서울특별시,광진구라선거구,6110504,1105,광진구,화양동,계,21775,7688,2074,1185,2220,1066,739,7284,404,14087
1100,서울특별시,광진구라선거구,6110504,1105,광진구,화양동,관내사전투표,2499,2492,743,438,673,299,214,2367,125,7
1100,서울특별시,광진구라선거구,6110504,1105,광진구,화양동,선거일투표,19276,5196,1331,747,1547,767,525,4917,279,14080
1100,서울특별시,광진구라선거구,6110504,1105,광진구,잘못 투입·구분된 투표지,,0,20,5,3,9,1,1,19,1,-20
1100,서울특별시,동대문구가선거구,6110601,1106,동대문구,합계,,30363,14610,4481,3158,6543,14182,428,15753
1100,서울특별시,동대문구가선거구,6110601,1106,동대문구,거소투표,,45,41,15,6,13,34,7,4
1100,서울특별시,동대문구가선거구,6110601,1106,동대문구,관외사전투표,,2404,2402,856,486,989,2331,71,2
1100,서울특별시,동대문구가선거구,6110601,1106,동대문구,용신동,계,27914,12161,3608,2665,5538,11811,350,15753
1100,서울특별시,동대문구가선거구,6110601,1106,동대문구,용신동,관내사전투표,3731,3730,1188,864,1587,3639,91,1
1100,서울특별시,동대문구가선거구,6110601,1106,동대문구,용신동,선거일투표,24183,8431,2420,1801,3951,8172,259,15752
1100,서울특별시,동대문구가선거구,6110601,1106,동대문구,잘못 투입·구분된 투표지,,0,6,2,1,3,6,0,-6
1100,서울특별시,동대문구나선거구,6110602,1106,동대문구,합계,,40073,21175,6578,3455,10544,20577,598,18898
1100,서울특별시,동대문구나선거구,6110602,1106,동대문구,거소투표,,40,38,9,8,16,33,5,2
1100,서울특별시,동대문구나선거구,6110602,1106,동대문구,관외사전투표,,2444,2442,964,346,1068,2378,64,2
1100,서울특별시,동대문구나선거구,6110602,1106,동대문구,제기동,계,21200,9995,3071,1617,5022,9710,285,11205
1100,서울특별시,동대문구나선거구,6110602,1106,동대문구,제기동,관내사전투표,3336,3332,1068,607,1554,3229,103,4
1100,서울특별시,동대문구나선거구,6110602,1106,동대문구,제기동,선거일투표,17864,6663,2003,1010,3468,6481,182,11201
1100,서울특별시,동대문구나선거구,6110602,1106,동대문구,청량리동,계,16389,8689,2533,1480,4432,8445,244,7700
1100,서울특별시,동대문구나선거구,6110602,1106,동대문구,청량리동,관내사전투표,2340,2339,740,483,1045,2268,71,1
1100,서울특별시,동대문구나선거구,6110602,1106,동대문구,청량리동,선거일투표,14049,6350,1793,997,3387,6177,173,7699
1100,서울특별시,동대문구나선거구,6110602,1106,동대문구,잘못 투입·구분된 투표지,,0,11,1,4,6,11,0,-11
1100,서울특별시,동대문구다선거구,6110603,1106,동대문구,검색된 결과가 없습니다.
1100,서울특별시,동대문구라선거구,6110604,1106,동대문구,합계,,34254,18496,7674,9290,1170,18134,362,15758
1100,서울특별시,동대문구라선거구,6110604,1106,동대문구,거소투표,,39,37,17,17,1,35,2,2
1100,서울특별시,동대문구라선거구,6110604,1106,동대문구,관외사전투표,,2428,2426,1127,1087,154,2368,58,2
1100,서울특별시,동대문구라선거구,6110604,1106,동대문구,이문제1동,계,15612,7490,2822,3944,580,7346,144,8122
1100,서울특별시,동대문구라선거구,6110604,1106,동대문구,이문제1동,관내사전투표,2070,2069,917,975,156,2048,21,1
1100,서울특별시,동대문구라선거구,6110604,1106,동대문구,이문제1동,선거일투표,13542,5421,1905,2969,424,5298,123,8121
1100,서울특별시,동대문구라선거구,6110604,1106,동대문구,이문제2동,계,16175,8519,3701,4226,434,8361,158,7656
1100,서울특별시,동대문구라선거구,6110604,1106,동대문구,이문제2동,관내사전투표,2616,2599,1281,1183,110,2574,25,17
1100,서울특별시,동대문구라선거구,6110604,1106,동대문구,이문제2동,선거일투표,13559,5920,2420,3043,324,5787,133,7639
1100,서울특별시,동대문구라선거구,6110604,1106,동대문구,잘못 투입·구분된 투표지,,0,24,7,16,1,24,0,-24
1100,서울특별시,동대문구마선거구,6110605,1106,동대문구,합계,,66862,35548,9262,4684,9434,4065,3455,1520,1203,33623,1925,31314
1100,서울특별시,동대문구마선거구,6110605,1106,동대문구,거소투표,,76,73,17,8,21,11,7,0,0,64,9,3
1100,서울특별시,동대문구마선거구,6110605,1106,동대문구,관외사전투표,,4051,4042,1183,631,1196,355,198,130,120,3813,229,9
1100,서울특별시,동대문구마선거구,6110605,1106,동대문구,전농제1동,계,24017,11507,3015,1462,3125,1452,848,527,421,10850,657,12510
1100,서울특별시,동대문구마선거구,6110605,1106,동대문구,전농제1동,관내사전투표,3071,3064,897,428,737,354,212,122,128,2878,186,7
1100,서울특별시,동대문구마선거구,6110605,1106,동대문구,전농제1동,선거일투표,20946,8443,2118,1034,2388,1098,636,405,293,7972,471,12503
1100,서울특별시,동대문구마선거구,6110605,1106,동대문구,전농제2동,계,15399,8253,2087,1093,2251,881,815,373,298,7798,455,7146
1100,서울특별시,동대문구마선거구,6110605,1106,동대문구,전농제2동,관내사전투표,2996,2990,794,440,772,312,237,146,114,2815,175,6
1100,서울특별시,동대문구마선거구,6110605,1106,동대문구,전농제2동,선거일투표,12403,5263,1293,653,1479,569,578,227,184,4983,280,7140
1100,서울특별시,동대문구마선거구,6110605,1106,동대문구,답십리제1동,계,23319,11639,2945,1482,2834,1365,1587,490,363,11066,573,11680
1100,서울특별시,동대문구마선거구,6110605,1106,동대문구,답십리제1동,관내사전투표,3154,3145,912,442,726,317,373,112,106,2988,157,9
1100,서울특별시,동대문구마선거구,6110605,1106,동대문구,답십리제1동,선거일투표,20165,8494,2033,1040,2108,1048,1214,378,257,8078,416,11671
1100,서울특별시,동대문구마선거구,6110605,1106,동대문구,잘못 투입·구분된 투표지,,0,34,15,8,7,1,0,0,1,32,2,-34
1100,서울특별시,동대문구바선거구,6110606,1106,동대문구,합계,,86401,44559,11546,4649,4238,12297,4638,2757,1075,816,42016,2543,41842
1100,서울특별시,동대문구바선거구,6110606,1106,동대문구,거소투표,,103,100,28,7,6,24,12,5,3,2,87,13,3
1100,서울특별시,동대문구바선거구,6110606,1106,동대문구,관외사전투표,,4485,4483,1316,486,466,1197,386,205,115,70,4241,242,2
1100,서울특별시,동대문구바선거구,6110606,1106,동대문구,답십리제2동,계,23206,11834,2814,1596,1028,3323,1035,960,273,120,11149,685,11372
1100,서울특별시,동대문구바선거구,6110606,1106,동대문구,답십리제2동,관내사전투표,3173,3157,814,428,283,810,242,286,46,33,2942,215,16
1100,서울특별시,동대문구바선거구,6110606,1106,동대문구,답십리제2동,선거일투표,20033,8677,2000,1168,745,2513,793,674,227,87,8207,470,11356
1100,서울특별시,동대문구바선거구,6110606,1106,동대문구,장안제1동,계,32466,15553,4277,1290,1522,3739,2096,930,395,403,14652,901,16913
1100,서울특별시,동대문구바선거구,6110606,1106,동대문구,장안제1동,관내사전투표,4695,4686,1464,459,448,1024,573,232,93,109,4402,284,9
1100,서울특별시,동대문구바선거구,6110606,1106,동대문구,장안제1동,선거일투표,27771,10867,2813,831,1074,2715,1523,698,302,294,10250,617,16904
1100,서울특별시,동대문구바선거구,6110606,1106,동대문구,장안제2동,계,26141,12556,3101,1263,1213,4007,1107,653,289,221,11854,702,13585
1100,서울특별시,동대문구바선거구,6110606,1106,동대문구,장안제2동,관내사전투표,3619,3615,1010,383,353,1143,257,173,59,46,3424,191,4
1100,서울특별시,동대문구바선거구,6110606,1106,동대문구,장안제2동,선거일투표,22522,8941,2091,880,860,2864,850,480,230,175,8430,511,13581
1100,서울특별시,동대문구바선거구,6110606,1106,동대문구,잘못 투입·구분된 투표지,,0,33,10,7,3,7,2,4,0,0,33,0,-33
1100,서울특별시,중랑구가선거구,6110701,1107,중랑구,검색된 결과가 없습니다.
1100,서울특별시,중랑구나선거구,6110702,1107,중랑구,검색된 결과가 없습니다.
1100,서울특별시,중랑구다선거구,6110703,1107,중랑구,합계,,84551,39442,12906,6622,8747,6985,1754,37014,2428,45109
1100,서울특별시,중랑구다선거구,6110703,1107,중랑구,거소투표,,82,77,27,8,16,16,1,68,9,5
1100,서울특별시,중랑구다선거구,6110703,1107,중랑구,관외사전투표,,4811,4805,1810,794,1019,687,247,4557,248,6
1100,서울특별시,중랑구다선거구,6110703,1107,중랑구,면목본동,계,29285,12530,3612,2482,2734,2313,523,11664,866,16755
1100,서울특별시,중랑구다선거구,6110703,1107,중랑구,면목본동,관내사전투표,4896,4874,1495,1038,1029,812,172,4546,328,22
1100,서울특별시,중랑구다선거구,6110703,1107,중랑구,면목본동,선거일투표,24389,7656,2117,1444,1705,1501,351,7118,538,16733
1100,서울특별시,중랑구다선거구,6110703,1107,중랑구,면목제2동,계,20255,8807,3037,1285,1954,1623,343,8242,565,11448
1100,서울특별시,중랑구다선거구,6110703,1107,중랑구,면목제2동,관내사전투표,3274,3271,1265,464,701,538,103,3071,200,3
1100,서울특별시,중랑구다선거구,6110703,1107,중랑구,면목제2동,선거일투표,16981,5536,1772,821,1253,1085,240,5171,365,11445
1100,서울특별시,중랑구다선거구,6110703,1107,중랑구,면목제5동,계,12269,5929,2045,953,1256,1154,213,5621,308,6340
1100,서울특별시,중랑구다선거구,6110703,1107,중랑구,면목제5동,관내사전투표,2251,2244,849,374,432,398,86,2139,105,7
1100,서울특별시,중랑구다선거구,6110703,1107,중랑구,면목제5동,선거일투표,10018,3685,1196,579,824,756,127,3482,203,6333
1100,서울특별시,중랑구다선거구,6110703,1107,중랑구,상봉제2동,계,17849,7249,2356,1092,1757,1189,426,6820,429,10600
1100,서울특별시,중랑구다선거구,6110703,1107,중랑구,상봉제2동,관내사전투표,2861,2852,1024,458,645,424,140,2691,161,9
1100,서울특별시,중랑구다선거구,6110703,1107,중랑구,상봉제2동,선거일투표,14988,4397,1332,634,1112,765,286,4129,268,10591
1100,서울특별시,중랑구다선거구,6110703,1107,중랑구,잘못 투입·구분된 투표지,,0,45,19,8,11,3,1,42,3,-45
1100,서울특별시,중랑구라선거구,6110704,1107,중랑구,검색된 결과가 없습니다.
1100,서울특별시,중랑구마선거구,6110705,1107,중랑구,합계,,40533,20127,9462,6822,2874,19158,969,20406
1100,서울특별시,중랑구마선거구,6110705,1107,중랑구,거소투표,,44,42,22,11,5,38,4,2
1100,서울특별시,중랑구마선거구,6110705,1107,중랑구,관외사전투표,,2640,2639,1433,864,276,2573,66,1
1100,서울특별시,중랑구마선거구,6110705,1107,중랑구,중화제1동,계,16895,8616,3940,2910,1394,8244,372,8279
1100,서울특별시,중랑구마선거구,6110705,1107,중랑구,중화제1동,관내사전투표,3660,3658,1812,1123,608,3543,115,2
1100,서울특별시,중랑구마선거구,6110705,1107,중랑구,중화제1동,선거일투표,13235,4958,2128,1787,786,4701,257,8277
1100,서울특별시,중랑구마선거구,6110705,1107,중랑구,중화제2동,계,20954,8815,4060,3034,1197,8291,524,12139
1100,서울특별시,중랑구마선거구,6110705,1107,중랑구,중화제2동,관내사전투표,2463,2460,1232,780,333,2345,115,3
1100,서울특별시,중랑구마선거구,6110705,1107,중랑구,중화제2동,선거일투표,18491,6355,2828,2254,864,5946,409,12136
1100,서울특별시,중랑구마선거구,6110705,1107,중랑구,잘못 투입·구분된 투표지,,0,15,7,3,2,12,3,-15
1100,서울특별시,중랑구바선거구,6110706,1107,중랑구,합계,,38667,22053,9882,6878,4157,20917,1136,16614
1100,서울특별시,중랑구바선거구,6110706,1107,중랑구,거소투표,,58,55,20,19,12,51,4,3
1100,서울특별시,중랑구바선거구,6110706,1107,중랑구,관외사전투표,,2509,2505,1298,839,311,2448,57,4
1100,서울특별시,중랑구바선거구,6110706,1107,중랑구,상봉제1동,계,18136,8739,3815,2839,1579,8233,506,9397
1100,서울특별시,중랑구바선거구,6110706,1107,중랑구,상봉제1동,관내사전투표,2199,2196,1046,696,389,2131,65,3
1100,서울특별시,중랑구바선거구,6110706,1107,중랑구,상봉제1동,선거일투표,15937,6543,2769,2143,1190,6102,441,9394
1100,서울특별시,중랑구바선거구,6110706,1107,중랑구,신내제2동,계,17964,10731,4738,3174,2253,10165,566,7233
1100,서울특별시,중랑구바선거구,6110706,1107,중랑구,신내제2동,관내사전투표,4004,3999,1966,1067,870,3903,96,5
1100,서울특별시,중랑구바선거구,6110706,1107,중랑구,신내제2동,선거일투표,13960,6732,2772,2107,1383,6262,470,7228
1100,서울특별시,중랑구바선거구,6110706,1107,중랑구,잘못 투입·구분된 투표지,,0,23,11,7,2,20,3,-23
1100,서울특별시,중랑구사선거구,6110707,1107,중랑구,검색된 결과가 없습니다.
1100,서울특별시,성북구가선거구,6110801,1108,성북구,합계,,98171,50677,12389,5550,5485,12892,5867,2548,2618,456,47805,2872,47494
1100,서울특별시,성북구가선거구,6110801,1108,성북구,거소투표,,119,116,27,12,8,31,12,5,2,3,100,16,3
1100,서울특별시,성북구가선거구,6110801,1108,성북구,관외사전투표,,5947,5942,1709,590,628,1544,550,196,339,59,5615,327,5
1100,서울특별시,성북구가선거구,6110801,1108,성북구,성북동,계,14075,7089,1464,1049,774,1696,985,289,413,40,6710,379,6986
1100,서울특별시,성북구가선거구,6110801,1108,성북구,성북동,관내사전투표,2873,2871,693,497,351,618,317,85,140,14,2715,156,2
1100,서울특별시,성북구가선거구,6110801,1108,성북구,성북동,선거일투표,11202,4218,771,552,423,1078,668,204,273,26,3995,223,6984
1100,서울특별시,성북구가선거구,6110801,1108,성북구,삼선동,계,20463,10328,2435,1193,1438,2356,1176,454,518,117,9687,641,10135
1100,서울특별시,성북구가선거구,6110801,1108,성북구,삼선동,관내사전투표,4235,4227,1112,553,620,875,424,157,199,43,3983,244,8
1100,서울특별시,성북구가선거구,6110801,1108,성북구,삼선동,선거일투표,16228,6101,1323,640,818,1481,752,297,319,74,5704,397,10127
1100,서울특별시,성북구가선거구,6110801,1108,성북구,동선동,계,13092,5665,1585,661,539,1398,555,234,335,53,5360,305,7427
1100,서울특별시,성북구가선거구,6110801,1108,성북구,동선동,관내사전투표,1748,1746,572,239,157,385,158,58,71,15,1655,91,2
1100,서울특별시,성북구가선거구,6110801,1108,성북구,동선동,선거일투표,11344,3919,1013,422,382,1013,397,176,264,38,3705,214,7425
1100,서울특별시,성북구가선거구,6110801,1108,성북구,돈암제2동,계,17970,9561,1979,1057,976,2622,1393,488,452,75,9042,519,8409
1100,서울특별시,성북구가선거구,6110801,1108,성북구,돈암제2동,관내사전투표,2478,2471,568,303,267,629,331,115,100,12,2325,146,7
1100,서울특별시,성북구가선거구,6110801,1108,성북구,돈암제2동,선거일투표,15492,7090,1411,754,709,1993,1062,373,352,63,6717,373,8402
1100,서울특별시,성북구가선거구,6110801,1108,성북구,안암동,계,13476,5988,1531,460,498,1653,630,475,307,72,5626,362,7488
1100,서울특별시,성북구가선거구,6110801,1108,성북구,안암동,관내사전투표,1933,1929,573,184,201,465,153,158,75,13,1822,107,4
1100,서울특별시,성북구가선거구,6110801,1108,성북구,안암동,선거일투표,11543,4059,958,276,297,1188,477,317,232,59,3804,255,7484
1100,서울특별시,성북구가선거구,6110801,1108,성북구,보문동,계,13029,5939,1646,524,620,1581,558,403,252,37,5621,318,7090
1100,서울특별시,성북구가선거구,6110801,1108,성북구,보문동,관내사전투표,2242,2235,667,215,235,587,209,120,78,11,2122,113,7
1100,서울특별시,성북구가선거구,6110801,1108,성북구,보문동,선거일투표,10787,3704,979,309,385,994,349,283,174,26,3499,205,7083
1100,서울특별시,성북구가선거구,6110801,1108,성북구,잘못 투입·구분된 투표지,,0,49,13,4,4,11,8,4,0,0,44,5,-49
1100,서울특별시,성북구나선거구,6110802,1108,성북구,합계,,99193,54386,14146,6046,4031,12923,6613,2205,1107,855,3004,50930,3456,44807
1100,서울특별시,성북구나선거구,6110802,1108,성북구,거소투표,,104,100,28,5,10,22,15,5,4,1,4,94,6,4
1100,서울특별시,성북구나선거구,6110802,1108,성북구,관외사전투표,,6767,6761,2098,713,602,1486,763,200,119,86,248,6315,446,6
1100,서울특별시,성북구나선거구,6110802,1108,성북구,정릉제1동,계,14509,7839,2135,671,829,1857,1067,290,150,106,268,7373,466,6670
1100,서울특별시,성북구나선거구,6110802,1108,성북구,정릉제1동,관내사전투표,2880,2873,816,266,368,664,373,92,34,31,70,2714,159,7
1100,서울특별시,성북구나선거구,6110802,1108,성북구,정릉제1동,선거일투표,11629,4966,1319,405,461,1193,694,198,116,75,198,4659,307,6663
1100,서울특별시,성북구나선거구,6110802,1108,성북구,정릉제2동,계,18853,9508,2437,1159,655,2455,1114,484,211,81,248,8844,664,9345
1100,서울특별시,성북구나선거구,6110802,1108,성북구,정릉제2동,관내사전투표,4144,4138,1096,572,271,1119,390,184,75,27,87,3821,317,6
1100,서울특별시,성북구나선거구,6110802,1108,성북구,정릉제2동,선거일투표,14709,5370,1341,587,384,1336,724,300,136,54,161,5023,347,9339
1100,서울특별시,성북구나선거구,6110802,1108,성북구,정릉제3동,계,12517,5225,1186,677,407,1487,600,194,78,45,153,4827,398,7292
1100,서울특별시,성북구나선거구,6110802,1108,성북구,정릉제3동,관내사전투표,1924,1919,436,283,143,548,197,54,26,20,41,1748,171,5
1100,서울특별시,성북구나선거구,6110802,1108,성북구,정릉제3동,선거일투표,10593,3306,750,394,264,939,403,140,52,25,112,3079,227,7287
1100,서울특별시,성북구나선거구,6110802,1108,성북구,정릉제4동,계,20661,10437,2318,1839,661,2777,1161,428,191,79,394,9848,589,10224
1100,서울특별시,성북구나선거구,6110802,1108,성북구,정릉제4동,관내사전투표,3814,3814,905,739,228,926,407,126,59,25,134,3549,265,0
1100,서울특별시,성북구나선거구,6110802,1108,성북구,정릉제4동,선거일투표,16847,6623,1413,1100,433,1851,754,302,132,54,260,6299,324,10224
1100,서울특별시,성북구나선거구,6110802,1108,성북구,길음제1동,계,25782,14478,3924,977,862,2838,1890,601,354,457,1689,13592,886,11304
1100,서울특별시,성북구나선거구,6110802,1108,성북구,길음제1동,관내사전투표,4090,4088,1299,327,282,770,468,143,75,133,372,3869,219,2
1100,서울특별시,성북구나선거구,6110802,1108,성북구,길음제1동,선거일투표,21692,10390,2625,650,580,2068,1422,458,279,324,1317,9723,667,11302
1100,서울특별시,성북구나선거구,6110802,1108,성북구,잘못 투입·구분된 투표지,,0,38,20,5,5,1,3,3,0,0,0,37,1,-38
1100,서울특별시,성북구다선거구,6110803,1108,성북구,검색된 결과가 없습니다.
1100,서울특별시,성북구라선거구,6110804,1108,성북구,합계,,57333,31405,10349,5517,9937,3061,28864,2541,25928
1100,서울특별시,성북구라선거구,6110804,1108,성북구,거소투표,,65,61,20,7,24,5,56,5,4
1100,서울특별시,성북구라선거구,6110804,1108,성북구,관외사전투표,,3699,3694,1289,656,1260,231,3436,258,5
1100,서울특별시,성북구라선거구,6110804,1108,성북구,길음제2동,계,16249,8542,2484,1222,3739,522,7967,575,7707
1100,서울특별시,성북구라선거구,6110804,1108,성북구,길음제2동,관내사전투표,2668,2663,825,396,1104,155,2480,183,5
1100,서울특별시,성북구라선거구,6110804,1108,성북구,길음제2동,선거일투표,13581,5879,1659,826,2635,367,5487,392,7702
1100,서울특별시,성북구라선거구,6110804,1108,성북구,월곡제1동,계,21202,11171,4154,1997,2652,1433,10236,935,10031
1100,서울특별시,성북구라선거구,6110804,1108,성북구,월곡제1동,관내사전투표,3928,3923,1649,741,897,438,3725,198,5
1100,서울특별시,성북구라선거구,6110804,1108,성북구,월곡제1동,선거일투표,17274,7248,2505,1256,1755,995,6511,737,10026
1100,서울특별시,성북구라선거구,6110804,1108,성북구,월곡제2동,계,16118,7903,2392,1632,2247,870,7141,762,8215
1100,서울특별시,성북구라선거구,6110804,1108,성북구,월곡제2동,관내사전투표,2454,2445,759,544,663,227,2193,252,9
1100,서울특별시,성북구라선거구,6110804,1108,성북구,월곡제2동,선거일투표,13664,5458,1633,1088,1584,643,4948,510,8206
1100,서울특별시,성북구라선거구,6110804,1108,성북구,잘못 투입·구분된 투표지,,0,34,10,3,15,0,28,6,-34
1100,서울특별시,성북구마선거구,6110805,1108,성북구,검색된 결과가 없습니다.
1100,서울특별시,성북구바선거구,6110806,1108,성북구,검색된 결과가 없습니다.
1100,서울특별시,강북구가선거구,6110901,1109,강북구,합계,,72336,34855,10261,6548,12518,3092,32419,2436,37481
1100,서울특별시,강북구가선거구,6110901,1109,강북구,거소투표,,100,91,29,10,19,11,69,22,9
1100,서울특별시,강북구가선거구,6110901,1109,강북구,관외사전투표,,3879,3878,1330,789,1104,373,3596,282,1
1100,서울특별시,강북구가선거구,6110901,1109,강북구,번1동,계,16234,6861,1939,1271,2522,591,6323,538,9373
1100,서울특별시,강북구가선거구,6110901,1109,강북구,번1동,관내사전투표,2604,2601,763,546,866,183,2358,243,3
1100,서울특별시,강북구가선거구,6110901,1109,강북구,번1동,선거일투표,13630,4260,1176,725,1656,408,3965,295,9370
1100,서울특별시,강북구가선거구,6110901,1109,강북구,번2동,계,13405,6427,1911,1264,2169,582,5926,501,6978
1100,서울특별시,강북구가선거구,6110901,1109,강북구,번2동,관내사전투표,2090,2080,613,434,646,165,1858,222,10
1100,서울특별시,강북구가선거구,6110901,1109,강북구,번2동,선거일투표,11315,4347,1298,830,1523,417,4068,279,6968
1100,서울특별시,강북구가선거구,6110901,1109,강북구,수유2동,계,18128,8840,2412,1523,3620,761,8316,524,9288
1100,서울특별시,강북구가선거구,6110901,1109,강북구,수유2동,관내사전투표,3704,3701,1059,676,1436,281,3452,249,3
1100,서울특별시,강북구가선거구,6110901,1109,강북구,수유2동,선거일투표,14424,5139,1353,847,2184,480,4864,275,9285
1100,서울특별시,강북구가선거구,6110901,1109,강북구,수유3동,계,20590,8731,2631,1687,3073,774,8165,566,11859
1100,서울특별시,강북구가선거구,6110901,1109,강북구,수유3동,관내사전투표,2800,2798,898,617,874,218,2607,191,2
1100,서울특별시,강북구가선거구,6110901,1109,강북구,수유3동,선거일투표,17790,5933,1733,1070,2199,556,5558,375,11857
1100,서울특별시,강북구가선거구,6110901,1109,강북구,잘못 투입·구분된 투표지,,0,27,9,4,11,0,24,3,-27
1100,서울특별시,강북구나선거구,6110902,1109,강북구,합계,,64268,31193,10264,5582,8860,4072,28778,2415,33075
1100,서울특별시,강북구나선거구,6110902,1109,강북구,거소투표,,79,74,19,6,17,9,51,23,5
1100,서울특별시,강북구나선거구,6110902,1109,강북구,관외사전투표,,3747,3744,1438,700,967,360,3465,279,3
1100,서울특별시,강북구나선거구,6110902,1109,강북구,수유1동,계,17858,7711,2688,1312,2147,1050,7197,514,10147
1100,서울특별시,강북구나선거구,6110902,1109,강북구,수유1동,관내사전투표,2962,2952,1094,521,781,322,2718,234,10
1100,서울특별시,강북구나선거구,6110902,1109,강북구,수유1동,선거일투표,14896,4759,1594,791,1366,728,4479,280,10137
1100,서울특별시,강북구나선거구,6110902,1109,강북구,우이동,계,17506,8315,2554,1485,2501,1075,7615,700,9191
1100,서울특별시,강북구나선거구,6110902,1109,강북구,우이동,관내사전투표,2967,2965,947,556,849,345,2697,268,2
1100,서울특별시,강북구나선거구,6110902,1109,강북구,우이동,선거일투표,14539,5350,1607,929,1652,730,4918,432,9189
1100,서울특별시,강북구나선거구,6110902,1109,강북구,인수동,계,25078,11324,3554,2074,3221,1577,10426,898,13754
1100,서울특별시,강북구나선거구,6110902,1109,강북구,인수동,관내사전투표,4443,4441,1434,876,1212,534,4056,385,2
1100,서울특별시,강북구나선거구,6110902,1109,강북구,인수동,선거일투표,20635,6883,2120,1198,2009,1043,6370,513,13752
1100,서울특별시,강북구나선거구,6110902,1109,강북구,잘못 투입·구분된 투표지,,0,25,11,5,7,1,24,1,-25
1100,서울특별시,강북구다선거구,6110903,1109,강북구,합계,,70303,36086,12579,5369,10452,4608,1192,34200,1886,34217
1100,서울특별시,강북구다선거구,6110903,1109,강북구,거소투표,,85,80,30,9,21,8,3,71,9,5
1100,서울특별시,강북구다선거구,6110903,1109,강북구,관외사전투표,,4054,4047,1540,578,1182,407,139,3846,201,7
1100,서울특별시,강북구다선거구,6110903,1109,강북구,삼양동,계,19562,8687,2814,1590,2384,1182,262,8232,455,10875
1100,서울특별시,강북구다선거구,6110903,1109,강북구,삼양동,관내사전투표,2729,2722,847,657,683,290,79,2556,166,7
1100,서울특별시,강북구다선거구,6110903,1109,강북구,삼양동,선거일투표,16833,5965,1967,933,1701,892,183,5676,289,10868
1100,서울특별시,강북구다선거구,6110903,1109,강북구,송천동,계,22634,10307,3490,1564,3050,1295,310,9709,598,12327
1100,서울특별시,강북구다선거구,6110903,1109,강북구,송천동,관내사전투표,3397,3384,1245,497,908,417,82,3149,235,13
1100,서울특별시,강북구다선거구,6110903,1109,강북구,송천동,선거일투표,19237,6923,2245,1067,2142,878,228,6560,363,12314
1100,서울특별시,강북구다선거구,6110903,1109,강북구,삼각산동,계,23968,12927,4691,1621,3802,1714,477,12305,622,11041
1100,서울특별시,강북구다선거구,6110903,1109,강북구,삼각산동,관내사전투표,3727,3717,1416,507,1016,415,140,3494,223,10
1100,서울특별시,강북구다선거구,6110903,1109,강북구,삼각산동,선거일투표,20241,9210,3275,1114,2786,1299,337,8811,399,11031
1100,서울특별시,강북구다선거구,6110903,1109,강북구,잘못 투입·구분된 투표지,,0,38,14,7,13,2,1,37,1,-38
1100,서울특별시,강북구라선거구,6110904,1109,강북구,합계,,61223,31222,10722,5731,8990,3660,29103,2119,30001
1100,서울특별시,강북구라선거구,6110904,1109,강북구,거소투표,,74,70,14,13,18,10,55,15,4
1100,서울특별시,강북구라선거구,6110904,1109,강북구,관외사전투표,,3952,3944,1610,688,1015,371,3684,260,8
1100,서울특별시,강북구라선거구,6110904,1109,강북구,미아동,계,19167,8896,2872,1923,2544,940,8279,617,10271
1100,서울특별시,강북구라선거구,6110904,1109,강북구,미아동,관내사전투표,3277,3255,1141,763,819,300,3023,232,22
1100,서울특별시,강북구라선거구,6110904,1109,강북구,미아동,선거일투표,15890,5641,1731,1160,1725,640,5256,385,10249
1100,서울특별시,강북구라선거구,6110904,1109,강북구,송중동,계,24050,10996,3358,2181,3524,1209,10272,724,13054
1100,서울특별시,강북구라선거구,6110904,1109,강북구,송중동,관내사전투표,3446,3437,1147,717,997,317,3178,259,9
1100,서울특별시,강북구라선거구,6110904,1109,강북구,송중동,선거일투표,20604,7559,2211,1464,2527,892,7094,465,13045
1100,서울특별시,강북구라선거구,6110904,1109,강북구,번3동,계,13980,7271,2854,916,1875,1125,6770,501,6709
1100,서울특별시,강북구라선거구,6110904,1109,강북구,번3동,관내사전투표,2796,2792,1092,382,675,434,2583,209,4
1100,서울특별시,강북구라선거구,6110904,1109,강북구,번3동,선거일투표,11184,4479,1762,534,1200,691,4187,292,6705
1100,서울특별시,강북구라선거구,6110904,1109,강북구,잘못 투입·구분된 투표지,,0,45,14,10,14,5,43,2,-45
1100,서울특별시,도봉구가선거구,6111001,1110,도봉구,합계,,66144,37657,11537,6496,10512,6839,432,35816,1841,28487
1100,서울특별시,도봉구가선거구,6111001,1110,도봉구,거소투표,,82,77,20,13,18,17,1,69,8,5
1100,서울특별시,도봉구가선거구,6111001,1110,도봉구,관외사전투표,,4061,4049,1405,729,1151,476,53,3814,235,12
1100,서울특별시,도봉구가선거구,6111001,1110,도봉구,창1동,계,20074,10173,3197,1792,2871,1702,136,9698,475,9901
1100,서울특별시,도봉구가선거구,6111001,1110,도봉구,창1동,관내사전투표,3353,3343,1134,597,900,565,34,3230,113,10
1100,서울특별시,도봉구가선거구,6111001,1110,도봉구,창1동,선거일투표,16721,6830,2063,1195,1971,1137,102,6468,362,9891
1100,서울특별시,도봉구가선거구,6111001,1110,도봉구,창4동,계,21544,12390,3807,2256,3756,1870,104,11793,597,9154
1100,서울특별시,도봉구가선거구,6111001,1110,도봉구,창4동,관내사전투표,3842,3832,1266,737,1026,580,32,3641,191,10
1100,서울특별시,도봉구가선거구,6111001,1110,도봉구,창4동,선거일투표,17702,8558,2541,1519,2730,1290,72,8152,406,9144
1100,서울특별시,도봉구가선거구,6111001,1110,도봉구,창5동,계,20383,10922,3100,1695,2704,2766,137,10402,520,9461
1100,서울특별시,도봉구가선거구,6111001,1110,도봉구,창5동,관내사전투표,3605,3592,1102,592,789,889,44,3416,176,13
1100,서울특별시,도봉구가선거구,6111001,1110,도봉구,창5동,선거일투표,16778,7330,1998,1103,1915,1877,93,6986,344,9448
1100,서울특별시,도봉구가선거구,6111001,1110,도봉구,잘못 투입·구분된 투표지,,0,46,8,11,12,8,1,40,6,-46
1100,서울특별시,도봉구나선거구,6111002,1110,도봉구,합계,,72524,35872,11889,4662,9326,4964,3285,34126,1746,36652
1100,서울특별시,도봉구나선거구,6111002,1110,도봉구,거소투표,,92,82,28,9,19,12,5,73,9,10
1100,서울특별시,도봉구나선거구,6111002,1110,도봉구,관외사전투표,,4058,4023,1508,682,995,383,242,3810,213,35
1100,서울특별시,도봉구나선거구,6111002,1110,도봉구,쌍문1동,계,17675,8135,2769,1015,2260,1145,542,7731,404,9540
1100,서울특별시,도봉구나선거구,6111002,1110,도봉구,쌍문1동,관내사전투표,2700,2690,957,321,730,338,197,2543,147,10
1100,서울특별시,도봉구나선거구,6111002,1110,도봉구,쌍문1동,선거일투표,14975,5445,1812,694,1530,807,345,5188,257,9530
1100,서울특별시,도봉구나선거구,6111002,1110,도봉구,쌍문3동,계,14460,6859,2451,841,1875,895,471,6533,326,7601
1100,서울특별시,도봉구나선거구,6111002,1110,도봉구,쌍문3동,관내사전투표,2463,2445,919,325,630,258,192,2324,121,18
1100,서울특별시,도봉구나선거구,6111002,1110,도봉구,쌍문3동,선거일투표,11997,4414,1532,516,1245,637,279,4209,205,7583
1100,서울특별시,도봉구나선거구,6111002,1110,도봉구,창2동,계,24643,11442,3654,1395,2760,1832,1278,10919,523,13201
1100,서울특별시,도봉구나선거구,6111002,1110,도봉구,창2동,관내사전투표,4102,4086,1343,522,943,595,474,3877,209,16
1100,서울특별시,도봉구나선거구,6111002,1110,도봉구,창2동,선거일투표,20541,7356,2311,873,1817,1237,804,7042,314,13185
1100,서울특별시,도봉구나선거구,6111002,1110,도봉구,창3동,계,11596,5233,1457,696,1394,681,739,4967,266,6363
1100,서울특별시,도봉구나선거구,6111002,1110,도봉구,창3동,관내사전투표,1952,1935,555,246,540,205,294,1840,95,17
1100,서울특별시,도봉구나선거구,6111002,1110,도봉구,창3동,선거일투표,9644,3298,902,450,854,476,445,3127,171,6346
1100,서울특별시,도봉구나선거구,6111002,1110,도봉구,잘못 투입·구분된 투표지,,0,98,22,24,23,16,8,93,5,-98
1100,서울특별시,도봉구다선거구,6111003,1110,도봉구,검색된 결과가 없습니다.
1100,서울특별시,도봉구라선거구,6111004,1110,도봉구,검색된 결과가 없습니다.
1100,서울특별시,도봉구마선거구,6111005,1110,도봉구,합계,,43202,21470,9217,10254,1536,21007,463,21732
1100,서울특별시,도봉구마선거구,6111005,1110,도봉구,거소투표,,60,56,20,27,2,49,7,4
1100,서울특별시,도봉구마선거구,6111005,1110,도봉구,관외사전투표,,3054,3025,1467,1360,120,2947,78,29
1100,서울특별시,도봉구마선거구,6111005,1110,도봉구,방학1동,계,23326,10737,4512,5194,836,10542,195,12589
1100,서울특별시,도봉구마선거구,6111005,1110,도봉구,방학1동,관내사전투표,3345,3340,1505,1541,233,3279,61,5
1100,서울특별시,도봉구마선거구,6111005,1110,도봉구,방학1동,선거일투표,19981,7397,3007,3653,603,7263,134,12584
1100,서울특별시,도봉구마선거구,6111005,1110,도봉구,방학2동,계,16762,7610,3198,3655,575,7428,182,9152
1100,서울특별시,도봉구마선거구,6111005,1110,도봉구,방학2동,관내사전투표,2969,2962,1300,1370,215,2885,77,7
1100,서울특별시,도봉구마선거구,6111005,1110,도봉구,방학2동,선거일투표,13793,4648,1898,2285,360,4543,105,9145
1100,서울특별시,도봉구마선거구,6111005,1110,도봉구,잘못 투입·구분된 투표지,,0,42,20,18,3,41,1,-42
1100,서울특별시,노원구가선거구,6111101,1111,노원구,합계,,68551,38066,8271,6551,10706,5435,5142,36105,1961,30485
1100,서울특별시,노원구가선거구,6111101,1111,노원구,거소투표,,81,73,17,9,21,13,4,64,9,8
1100,서울특별시,노원구가선거구,6111101,1111,노원구,관외사전투표,,4707,4703,1333,912,1386,462,387,4480,223,4
1100,서울특별시,노원구가선거구,6111101,1111,노원구,월계1동,계,18454,9446,1865,1655,2504,1822,1113,8959,487,9008
1100,서울특별시,노원구가선거구,6111101,1111,노원구,월계1동,관내사전투표,3525,3510,729,691,815,624,447,3306,204,15
1100,서울특별시,노원구가선거구,6111101,1111,노원구,월계1동,선거일투표,14929,5936,1136,964,1689,1198,666,5653,283,8993
1100,서울특별시,노원구가선거구,6111101,1111,노원구,월계2동,계,21404,10768,2583,1798,3136,1437,1217,10171,597,10636
1100,서울특별시,노원구가선거구,6111101,1111,노원구,월계2동,관내사전투표,3125,3110,804,575,813,375,348,2915,195,15
1100,서울특별시,노원구가선거구,6111101,1111,노원구,월계2동,선거일투표,18279,7658,1779,1223,2323,1062,869,7256,402,10621
1100,서울특별시,노원구가선거구,6111101,1111,노원구,월계3동,계,23905,13029,2461,2172,3652,1691,2414,12390,639,10876
1100,서울특별시,노원구가선거구,6111101,1111,노원구,월계3동,관내사전투표,2453,2443,584,399,614,266,437,2300,143,10
1100,서울특별시,노원구가선거구,6111101,1111,노원구,월계3동,선거일투표,21452,10586,1877,1773,3038,1425,1977,10090,496,10866
1100,서울특별시,노원구가선거구,6111101,1111,노원구,잘못 투입·구분된 투표지,,0,47,12,5,7,10,7,41,6,-47
1100,서울특별시,노원구나선거구,6111102,1111,노원구,합계,,68421,37722,9283,4583,9066,6001,7291,36224,1498,30699
1100,서울특별시,노원구나선거구,6111102,1111,노원구,거소투표,,63,56,17,6,18,7,2,50,6,7
1100,서울특별시,노원구나선거구,6111102,1111,노원구,관외사전투표,,4666,4550,1456,594,1297,451,575,4373,177,116
1100,서울특별시,노원구나선거구,6111102,1111,노원구,공릉1동,계,30981,15355,3884,2129,3644,2641,2381,14679,676,15626
1100,서울특별시,노원구나선거구,6111102,1111,노원구,공릉1동,관내사전투표,4765,4758,1203,816,1030,814,698,4561,197,7
1100,서울특별시,노원구나선거구,6111102,1111,노원구,공릉1동,선거일투표,26216,10597,2681,1313,2614,1827,1683,10118,479,15619
1100,서울특별시,노원구나선거구,6111102,1111,노원구,공릉2동,계,32711,17609,3877,1834,4066,2888,4312,16977,632,15102
1100,서울특별시,노원구나선거구,6111102,1111,노원구,공릉2동,관내사전투표,5077,5052,1154,573,1051,770,1329,4877,175,25
1100,서울특별시,노원구나선거구,6111102,1111,노원구,공릉2동,선거일투표,27634,12557,2723,1261,3015,2118,2983,12100,457,15077
1100,서울특별시,노원구나선거구,6111102,1111,노원구,잘못 투입·구분된 투표지,,0,152,49,20,41,14,21,145,7,-152
1100,서울특별시,노원구다선거구,6111103,1111,노원구,합계,,80401,45306,13532,9064,14788,4849,546,42779,2527,35095
1100,서울특별시,노원구다선거구,6111103,1111,노원구,거소투표,,162,159,54,20,52,11,5,142,17,3
1100,서울특별시,노원구다선거구,6111103,1111,노원구,관외사전투표,,5458,5443,1764,967,1844,455,98,5128,315,15
1100,서울특별시,노원구다선거구,6111103,1111,노원구,하계1동,계,21954,11153,3048,2256,4100,1032,134,10570,583,10801
1100,서울특별시,노원구다선거구,6111103,1111,노원구,하계1동,관내사전투표,2878,2847,789,644,995,228,27,2683,164,31
1100,서울특별시,노원구다선거구,6111103,1111,노원구,하계1동,선거일투표,19076,8306,2259,1612,3105,804,107,7887,419,10770
1100,서울특별시,노원구다선거구,6111103,1111,노원구,중계본동,계,17249,9102,2824,1800,2872,1016,114,8626,476,8147
1100,서울특별시,노원구다선거구,6111103,1111,노원구,중계본동,관내사전투표,2714,2696,952,596,744,247,28,2567,129,18
1100,서울특별시,노원구다선거구,6111103,1111,노원구,중계본동,선거일투표,14535,6406,1872,1204,2128,769,86,6059,347,8129
1100,서울특별시,노원구다선거구,6111103,1111,노원구,중계1동,계,19568,10807,3258,2233,3214,1403,112,10220,587,8761
1100,서울특별시,노원구다선거구,6111103,1111,노원구,중계1동,관내사전투표,3839,3833,1203,842,1090,445,37,3617,216,6
1100,서울특별시,노원구다선거구,6111103,1111,노원구,중계1동,선거일투표,15729,6974,2055,1391,2124,958,75,6603,371,8755
1100,서울특별시,노원구다선거구,6111103,1111,노원구,중계4동,계,16010,8501,2536,1757,2670,914,82,7959,542,7509
1100,서울특별시,노원구다선거구,6111103,1111,노원구,중계4동,관내사전투표,2862,2797,901,610,775,284,21,2591,206,65
1100,서울특별시,노원구다선거구,6111103,1111,노원구,중계4동,선거일투표,13148,5704,1635,1147,1895,630,61,5368,336,7444
1100,서울특별시,노원구다선거구,6111103,1111,노원구,잘못 투입·구분된 투표지,,0,141,48,31,36,18,1,134,7,-141
1100,서울특별시,노원구라선거구,6111104,1111,노원구,합계,,76206,42813,10905,7766,10990,7242,2836,1026,40765,2048,33393
1100,서울특별시,노원구라선거구,6111104,1111,노원구,거소투표,,124,103,37,12,20,22,3,3,97,6,21
1100,서울특별시,노원구라선거구,6111104,1111,노원구,관외사전투표,,4744,4703,1271,908,1264,648,285,83,4459,244,41
1100,서울특별시,노원구라선거구,6111104,1111,노원구,하계2동,계,17105,9408,2505,1630,2419,1586,611,231,8982,426,7697
1100,서울특별시,노원구라선거구,6111104,1111,노원구,하계2동,관내사전투표,2576,2576,692,495,647,402,145,52,2433,143,0
1100,서울특별시,노원구라선거구,6111104,1111,노원구,하계2동,선거일투표,14529,6832,1813,1135,1772,1184,466,179,6549,283,7697
1100,서울특별시,노원구라선거구,6111104,1111,노원구,중계2·3동,계,28366,14844,3834,2889,3442,2694,815,391,14065,779,13522
1100,서울특별시,노원구라선거구,6111104,1111,노원구,중계2·3동,관내사전투표,4150,4146,1154,896,892,655,202,101,3900,246,4
1100,서울특별시,노원구라선거구,6111104,1111,노원구,중계2·3동,선거일투표,24216,10698,2680,1993,2550,2039,613,290,10165,533,13518
1100,서울특별시,노원구라선거구,6111104,1111,노원구,상계6·7동,계,25867,13706,3242,2321,3828,2287,1118,318,13114,592,12161
1100,서울특별시,노원구라선거구,6111104,1111,노원구,상계6·7동,관내사전투표,2882,2882,765,586,729,381,211,81,2753,129,0
1100,서울특별시,노원구라선거구,6111104,1111,노원구,상계6·7동,선거일투표,22985,10824,2477,1735,3099,1906,907,237,10361,463,12161
1100,서울특별시,노원구라선거구,6111104,1111,노원구,잘못 투입·구분된 투표지,,0,49,16,6,17,5,4,0,48,1,-49
1100,서울특별시,노원구마선거구,6111105,1111,노원구,합계,,62269,32922,9228,4716,9223,5239,2722,31128,1794,29347
1100,서울특별시,노원구마선거구,6111105,1111,노원구,거소투표,,90,80,28,11,22,8,3,72,8,10
1100,서울특별시,노원구마선거구,6111105,1111,노원구,관외사전투표,,3660,3657,1227,485,1110,367,290,3479,178,3
1100,서울특별시,노원구마선거구,6111105,1111,노원구,상계2동,계,16665,8284,2212,1344,2495,1255,535,7841,443,8381
1100,서울특별시,노원구마선거구,6111105,1111,노원구,상계2동,관내사전투표,3380,3367,921,624,948,482,189,3164,203,13
1100,서울특별시,노원구마선거구,6111105,1111,노원구,상계2동,선거일투표,13285,4917,1291,720,1547,773,346,4677,240,8368
1100,서울특별시,노원구마선거구,6111105,1111,노원구,상계3·4동,계,21394,10620,3181,1223,2856,1755,978,9993,627,10774
1100,서울특별시,노원구마선거구,6111105,1111,노원구,상계3·4동,관내사전투표,2992,2986,1002,398,711,477,183,2771,215,6
1100,서울특별시,노원구마선거구,6111105,1111,노원구,상계3·4동,선거일투표,18402,7634,2179,825,2145,1278,795,7222,412,10768
1100,서울특별시,노원구마선거구,6111105,1111,노원구,상계5동,계,20460,10240,2565,1649,2731,1848,913,9706,534,10220
1100,서울특별시,노원구마선거구,6111105,1111,노원구,상계5동,관내사전투표,3437,3423,905,622,843,598,261,3229,194,14
1100,서울특별시,노원구마선거구,6111105,1111,노원구,상계5동,선거일투표,17023,6817,1660,1027,1888,1250,652,6477,340,10206
1100,서울특별시,노원구마선거구,6111105,1111,노원구,잘못 투입·구분된 투표지,,0,41,15,4,9,6,3,37,4,-41
1100,서울특별시,노원구바선거구,6111106,1111,노원구,합계,,85900,48238,11161,9102,11918,7749,6154,46084,2154,37662
1100,서울특별시,노원구바선거구,6111106,1111,노원구,거소투표,,155,148,41,22,28,25,12,128,20,7
1100,서울특별시,노원구바선거구,6111106,1111,노원구,관외사전투표,,5250,5241,1451,951,1212,776,597,4987,254,9
1100,서울특별시,노원구바선거구,6111106,1111,노원구,상계1동,계,31175,15879,3682,3004,3834,2728,1938,15186,693,15296
1100,서울특별시,노원구바선거구,6111106,1111,노원구,상계1동,관내사전투표,5090,5052,1228,1137,1181,728,531,4805,247,38
1100,서울특별시,노원구바선거구,6111106,1111,노원구,상계1동,선거일투표,26085,10827,2454,1867,2653,2000,1407,10381,446,15258
1100,서울특별시,노원구바선거구,6111106,1111,노원구,상계8동,계,17578,9512,2220,1886,2259,1290,1444,9099,413,8066
1100,서울특별시,노원구바선거구,6111106,1111,노원구,상계8동,관내사전투표,3383,3374,871,754,723,367,509,3224,150,9
1100,서울특별시,노원구바선거구,6111106,1111,노원구,상계8동,선거일투표,14195,6138,1349,1132,1536,923,935,5875,263,8057
1100,서울특별시,노원구바선거구,6111106,1111,노원구,상계9동,계,16605,9107,1851,1818,2336,1554,1134,8693,414,7498
1100,서울특별시,노원구바선거구,6111106,1111,노원구,상계9동,관내사전투표,3275,3253,701,720,791,496,393,3101,152,22
1100,서울특별시,노원구바선거구,6111106,1111,노원구,상계9동,선거일투표,13330,5854,1150,1098,1545,1058,741,5592,262,7476
1100,서울특별시,노원구바선거구,6111106,1111,노원구,상계10동,계,15137,8242,1890,1392,2221,1364,1018,7885,357,6895
1100,서울특별시,노원구바선거구,6111106,1111,노원구,상계10동,관내사전투표,2879,2850,677,581,723,382,355,2718,132,29
1100,서울특별시,노원구바선거구,6111106,1111,노원구,상계10동,선거일투표,12258,5392,1213,811,1498,982,663,5167,225,6866
1100,서울특별시,노원구바선거구,6111106,1111,노원구,잘못 투입·구분된 투표지,,0,109,26,29,28,12,11,106,3,-109
1100,서울특별시,은평구가선거구,6111201,1112,은평구,검색된 결과가 없습니다.
1100,서울특별시,은평구나선거구,6111202,1112,은평구,합계,,45419,22812,8615,3985,9624,22224,588,22607
1100,서울특별시,은평구나선거구,6111202,1112,은평구,거소투표,,45,45,14,6,22,42,3,0
1100,서울특별시,은평구나선거구,6111202,1112,은평구,관외사전투표,,2816,2814,1162,457,1121,2740,74,2
1100,서울특별시,은평구나선거구,6111202,1112,은평구,응암제2동,계,20931,10083,3764,1753,4376,9893,190,10848
1100,서울특별시,은평구나선거구,6111202,1112,은평구,응암제2동,관내사전투표,2803,2796,1130,479,1133,2742,54,7
1100,서울특별시,은평구나선거구,6111202,1112,은평구,응암제2동,선거일투표,18128,7287,2634,1274,3243,7151,136,10841
1100,서울특별시,은평구나선거구,6111202,1112,은평구,응암제3동,계,21627,9850,3666,1766,4098,9530,320,11777
1100,서울특별시,은평구나선거구,6111202,1112,은평구,응암제3동,관내사전투표,4010,4004,1529,757,1595,3881,123,6
1100,서울특별시,은평구나선거구,6111202,1112,은평구,응암제3동,선거일투표,17617,5846,2137,1009,2503,5649,197,11771
1100,서울특별시,은평구나선거구,6111202,1112,은평구,잘못 투입·구분된 투표지,,0,20,9,3,7,19,1,-20
1100,서울특별시,은평구다선거구,6111203,1112,은평구,합계,,44105,24099,11344,10338,1819,23501,598,20006
1100,서울특별시,은평구다선거구,6111203,1112,은평구,거소투표,,58,50,22,20,4,46,4,8
1100,서울특별시,은평구다선거구,6111203,1112,은평구,관외사전투표,,3519,3516,1886,1352,198,3436,80,3
1100,서울특별시,은평구다선거구,6111203,1112,은평구,신사제2동,계,15864,7332,3442,3123,604,7169,163,8532
1100,서울특별시,은평구다선거구,6111203,1112,은평구,신사제2동,관내사전투표,2291,2288,1102,952,183,2237,51,3
1100,서울특별시,은평구다선거구,6111203,1112,은평구,신사제2동,선거일투표,13573,5044,2340,2171,421,4932,112,8529
1100,서울특별시,은평구다선거구,6111203,1112,은평구,증산동,계,13866,7397,3525,3166,486,7177,220,6469
1100,서울특별시,은평구다선거구,6111203,1112,은평구,증산동,관내사전투표,3172,3168,1553,1287,231,3071,97,4
1100,서울특별시,은평구다선거구,6111203,1112,은평구,증산동,선거일투표,10694,4229,1972,1879,255,4106,123,6465
1100,서울특별시,은평구다선거구,6111203,1112,은평구,수색동,계,10798,5789,2463,2671,526,5660,129,5009
1100,서울특별시,은평구다선거구,6111203,1112,은평구,수색동,관내사전투표,2068,2065,905,900,218,2023,42,3
1100,서울특별시,은평구다선거구,6111203,1112,은평구,수색동,선거일투표,8730,3724,1558,1771,308,3637,87,5006
1100,서울특별시,은평구다선거구,6111203,1112,은평구,잘못 투입·구분된 투표지,,0,15,6,6,1,13,2,-15
1100,서울특별시,은평구라선거구,6111204,1112,은평구,합계,,64456,32177,10188,5151,10008,2092,1667,317,439,516,30378,1799,32279
1100,서울특별시,은평구라선거구,6111204,1112,은평구,거소투표,,69,68,22,9,14,10,3,0,0,0,58,10,1
1100,서울특별시,은평구라선거구,6111204,1112,은평구,관외사전투표,,3765,3763,1314,671,964,279,210,29,46,37,3550,213,2
1100,서울특별시,은평구라선거구,6111204,1112,은평구,역촌동,계,37865,17198,5401,2684,5536,1005,919,106,239,369,16259,939,20667
1100,서울특별시,은평구라선거구,6111204,1112,은평구,역촌동,관내사전투표,6544,6530,2230,1079,1911,323,329,29,49,173,6123,407,14
1100,서울특별시,은평구라선거구,6111204,1112,은평구,역촌동,선거일투표,31321,10668,3171,1605,3625,682,590,77,190,196,10136,532,20653
1100,서울특별시,은평구라선거구,6111204,1112,은평구,신사제1동,계,22757,11101,3436,1775,3481,797,534,182,154,108,10467,634,11656
1100,서울특별시,은평구라선거구,6111204,1112,은평구,신사제1동,관내사전투표,4922,4893,1616,803,1477,325,183,83,40,57,4584,309,29
1100,서울특별시,은평구라선거구,6111204,1112,은평구,신사제1동,선거일투표,17835,6208,1820,972,2004,472,351,99,114,51,5883,325,11627
1100,서울특별시,은평구라선거구,6111204,1112,은평구,잘못 투입·구분된 투표지,,0,47,15,12,13,1,1,0,0,2,44,3,-47
1100,서울특별시,은평구마선거구,6111205,1112,은평구,검색된 결과가 없습니다.
1100,서울특별시,은평구바선거구,6111206,1112,은평구,합계,,45505,26657,11698,12490,2001,26189,468,18848
1100,서울특별시,은평구바선거구,6111206,1112,은평구,거소투표,,75,73,22,38,3,63,10,2
1100,서울특별시,은평구바선거구,6111206,1112,은평구,관외사전투표,,3105,3092,1489,1320,211,3020,72,13
1100,서울특별시,은평구바선거구,6111206,1112,은평구,진관동,계,42325,23472,10180,11121,1786,23087,385,18853
1100,서울특별시,은평구바선거구,6111206,1112,은평구,진관동,관내사전투표,6987,6985,3334,3102,443,6879,106,2
1100,서울특별시,은평구바선거구,6111206,1112,은평구,진관동,선거일투표,35338,16487,6846,8019,1343,16208,279,18851
1100,서울특별시,은평구바선거구,6111206,1112,은평구,잘못 투입·구분된 투표지,,0,20,7,11,1,19,1,-20
1100,서울특별시,은평구사선거구,6111207,1112,은평구,검색된 결과가 없습니다.
1100,서울특별시,은평구아선거구,6111208,1112,은평구,합계,,53194,25707,12316,11592,1064,24972,735,27487
1100,서울특별시,은평구아선거구,6111208,1112,은평구,거소투표,,460,429,158,110,38,306,123,31
1100,서울특별시,은평구아선거구,6111208,1112,은평구,관외사전투표,,3759,3751,2042,1444,179,3665,86,8
1100,서울특별시,은평구아선거구,6111208,1112,은평구,구산동,계,26246,11788,5526,5527,484,11537,251,14458
1100,서울특별시,은평구아선거구,6111208,1112,은평구,구산동,관내사전투표,4162,4156,2110,1802,146,4058,98,6
1100,서울특별시,은평구아선거구,6111208,1112,은평구,구산동,선거일투표,22084,7632,3416,3725,338,7479,153,14452
1100,서울특별시,은평구아선거구,6111208,1112,은평구,대조동,계,22729,9720,4582,4503,361,9446,274,13009
1100,서울특별시,은평구아선거구,6111208,1112,은평구,대조동,관내사전투표,3280,3279,1605,1409,109,3123,156,1
1100,서울특별시,은평구아선거구,6111208,1112,은평구,대조동,선거일투표,19449,6441,2977,3094,252,6323,118,13008
1100,서울특별시,은평구아선거구,6111208,1112,은평구,잘못 투입·구분된 투표지,,0,19,8,8,2,18,1,-19
1100,서울특별시,서대문구가선거구,6111301,1113,서대문구,합계,,65905,34555,8212,5089,8475,8883,2179,32838,1717,31350
1100,서울특별시,서대문구가선거구,6111301,1113,서대문구,거소투표,,76,73,20,11,17,17,3,68,5,3
1100,서울특별시,서대문구가선거구,6111301,1113,서대문구,관외사전투표,,4734,4730,1394,790,1283,789,261,4517,213,4
1100,서울특별시,서대문구가선거구,6111301,1113,서대문구,충현동,계,16224,7849,1683,1197,1747,2468,388,7483,366,8375
1100,서울특별시,서대문구가선거구,6111301,1113,서대문구,충현동,관내사전투표,1978,1977,461,357,424,540,96,1878,99,1
1100,서울특별시,서대문구가선거구,6111301,1113,서대문구,충현동,선거일투표,14246,5872,1222,840,1323,1928,292,5605,267,8374
1100,서울특별시,서대문구가선거구,6111301,1113,서대문구,천연동,계,14028,7968,1970,1042,1828,2165,516,7521,447,6060
1100,서울특별시,서대문구가선거구,6111301,1113,서대문구,천연동,관내사전투표,2604,2603,690,386,599,647,149,2471,132,1
1100,서울특별시,서대문구가선거구,6111301,1113,서대문구,천연동,선거일투표,11424,5365,1280,656,1229,1518,367,5050,315,6059
1100,서울특별시,서대문구가선거구,6111301,1113,서대문구,북아현동,계,13563,7354,1534,1091,1722,2257,390,6994,360,6209
1100,서울특별시,서대문구가선거구,6111301,1113,서대문구,북아현동,관내사전투표,2897,2871,688,524,615,749,138,2714,157,26
1100,서울특별시,서대문구가선거구,6111301,1113,서대문구,북아현동,선거일투표,10666,4483,846,567,1107,1508,252,4280,203,6183
1100,서울특별시,서대문구가선거구,6111301,1113,서대문구,신촌동,계,17280,6541,1600,956,1869,1175,618,6218,323,10739
1100,서울특별시,서대문구가선거구,6111301,1113,서대문구,신촌동,관내사전투표,1501,1499,413,228,372,277,149,1439,60,2
1100,서울특별시,서대문구가선거구,6111301,1113,서대문구,신촌동,선거일투표,15779,5042,1187,728,1497,898,469,4779,263,10737
1100,서울특별시,서대문구가선거구,6111301,1113,서대문구,잘못 투입·구분된 투표지,,0,40,11,2,9,12,3,37,3,-40
1100,서울특별시,서대문구나선거구,6111302,1113,서대문구,검색된 결과가 없습니다.
1100,서울특별시,서대문구다선거구,6111303,1113,서대문구,합계,,32881,19331,7253,8660,2376,343,18632,699,13550
1100,서울특별시,서대문구다선거구,6111303,1113,서대문구,거소투표,,39,38,11,18,2,2,33,5,1
1100,서울특별시,서대문구다선거구,6111303,1113,서대문구,관외사전투표,,2465,2448,1132,1010,218,42,2402,46,17
1100,서울특별시,서대문구다선거구,6111303,1113,서대문구,홍제제1동,계,18651,9913,3691,4458,1204,215,9568,345,8738
1100,서울특별시,서대문구다선거구,6111303,1113,서대문구,홍제제1동,관내사전투표,2103,2100,813,912,284,47,2056,44,3
1100,서울특별시,서대문구다선거구,6111303,1113,서대문구,홍제제1동,선거일투표,16548,7813,2878,3546,920,168,7512,301,8735
1100,서울특별시,서대문구다선거구,6111303,1113,서대문구,홍제제2동,계,11726,6869,2396,3150,943,84,6573,296,4857
1100,서울특별시,서대문구다선거구,6111303,1113,서대문구,홍제제2동,관내사전투표,2791,2779,1060,1237,401,31,2729,50,12
1100,서울특별시,서대문구다선거구,6111303,1113,서대문구,홍제제2동,선거일투표,8935,4090,1336,1913,542,53,3844,246,4845
1100,서울특별시,서대문구다선거구,6111303,1113,서대문구,잘못 투입·구분된 투표지,,0,63,23,24,9,0,56,7,-63
1100,서울특별시,서대문구라선거구,6111304,1113,서대문구,합계,,59737,32134,10463,5344,9017,4754,680,30258,1876,27603
1100,서울특별시,서대문구라선거구,6111304,1113,서대문구,거소투표,,91,86,23,15,30,10,2,80,6,5
1100,서울특별시,서대문구라선거구,6111304,1113,서대문구,관외사전투표,,4796,4785,1875,681,1322,545,102,4525,260,11
1100,서울특별시,서대문구라선거구,6111304,1113,서대문구,홍제제3동,계,14428,7416,2348,1245,1975,1302,132,7002,414,7012
1100,서울특별시,서대문구라선거구,6111304,1113,서대문구,홍제제3동,관내사전투표,2440,2386,809,454,587,388,34,2272,114,54
1100,서울특별시,서대문구라선거구,6111304,1113,서대문구,홍제제3동,선거일투표,11988,5030,1539,791,1388,914,98,4730,300,6958
1100,서울특별시,서대문구라선거구,6111304,1113,서대문구,홍은제1동,계,18994,10143,2924,2172,2650,1546,214,9506,637,8851
1100,서울특별시,서대문구라선거구,6111304,1113,서대문구,홍은제1동,관내사전투표,3492,3488,1100,808,853,477,38,3276,212,4
1100,서울특별시,서대문구라선거구,6111304,1113,서대문구,홍은제1동,선거일투표,15502,6655,1824,1364,1797,1069,176,6230,425,8847
1100,서울특별시,서대문구라선거구,6111304,1113,서대문구,홍은제2동,계,21428,9607,3259,1212,3019,1333,229,9052,555,11821
1100,서울특별시,서대문구라선거구,6111304,1113,서대문구,홍은제2동,관내사전투표,2797,2773,1041,388,841,320,44,2634,139,24
1100,서울특별시,서대문구라선거구,6111304,1113,서대문구,홍은제2동,선거일투표,18631,6834,2218,824,2178,1013,185,6418,416,11797
1100,서울특별시,서대문구라선거구,6111304,1113,서대문구,잘못 투입·구분된 투표지,,0,97,34,19,21,18,1,93,4,-97
1100,서울특별시,서대문구마선거구,6111305,1113,서대문구,합계,,80848,44401,14167,6970,13851,5464,40452,3949,36447
1100,서울특별시,서대문구마선거구,6111305,1113,서대문구,거소투표,,93,88,22,12,26,12,72,16,5
1100,서울특별시,서대문구마선거구,6111305,1113,서대문구,관외사전투표,,4221,4215,1524,721,1296,377,3918,297,6
1100,서울특별시,서대문구마선거구,6111305,1113,서대문구,남가좌제1동,계,12709,7578,2298,1109,2483,1099,6989,589,5131
1100,서울특별시,서대문구마선거구,6111305,1113,서대문구,남가좌제1동,관내사전투표,3332,3321,1094,511,1015,447,3067,254,11
1100,서울특별시,서대문구마선거구,6111305,1113,서대문구,남가좌제1동,선거일투표,9377,4257,1204,598,1468,652,3922,335,5120
1100,서울특별시,서대문구마선거구,6111305,1113,서대문구,남가좌제2동,계,22639,11137,3414,1788,3574,1298,10074,1063,11502
1100,서울특별시,서대문구마선거구,6111305,1113,서대문구,남가좌제2동,관내사전투표,2788,2767,935,532,795,279,2541,226,21
1100,서울특별시,서대문구마선거구,6111305,1113,서대문구,남가좌제2동,선거일투표,19851,8370,2479,1256,2779,1019,7533,837,11481
1100,서울특별시,서대문구마선거구,6111305,1113,서대문구,북가좌제1동,계,15056,8728,2685,1247,2840,1182,7954,774,6328
1100,서울특별시,서대문구마선거구,6111305,1113,서대문구,북가좌제1동,관내사전투표,3685,3679,1224,569,1091,463,3347,332,6
1100,서울특별시,서대문구마선거구,6111305,1113,서대문구,북가좌제1동,선거일투표,11371,5049,1461,678,1749,719,4607,442,6322
1100,서울특별시,서대문구마선거구,6111305,1113,서대문구,북가좌제2동,계,26130,12561,4195,2077,3603,1489,11364,1197,13569
1100,서울특별시,서대문구마선거구,6111305,1113,서대문구,북가좌제2동,관내사전투표,3949,3938,1400,705,1024,405,3534,404,11
1100,서울특별시,서대문구마선거구,6111305,1113,서대문구,북가좌제2동,선거일투표,22181,8623,2795,1372,2579,1084,7830,793,13558
1100,서울특별시,서대문구마선거구,6111305,1113,서대문구,잘못 투입·구분된 투표지,,0,94,29,16,29,7,81,13,-94
1100,서울특별시,마포구가선거구,6111401,1114,마포구,검색된 결과가 없습니다.
1100,서울특별시,마포구나선거구,6111402,1114,마포구,합계,,39637,23093,8610,10691,3015,22316,777,16544
1100,서울특별시,마포구나선거구,6111402,1114,마포구,거소투표,,32,30,10,16,2,28,2,2
1100,서울특별시,마포구나선거구,6111402,1114,마포구,관외사전투표,,2442,2441,1035,1112,244,2391,50,1
1100,서울특별시,마포구나선거구,6111402,1114,마포구,아현동,계,19710,10683,3837,4862,1677,10376,307,9027
1100,서울특별시,마포구나선거구,6111402,1114,마포구,아현동,관내사전투표,2855,2849,1108,1306,385,2799,50,6
1100,서울특별시,마포구나선거구,6111402,1114,마포구,아현동,선거일투표,16855,7834,2729,3556,1292,7577,257,9021
1100,서울특별시,마포구나선거구,6111402,1114,마포구,도화동,계,17453,9924,3722,4700,1087,9509,415,7529
1100,서울특별시,마포구나선거구,6111402,1114,마포구,도화동,관내사전투표,2956,2953,1293,1248,341,2882,71,3
1100,서울특별시,마포구나선거구,6111402,1114,마포구,도화동,선거일투표,14497,6971,2429,3452,746,6627,344,7526
1100,서울특별시,마포구나선거구,6111402,1114,마포구,잘못 투입·구분된 투표지,,0,15,6,1,5,12,3,-15
1100,서울특별시,마포구다선거구,6111403,1114,마포구,검색된 결과가 없습니다.
1100,서울특별시,마포구라선거구,6111404,1114,마포구,합계,,27580,14336,5970,6768,1156,13894,442,13244
1100,서울특별시,마포구라선거구,6111404,1114,마포구,거소투표,,16,16,5,10,0,15,1,0
1100,서울특별시,마포구라선거구,6111404,1114,마포구,관외사전투표,,1912,1911,870,860,145,1875,36,1
1100,서울특별시,마포구라선거구,6111404,1114,마포구,대흥동,계,12219,5513,2248,2617,431,5296,217,6706
1100,서울특별시,마포구라선거구,6111404,1114,마포구,대흥동,관내사전투표,1808,1804,859,784,114,1757,47,4
1100,서울특별시,마포구라선거구,6111404,1114,마포구,대흥동,선거일투표,10411,3709,1389,1833,317,3539,170,6702
1100,서울특별시,마포구라선거구,6111404,1114,마포구,염리동,계,13433,6888,2841,3280,580,6701,187,6545
1100,서울특별시,마포구라선거구,6111404,1114,마포구,염리동,관내사전투표,2430,2429,1164,1054,184,2402,27,1
1100,서울특별시,마포구라선거구,6111404,1114,마포구,염리동,선거일투표,11003,4459,1677,2226,396,4299,160,6544
1100,서울특별시,마포구라선거구,6111404,1114,마포구,잘못 투입·구분된 투표지,,0,8,6,1,0,7,1,-8
1100,서울특별시,마포구마선거구,6111405,1114,마포구,합계,,37732,20319,7881,9318,2534,19733,586,17413
1100,서울특별시,마포구마선거구,6111405,1114,마포구,거소투표,,26,24,8,11,3,22,2,2
1100,서울특별시,마포구마선거구,6111405,1114,마포구,관외사전투표,,2454,2453,1117,1059,230,2406,47,1
1100,서울특별시,마포구마선거구,6111405,1114,마포구,서강동,계,20340,10422,3643,5054,1381,10078,344,9918
1100,서울특별시,마포구마선거구,6111405,1114,마포구,서강동,관내사전투표,2891,2891,1142,1323,371,2836,55,0
1100,서울특별시,마포구마선거구,6111405,1114,마포구,서강동,선거일투표,17449,7531,2501,3731,1010,7242,289,9918
1100,서울특별시,마포구마선거구,6111405,1114,마포구,합정동,계,14912,7413,3112,3191,918,7221,192,7499
1100,서울특별시,마포구마선거구,6111405,1114,마포구,합정동,관내사전투표,2544,2542,1205,993,310,2508,34,2
1100,서울특별시,마포구마선거구,6111405,1114,마포구,합정동,선거일투표,12368,4871,1907,2198,608,4713,158,7497
1100,서울특별시,마포구마선거구,6111405,1114,마포구,잘못 투입·구분된 투표지,,0,7,1,3,2,6,1,-7
1100,서울특별시,마포구바선거구,6111406,1114,마포구,합계,,41530,20425,9414,8305,2086,19805,620,21105
1100,서울특별시,마포구바선거구,6111406,1114,마포구,거소투표,,40,37,14,16,6,36,1,3
1100,서울특별시,마포구바선거구,6111406,1114,마포구,관외사전투표,,3246,3242,1692,1252,220,3164,78,4
1100,서울특별시,마포구바선거구,6111406,1114,마포구,서교동,계,21198,8763,3926,3785,786,8497,266,12435
1100,서울특별시,마포구바선거구,6111406,1114,마포구,서교동,관내사전투표,2427,2425,1213,941,237,2391,34,2
1100,서울특별시,마포구바선거구,6111406,1114,마포구,서교동,선거일투표,18771,6338,2713,2844,549,6106,232,12433
1100,서울특별시,마포구바선거구,6111406,1114,마포구,망원1동,계,17046,8373,3779,3246,1074,8099,274,8673
1100,서울특별시,마포구바선거구,6111406,1114,마포구,망원1동,관내사전투표,3187,3184,1521,1211,395,3127,57,3
1100,서울특별시,마포구바선거구,6111406,1114,마포구,망원1동,선거일투표,13859,5189,2258,2035,679,4972,217,8670
1100,서울특별시,마포구바선거구,6111406,1114,마포구,잘못 투입·구분된 투표지,,0,10,3,6,0,9,1,-10
1100,서울특별시,마포구사선거구,6111407,1114,마포구,검색된 결과가 없습니다.
1100,서울특별시,마포구아선거구,6111408,1114,마포구,합계,,59948,33580,9700,4929,10595,3315,2947,501,31987,1593,26368
1100,서울특별시,마포구아선거구,6111408,1114,마포구,거소투표,,88,84,21,18,24,9,4,1,77,7,4
1100,서울특별시,마포구아선거구,6111408,1114,마포구,관외사전투표,,4686,4684,1607,704,1343,361,392,56,4463,221,2
1100,서울특별시,마포구아선거구,6111408,1114,마포구,성산2동,계,31662,16017,4432,2308,5180,1499,1551,298,15268,749,15645
1100,서울특별시,마포구아선거구,6111408,1114,마포구,성산2동,관내사전투표,4076,4074,1154,720,1250,326,360,77,3887,187,2
1100,서울특별시,마포구아선거구,6111408,1114,마포구,성산2동,선거일투표,27586,11943,3278,1588,3930,1173,1191,221,11381,562,15643
1100,서울특별시,마포구아선거구,6111408,1114,마포구,상암동,계,23512,12789,3638,1897,4046,1446,1000,146,12173,616,10723
1100,서울특별시,마포구아선거구,6111408,1114,마포구,상암동,관내사전투표,3285,3283,970,585,1010,329,200,38,3132,151,2
1100,서울특별시,마포구아선거구,6111408,1114,마포구,상암동,선거일투표,20227,9506,2668,1312,3036,1117,800,108,9041,465,10721
1100,서울특별시,마포구아선거구,6111408,1114,마포구,잘못 투입·구분된 투표지,,0,6,2,2,2,0,0,0,6,0,-6
1100,서울특별시,양천구가선거구,6111501,1115,양천구,합계,,46017,24229,7958,4373,11203,23534,695,21788
1100,서울특별시,양천구가선거구,6111501,1115,양천구,거소투표,,45,42,11,4,24,39,3,3
1100,서울특별시,양천구가선거구,6111501,1115,양천구,관외사전투표,,3031,3026,1163,520,1268,2951,75,5
1100,서울특별시,양천구가선거구,6111501,1115,양천구,목2동,계,24720,12414,4276,2154,5634,12064,350,12306
1100,서울특별시,양천구가선거구,6111501,1115,양천구,목2동,관내사전투표,4322,4317,1614,846,1769,4229,88,5
1100,서울특별시,양천구가선거구,6111501,1115,양천구,목2동,선거일투표,20398,8097,2662,1308,3865,7835,262,12301
1100,서울특별시,양천구가선거구,6111501,1115,양천구,목3동,계,18221,8736,2501,1695,4273,8469,267,9485
1100,서울특별시,양천구가선거구,6111501,1115,양천구,목3동,관내사전투표,3325,3325,965,704,1534,3203,122,0
1100,서울특별시,양천구가선거구,6111501,1115,양천구,목3동,선거일투표,14896,5411,1536,991,2739,5266,145,9485
1100,서울특별시,양천구가선거구,6111501,1115,양천구,잘못 투입·구분된 투표지,,0,11,7,0,4,11,0,-11
1100,서울특별시,양천구나선거구,6111502,1115,양천구,검색된 결과가 없습니다.
1100,서울특별시,양천구다선거구,6111503,1115,양천구,검색된 결과가 없습니다.
1100,서울특별시,양천구라선거구,6111504,1115,양천구,검색된 결과가 없습니다.
1100,서울특별시,양천구마선거구,6111505,1115,양천구,검색된 결과가 없습니다.
1100,서울특별시,양천구바선거구,6111506,1115,양천구,검색된 결과가 없습니다.
1100,서울특별시,양천구사선거구,6111507,1115,양천구,검색된 결과가 없습니다.
1100,서울특별시,양천구아선거구,6111508,1115,양천구,검색된 결과가 없습니다.
1100,서울특별시,강서구가선거구,6111601,1116,강서구,합계,,86007,39018,12639,8636,11933,3063,773,37044,1974,46989
1100,서울특별시,강서구가선거구,6111601,1116,강서구,거소투표,,72,66,14,11,25,4,3,57,9,6
1100,서울특별시,강서구가선거구,6111601,1116,강서구,관외사전투표,,5297,5288,1908,1156,1520,297,146,5027,261,9
1100,서울특별시,강서구가선거구,6111601,1116,강서구,화곡제1동,계,44226,17267,5516,3645,5516,1395,323,16395,872,26959
1100,서울특별시,강서구가선거구,6111601,1116,강서구,화곡제1동,관내사전투표,5276,5267,1718,1208,1661,387,66,5040,227,9
1100,서울특별시,강서구가선거구,6111601,1116,강서구,화곡제1동,선거일투표,38950,12000,3798,2437,3855,1008,257,11355,645,26950
1100,서울특별시,강서구가선거구,6111601,1116,강서구,화곡제2동,계,14779,6335,2111,1336,1969,509,107,6032,303,8444
1100,서울특별시,강서구가선거구,6111601,1116,강서구,화곡제2동,관내사전투표,2545,2542,888,558,770,177,39,2432,110,3
1100,서울특별시,강서구가선거구,6111601,1116,강서구,화곡제2동,선거일투표,12234,3793,1223,778,1199,332,68,3600,193,8441
1100,서울특별시,강서구가선거구,6111601,1116,강서구,화곡제8동,계,21633,10038,3082,2487,2890,857,194,9510,528,11595
1100,서울특별시,강서구가선거구,6111601,1116,강서구,화곡제8동,관내사전투표,4254,4247,1391,1102,1146,344,61,4044,203,7
1100,서울특별시,강서구가선거구,6111601,1116,강서구,화곡제8동,선거일투표,17379,5791,1691,1385,1744,513,133,5466,325,11588
1100,서울특별시,강서구가선거구,6111601,1116,강서구,잘못 투입·구분된 투표지,,0,24,8,1,13,1,0,23,1,-24
1100,서울특별시,강서구나선거구,6111602,1116,강서구,합계,,48676,26859,12414,12559,991,25964,895,21817
1100,서울특별시,강서구나선거구,6111602,1116,강서구,거소투표,,60,54,12,27,6,45,9,6
1100,서울특별시,강서구나선거구,6111602,1116,강서구,관외사전투표,,2621,2620,1300,1161,96,2557,63,1
1100,서울특별시,강서구나선거구,6111602,1116,강서구,화곡제3동,계,18046,9440,3941,4900,260,9101,339,8606
1100,서울특별시,강서구나선거구,6111602,1116,강서구,화곡제3동,관내사전투표,2664,2659,1283,1239,76,2598,61,5
1100,서울특별시,강서구나선거구,6111602,1116,강서구,화곡제3동,선거일투표,15382,6781,2658,3661,184,6503,278,8601
1100,서울특별시,강서구나선거구,6111602,1116,강서구,발산제1동,계,27949,14722,7155,6458,628,14241,481,13227
1100,서울특별시,강서구나선거구,6111602,1116,강서구,발산제1동,관내사전투표,4129,4123,2183,1727,159,4069,54,6
1100,서울특별시,강서구나선거구,6111602,1116,강서구,발산제1동,선거일투표,23820,10599,4972,4731,469,10172,427,13221
1100,서울특별시,강서구나선거구,6111602,1116,강서구,잘못 투입·구분된 투표지,,0,23,6,13,1,20,3,-23
1100,서울특별시,강서구다선거구,6111603,1116,강서구,검색된 결과가 없습니다.
1100,서울특별시,강서구라선거구,6111604,1116,강서구,합계,,82462,42970,12225,7742,14135,5442,39544,3426,39492
1100,서울특별시,강서구라선거구,6111604,1116,강서구,거소투표,,106,102,23,28,22,11,84,18,4
1100,서울특별시,강서구라선거구,6111604,1116,강서구,관외사전투표,,4871,4866,1624,847,1676,370,4517,349,5
1100,서울특별시,강서구라선거구,6111604,1116,강서구,공항동,계,24112,10857,3287,1796,3412,1534,10029,828,13255
1100,서울특별시,강서구라선거구,6111604,1116,강서구,공항동,관내사전투표,2819,2818,865,516,777,429,2587,231,1
1100,서울특별시,강서구라선거구,6111604,1116,강서구,공항동,선거일투표,21293,8039,2422,1280,2635,1105,7442,597,13254
1100,서울특별시,강서구라선거구,6111604,1116,강서구,방화제1동,계,33514,17602,4811,3446,5897,2154,16308,1294,15912
1100,서울특별시,강서구라선거구,6111604,1116,강서구,방화제1동,관내사전투표,5393,5387,1512,1285,1678,614,5089,298,6
1100,서울특별시,강서구라선거구,6111604,1116,강서구,방화제1동,선거일투표,28121,12215,3299,2161,4219,1540,11219,996,15906
1100,서울특별시,강서구라선거구,6111604,1116,강서구,방화제2동,계,19859,9508,2466,1624,3117,1369,8576,932,10351
1100,서울특별시,강서구라선거구,6111604,1116,강서구,방화제2동,관내사전투표,2607,2602,750,514,796,355,2415,187,5
1100,서울특별시,강서구라선거구,6111604,1116,강서구,방화제2동,선거일투표,17252,6906,1716,1110,2321,1014,6161,745,10346
1100,서울특별시,강서구라선거구,6111604,1116,강서구,잘못 투입·구분된 투표지,,0,35,14,1,11,4,30,5,-35
1100,서울특별시,강서구마선거구,6111605,1116,강서구,합계,,92211,50025,14284,7146,12077,9439,1854,297,1635,532,47264,2761,42186
1100,서울특별시,강서구마선거구,6111605,1116,강서구,거소투표,,150,137,30,20,34,25,4,0,5,2,120,17,13
1100,서울특별시,강서구마선거구,6111605,1116,강서구,관외사전투표,,5591,5586,1744,907,1378,932,221,19,60,33,5294,292,5
1100,서울특별시,강서구마선거구,6111605,1116,강서구,등촌제3동,계,26033,14023,4176,1555,3449,2211,472,61,1168,122,13214,809,12010
1100,서울특별시,강서구마선거구,6111605,1116,강서구,등촌제3동,관내사전투표,3877,3868,1336,489,892,520,96,17,264,22,3636,232,9
1100,서울특별시,강서구마선거구,6111605,1116,강서구,등촌제3동,선거일투표,22156,10155,2840,1066,2557,1691,376,44,904,100,9578,577,12001
1100,서울특별시,강서구마선거구,6111605,1116,강서구,가양제1동,계,28128,12430,3240,2197,2769,2689,568,115,89,208,11875,555,15698
1100,서울특별시,강서구마선거구,6111605,1116,강서구,가양제1동,관내사전투표,3160,3158,751,739,654,643,133,35,27,27,3009,149,2
1100,서울특별시,강서구마선거구,6111605,1116,강서구,가양제1동,선거일투표,24968,9272,2489,1458,2115,2046,435,80,62,181,8866,406,15696
1100,서울특별시,강서구마선거구,6111605,1116,강서구,가양제2동,계,13009,7365,2233,838,1993,1291,226,53,208,80,6922,443,5644
1100,서울특별시,강서구마선거구,6111605,1116,강서구,가양제2동,관내사전투표,2558,2557,814,305,658,426,75,24,63,44,2409,148,1
1100,서울특별시,강서구마선거구,6111605,1116,강서구,가양제2동,선거일투표,10451,4808,1419,533,1335,865,151,29,145,36,4513,295,5643
1100,서울특별시,강서구마선거구,6111605,1116,강서구,방화제3동,계,19300,10459,2851,1626,2446,2289,362,49,105,87,9815,644,8841
1100,서울특별시,강서구마선거구,6111605,1116,강서구,방화제3동,관내사전투표,3519,3518,1054,612,818,666,99,16,26,21,3312,206,1
1100,서울특별시,강서구마선거구,6111605,1116,강서구,방화제3동,선거일투표,15781,6941,1797,1014,1628,1623,263,33,79,66,6503,438,8840
1100,서울특별시,강서구마선거구,6111605,1116,강서구,잘못 투입·구분된 투표지,,0,25,10,3,8,2,1,0,0,0,24,1,-25
1100,서울특별시,강서구바선거구,6111606,1116,강서구,합계,,70602,39128,17598,18543,1915,38056,1072,31474
1100,서울특별시,강서구바선거구,6111606,1116,강서구,거소투표,,80,73,24,36,3,63,10,7
1100,서울특별시,강서구바선거구,6111606,1116,강서구,관외사전투표,,4417,4414,2234,1938,156,4328,86,3
1100,서울특별시,강서구바선거구,6111606,1116,강서구,염창동,계,31807,17585,7840,8431,917,17188,397,14222
1100,서울특별시,강서구바선거구,6111606,1116,강서구,염창동,관내사전투표,5167,5158,2514,2341,265,5120,38,9
1100,서울특별시,강서구바선거구,6111606,1116,강서구,염창동,선거일투표,26640,12427,5326,6090,652,12068,359,14213
1100,서울특별시,강서구바선거구,6111606,1116,강서구,등촌제1동,계,20983,9687,4397,4582,468,9447,240,11296
1100,서울특별시,강서구바선거구,6111606,1116,강서구,등촌제1동,관내사전투표,3572,3566,1722,1560,186,3468,98,6
1100,서울특별시,강서구바선거구,6111606,1116,강서구,등촌제1동,선거일투표,17411,6121,2675,3022,282,5979,142,11290
1100,서울특별시,강서구바선거구,6111606,1116,강서구,가양제3동,계,13315,7325,3083,3538,368,6989,336,5990
1100,서울특별시,강서구바선거구,6111606,1116,강서구,가양제3동,관내사전투표,2567,2565,1247,1140,138,2525,40,2
1100,서울특별시,강서구바선거구,6111606,1116,강서구,가양제3동,선거일투표,10748,4760,1836,2398,230,4464,296,5988
1100,서울특별시,강서구바선거구,6111606,1116,강서구,잘못 투입·구분된 투표지,,0,44,20,18,3,41,3,-44
1100,서울특별시,강서구사선거구,6111607,1116,강서구,검색된 결과가 없습니다.
1100,서울특별시,강서구아선거구,6111608,1116,강서구,합계,,53294,25064,11266,11168,1809,24243,821,28230
1100,서울특별시,강서구아선거구,6111608,1116,강서구,거소투표,,49,48,21,19,2,42,6,1
1100,서울특별시,강서구아선거구,6111608,1116,강서구,관외사전투표,,3307,3305,1718,1313,214,3245,60,2
1100,서울특별시,강서구아선거구,6111608,1116,강서구,화곡본동,계,28304,11333,5114,4743,1059,10916,417,16971
1100,서울특별시,강서구아선거구,6111608,1116,강서구,화곡본동,관내사전투표,3848,3845,1878,1530,314,3722,123,3
1100,서울특별시,강서구아선거구,6111608,1116,강서구,화곡본동,선거일투표,24456,7488,3236,3213,745,7194,294,16968
1100,서울특별시,강서구아선거구,6111608,1116,강서구,화곡제6동,계,21634,10347,4401,5082,530,10013,334,11287
1100,서울특별시,강서구아선거구,6111608,1116,강서구,화곡제6동,관내사전투표,3493,3487,1718,1505,202,3425,62,6
1100,서울특별시,강서구아선거구,6111608,1116,강서구,화곡제6동,선거일투표,18141,6860,2683,3577,328,6588,272,11281
1100,서울특별시,강서구아선거구,6111608,1116,강서구,잘못 투입·구분된 투표지,,0,31,12,11,4,27,4,-31
1100,서울특별시,구로구가선거구,6111701,1117,구로구,합계,,72918,39379,10476,5161,8972,7099,5630,37338,2041,33539
1100,서울특별시,구로구가선거구,6111701,1117,구로구,거소투표,,101,95,36,16,15,16,4,87,8,6
1100,서울특별시,구로구가선거구,6111701,1117,구로구,관외사전투표,,3982,3979,1354,527,895,599,422,3797,182,3
1100,서울특별시,구로구가선거구,6111701,1117,구로구,고척제1동,계,18845,9985,2394,1412,2250,1997,1464,9517,468,8860
1100,서울특별시,구로구가선거구,6111701,1117,구로구,고척제1동,관내사전투표,3818,3791,987,577,836,722,492,3614,177,27
1100,서울특별시,구로구가선거구,6111701,1117,구로구,고척제1동,선거일투표,15027,6194,1407,835,1414,1275,972,5903,291,8833
1100,서울특별시,구로구가선거구,6111701,1117,구로구,고척제2동,계,21679,11023,2839,1523,2339,2021,1702,10424,599,10656
1100,서울특별시,구로구가선거구,6111701,1117,구로구,고척제2동,관내사전투표,3217,3204,898,529,672,531,411,3041,163,13
1100,서울특별시,구로구가선거구,6111701,1117,구로구,고척제2동,선거일투표,18462,7819,1941,994,1667,1490,1291,7383,436,10643
1100,서울특별시,구로구가선거구,6111701,1117,구로구,개봉제1동,계,28311,14264,3844,1683,3460,2466,2031,13484,780,14047
1100,서울특별시,구로구가선거구,6111701,1117,구로구,개봉제1동,관내사전투표,4355,4349,1286,595,1030,638,567,4116,233,6
1100,서울특별시,구로구가선거구,6111701,1117,구로구,개봉제1동,선거일투표,23956,9915,2558,1088,2430,1828,1464,9368,547,14041
1100,서울특별시,구로구가선거구,6111701,1117,구로구,잘못 투입·구분된 투표지,,0,33,9,0,13,0,7,29,4,-33
1100,서울특별시,구로구나선거구,6111702,1117,구로구,검색된 결과가 없습니다.
1100,서울특별시,구로구다선거구,6111703,1117,구로구,합계,,86303,47333,12802,4612,10109,9263,8367,45153,2180,38970
1100,서울특별시,구로구다선거구,6111703,1117,구로구,거소투표,,114,108,25,15,23,24,11,98,10,6
1100,서울특별시,구로구다선거구,6111703,1117,구로구,관외사전투표,,4827,4817,1653,561,1120,560,682,4576,241,10
1100,서울특별시,구로구다선거구,6111703,1117,구로구,오류제1동,계,19864,9650,2646,1013,1845,2245,1436,9185,465,10214
1100,서울특별시,구로구다선거구,6111703,1117,구로구,오류제1동,관내사전투표,3535,3528,1098,404,656,697,520,3375,153,7
1100,서울특별시,구로구다선거구,6111703,1117,구로구,오류제1동,선거일투표,16329,6122,1548,609,1189,1548,916,5810,312,10207
1100,서울특별시,구로구다선거구,6111703,1117,구로구,오류제2동,계,29993,15613,4141,1501,3291,2993,2962,14888,725,14380
1100,서울특별시,구로구다선거구,6111703,1117,구로구,오류제2동,관내사전투표,4353,4348,1334,456,797,680,852,4119,229,5
1100,서울특별시,구로구다선거구,6111703,1117,구로구,오류제2동,선거일투표,25640,11265,2807,1045,2494,2313,2110,10769,496,14375
1100,서울특별시,구로구다선거구,6111703,1117,구로구,수궁동,계,19489,10413,2641,873,2500,2767,1136,9917,496,9076
1100,서울특별시,구로구다선거구,6111703,1117,구로구,수궁동,관내사전투표,3089,3077,955,288,736,623,319,2921,156,12
1100,서울특별시,구로구다선거구,6111703,1117,구로구,수궁동,선거일투표,16400,7336,1686,585,1764,2144,817,6996,340,9064
1100,서울특별시,구로구다선거구,6111703,1117,구로구,항동,계,12016,6694,1684,644,1319,669,2135,6451,243,5322
1100,서울특별시,구로구다선거구,6111703,1117,구로구,항동,관내사전투표,2379,2375,673,280,455,171,704,2283,92,4
1100,서울특별시,구로구다선거구,6111703,1117,구로구,항동,선거일투표,9637,4319,1011,364,864,498,1431,4168,151,5318
1100,서울특별시,구로구다선거구,6111703,1117,구로구,잘못 투입·구분된 투표지,,0,38,12,5,11,5,5,38,0,-38
1100,서울특별시,구로구라선거구,6111704,1117,구로구,합계,,57292,31622,13569,15755,1416,30740,882,25670
1100,서울특별시,구로구라선거구,6111704,1117,구로구,거소투표,,57,54,23,21,3,47,7,3
1100,서울특별시,구로구라선거구,6111704,1117,구로구,관외사전투표,,3296,3292,1574,1565,88,3227,65,4
1100,서울특별시,구로구라선거구,6111704,1117,구로구,신도림동,계,28279,15963,6454,8403,633,15490,473,12316
1100,서울특별시,구로구라선거구,6111704,1117,구로구,신도림동,관내사전투표,4404,4398,2054,2126,151,4331,67,6
1100,서울특별시,구로구라선거구,6111704,1117,구로구,신도림동,선거일투표,23875,11565,4400,6277,482,11159,406,12310
1100,서울특별시,구로구라선거구,6111704,1117,구로구,구로제5동,계,25660,12298,5510,5760,691,11961,337,13362
1100,서울특별시,구로구라선거구,6111704,1117,구로구,구로제5동,관내사전투표,3243,3241,1635,1323,202,3160,81,2
1100,서울특별시,구로구라선거구,6111704,1117,구로구,구로제5동,선거일투표,22417,9057,3875,4437,489,8801,256,13360
1100,서울특별시,구로구라선거구,6111704,1117,구로구,잘못 투입·구분된 투표지,,0,15,8,6,1,15,0,-15
1100,서울특별시,구로구마선거구,6111705,1117,구로구,합계,,41229,20904,9578,10277,378,20233,671,20325
1100,서울특별시,구로구마선거구,6111705,1117,구로구,거소투표,,34,30,14,13,0,27,3,4
1100,서울특별시,구로구마선거구,6111705,1117,구로구,관외사전투표,,2680,2678,1361,1213,55,2629,49,2
1100,서울특별시,구로구마선거구,6111705,1117,구로구,구로제1동,계,16650,9282,4124,4743,164,9031,251,7368
1100,서울특별시,구로구마선거구,6111705,1117,구로구,구로제1동,관내사전투표,3678,3669,1820,1767,52,3639,30,9
1100,서울특별시,구로구마선거구,6111705,1117,구로구,구로제1동,선거일투표,12972,5613,2304,2976,112,5392,221,7359
1100,서울특별시,구로구마선거구,6111705,1117,구로구,구로제2동,계,21865,8897,4065,4305,159,8529,368,12968
1100,서울특별시,구로구마선거구,6111705,1117,구로구,구로제2동,관내사전투표,2588,2584,1279,1144,42,2465,119,4
1100,서울특별시,구로구마선거구,6111705,1117,구로구,구로제2동,선거일투표,19277,6313,2786,3161,117,6064,249,12964
1100,서울특별시,구로구마선거구,6111705,1117,구로구,잘못 투입·구분된 투표지,,0,17,14,3,0,17,0,-17
1100,서울특별시,구로구바선거구,6111706,1117,구로구,검색된 결과가 없습니다.
1100,서울특별시,금천구가선거구,6111801,1118,금천구,합계,,64314,30427,15094,13419,934,29447,980,33887
1100,서울특별시,금천구가선거구,6111801,1118,금천구,거소투표,,45,43,19,16,4,39,4,2
1100,서울특별시,금천구가선거구,6111801,1118,금천구,관외사전투표,,4602,4599,2488,1918,109,4515,84,3
1100,서울특별시,금천구가선거구,6111801,1118,금천구,가산동,계,22143,8592,4405,3621,263,8289,303,13551
1100,서울특별시,금천구가선거구,6111801,1118,금천구,가산동,관내사전투표,2997,2989,1683,1108,95,2886,103,8
1100,서울특별시,금천구가선거구,6111801,1118,금천구,가산동,선거일투표,19146,5603,2722,2513,168,5403,200,13543
1100,서울특별시,금천구가선거구,6111801,1118,금천구,독산제1동,계,37524,17160,8169,7849,558,16576,584,20364
1100,서울특별시,금천구가선거구,6111801,1118,금천구,독산제1동,관내사전투표,3204,3200,1684,1365,117,3166,34,4
1100,서울특별시,금천구가선거구,6111801,1118,금천구,독산제1동,선거일투표,34320,13960,6485,6484,441,13410,550,20360
1100,서울특별시,금천구가선거구,6111801,1118,금천구,잘못 투입·구분된 투표지,,0,33,13,15,0,28,5,-33
1100,서울특별시,금천구나선거구,6111802,1118,금천구,합계,,54944,25521,6680,4297,5803,3803,747,1912,941,24183,1338,29423
1100,서울특별시,금천구나선거구,6111802,1118,금천구,거소투표,,38,36,10,4,8,5,2,0,1,30,6,2
1100,서울특별시,금천구나선거구,6111802,1118,금천구,관외사전투표,,2664,2664,892,409,635,258,127,125,72,2518,146,0
1100,서울특별시,금천구나선거구,6111802,1118,금천구,독산제2동,계,16056,6681,1731,1045,1335,1355,175,303,378,6322,359,9375
1100,서울특별시,금천구나선거구,6111802,1118,금천구,독산제2동,관내사전투표,2306,2302,625,383,434,446,36,99,142,2165,137,4
1100,서울특별시,금천구나선거구,6111802,1118,금천구,독산제2동,선거일투표,13750,4379,1106,662,901,909,139,204,236,4157,222,9371
1100,서울특별시,금천구나선거구,6111802,1118,금천구,독산제3동,계,22271,9672,2448,1763,2403,1132,263,929,230,9168,504,12599
1100,서울특별시,금천구나선거구,6111802,1118,금천구,독산제3동,관내사전투표,3546,3545,897,722,822,323,64,439,77,3344,201,1
1100,서울특별시,금천구나선거구,6111802,1118,금천구,독산제3동,선거일투표,18725,6127,1551,1041,1581,809,199,490,153,5824,303,12598
1100,서울특별시,금천구나선거구,6111802,1118,금천구,독산제4동,계,13915,6456,1597,1074,1420,1051,180,553,260,6135,321,7459
1100,서울특별시,금천구나선거구,6111802,1118,금천구,독산제4동,관내사전투표,2935,2931,761,554,584,448,69,244,130,2790,141,4
1100,서울특별시,금천구나선거구,6111802,1118,금천구,독산제4동,선거일투표,10980,3525,836,520,836,603,111,309,130,3345,180,7455
1100,서울특별시,금천구나선거구,6111802,1118,금천구,잘못 투입·구분된 투표지,,0,12,2,2,2,2,0,2,0,10,2,-12
1100,서울특별시,금천구다선거구,6111803,1118,금천구,합계,,48391,24142,11266,8722,3155,23143,999,24249
1100,서울특별시,금천구다선거구,6111803,1118,금천구,거소투표,,52,50,15,21,6,42,8,2
1100,서울특별시,금천구다선거구,6111803,1118,금천구,관외사전투표,,3236,3206,1781,954,378,3113,93,30
1100,서울특별시,금천구다선거구,6111803,1118,금천구,시흥제1동,계,27745,12632,5644,4683,1797,12124,508,15113
1100,서울특별시,금천구다선거구,6111803,1118,금천구,시흥제1동,관내사전투표,4136,4124,1952,1507,535,3994,130,12
1100,서울특별시,금천구다선거구,6111803,1118,금천구,시흥제1동,선거일투표,23609,8508,3692,3176,1262,8130,378,15101
1100,서울특별시,금천구다선거구,6111803,1118,금천구,시흥제4동,계,17358,8192,3791,3045,967,7803,389,9166
1100,서울특별시,금천구다선거구,6111803,1118,금천구,시흥제4동,관내사전투표,2827,2819,1434,980,325,2739,80,8
1100,서울특별시,금천구다선거구,6111803,1118,금천구,시흥제4동,선거일투표,14531,5373,2357,2065,642,5064,309,9158
1100,서울특별시,금천구다선거구,6111803,1118,금천구,잘못 투입·구분된 투표지,,0,62,35,19,7,61,1,-62
1100,서울특별시,금천구라선거구,6111804,1118,금천구,합계,,45230,25728,8531,9647,2491,4134,24803,925,19502
1100,서울특별시,금천구라선거구,6111804,1118,금천구,거소투표,,144,116,31,46,5,8,90,26,28
1100,서울특별시,금천구라선거구,6111804,1118,금천구,관외사전투표,,2038,2033,866,777,157,197,1997,36,5
1100,서울특별시,금천구라선거구,6111804,1118,금천구,시흥제2동,계,17055,9958,3065,3777,1195,1636,9673,285,7097
1100,서울특별시,금천구라선거구,6111804,1118,금천구,시흥제2동,관내사전투표,3199,3182,1121,1117,362,536,3136,46,17
1100,서울특별시,금천구라선거구,6111804,1118,금천구,시흥제2동,선거일투표,13856,6776,1944,2660,833,1100,6537,239,7080
1100,서울특별시,금천구라선거구,6111804,1118,금천구,시흥제3동,계,9385,5113,1894,2171,411,447,4923,190,4272
1100,서울특별시,금천구라선거구,6111804,1118,금천구,시흥제3동,관내사전투표,2114,2107,838,839,202,174,2053,54,7
1100,서울특별시,금천구라선거구,6111804,1118,금천구,시흥제3동,선거일투표,7271,3006,1056,1332,209,273,2870,136,4265
1100,서울특별시,금천구라선거구,6111804,1118,금천구,시흥제5동,계,16608,8456,2658,2856,717,1838,8069,387,8152
1100,서울특별시,금천구라선거구,6111804,1118,금천구,시흥제5동,관내사전투표,3659,3644,1210,1179,320,810,3519,125,15
1100,서울특별시,금천구라선거구,6111804,1118,금천구,시흥제5동,선거일투표,12949,4812,1448,1677,397,1028,4550,262,8137
1100,서울특별시,금천구라선거구,6111804,1118,금천구,잘못 투입·구분된 투표지,,0,52,17,20,6,8,51,1,-52
1100,서울특별시,영등포구가선거구,6111901,1119,영등포구,검색된 결과가 없습니다.
1100,서울특별시,영등포구나선거구,6111902,1119,영등포구,합계,,43840,24182,11027,11288,1467,23782,400,19658
1100,서울특별시,영등포구나선거구,6111902,1119,영등포구,거소투표,,36,33,17,11,1,29,4,3
1100,서울특별시,영등포구나선거구,6111902,1119,영등포구,관외사전투표,,2902,2902,1504,1210,130,2844,58,0
1100,서울특별시,영등포구나선거구,6111902,1119,영등포구,도림동,계,15666,7166,3140,3128,743,7011,155,8500
1100,서울특별시,영등포구나선거구,6111902,1119,영등포구,도림동,관내사전투표,2517,2515,1207,943,305,2455,60,2
1100,서울특별시,영등포구나선거구,6111902,1119,영등포구,도림동,선거일투표,13149,4651,1933,2185,438,4556,95,8498
1100,서울특별시,영등포구나선거구,6111902,1119,영등포구,문래동,계,25236,14061,6354,6933,591,13878,183,11175
1100,서울특별시,영등포구나선거구,6111902,1119,영등포구,문래동,관내사전투표,3508,3494,1688,1622,152,3462,32,14
1100,서울특별시,영등포구나선거구,6111902,1119,영등포구,문래동,선거일투표,21728,10567,4666,5311,439,10416,151,11161
1100,서울특별시,영등포구나선거구,6111902,1119,영등포구,잘못 투입·구분된 투표지,,0,20,12,6,2,20,0,-20
1100,서울특별시,영등포구다선거구,6111903,1119,영등포구,합계,,60793,31218,13746,16351,234,304,30635,583,29575
1100,서울특별시,영등포구다선거구,6111903,1119,영등포구,거소투표,,55,49,17,25,3,0,45,4,6
1100,서울특별시,영등포구다선거구,6111903,1119,영등포구,관외사전투표,,5795,5773,2945,2630,25,65,5665,108,22
1100,서울특별시,영등포구다선거구,6111903,1119,영등포구,영등포동,계,24737,9569,4276,4930,70,89,9365,204,15168
1100,서울특별시,영등포구다선거구,6111903,1119,영등포구,영등포동,관내사전투표,2383,2377,1232,1057,15,20,2324,53,6
1100,서울특별시,영등포구다선거구,6111903,1119,영등포구,영등포동,선거일투표,22354,7192,3044,3873,55,69,7041,151,15162
1100,서울특별시,영등포구다선거구,6111903,1119,영등포구,당산제2동,계,30206,15793,6487,8753,136,150,15526,267,14413
1100,서울특별시,영등포구다선거구,6111903,1119,영등포구,당산제2동,관내사전투표,4058,4054,1826,2080,25,39,3970,84,4
1100,서울특별시,영등포구다선거구,6111903,1119,영등포구,당산제2동,선거일투표,26148,11739,4661,6673,111,111,11556,183,14409
1100,서울특별시,영등포구다선거구,6111903,1119,영등포구,잘못 투입·구분된 투표지,,0,34,21,13,0,0,34,0,-34
1100,서울특별시,영등포구라선거구,6111904,1119,영등포구,합계,,54701,29198,13551,9210,5726,28487,711,25503
1100,서울특별시,영등포구라선거구,6111904,1119,영등포구,거소투표,,44,43,21,12,10,43,0,1
1100,서울특별시,영등포구라선거구,6111904,1119,영등포구,관외사전투표,,3920,3920,2019,1267,524,3810,110,0
1100,서울특별시,영등포구라선거구,6111904,1119,영등포구,당산제1동,계,17170,8419,3665,2981,1562,8208,211,8751
1100,서울특별시,영등포구라선거구,6111904,1119,영등포구,당산제1동,관내사전투표,2515,2505,1170,820,442,2432,73,10
1100,서울특별시,영등포구라선거구,6111904,1119,영등포구,당산제1동,선거일투표,14655,5914,2495,2161,1120,5776,138,8741
1100,서울특별시,영등포구라선거구,6111904,1119,영등포구,양평제1동,계,15415,7392,3480,2421,1301,7202,190,8023
1100,서울특별시,영등포구라선거구,6111904,1119,영등포구,양평제1동,관내사전투표,2700,2687,1402,795,443,2640,47,13
1100,서울특별시,영등포구라선거구,6111904,1119,영등포구,양평제1동,선거일투표,12715,4705,2078,1626,858,4562,143,8010
1100,서울특별시,영등포구라선거구,6111904,1119,영등포구,양평제2동,계,18152,9393,4346,2522,2327,9195,198,8759
1100,서울특별시,영등포구라선거구,6111904,1119,영등포구,양평제2동,관내사전투표,2728,2723,1381,613,665,2659,64,5
1100,서울특별시,영등포구라선거구,6111904,1119,영등포구,양평제2동,선거일투표,15424,6670,2965,1909,1662,6536,134,8754
1100,서울특별시,영등포구라선거구,6111904,1119,영등포구,잘못 투입·구분된 투표지,,0,31,20,7,2,29,2,-31
1100,서울특별시,영등포구마선거구,6111905,1119,영등포구,검색된 결과가 없습니다.
1100,서울특별시,영등포구바선거구,6111906,1119,영등포구,검색된 결과가 없습니다.
1100,서울특별시,영등포구사선거구,6111907,1119,영등포구,합계,,64698,32552,8097,5349,8090,5286,1102,2903,30827,1725,32146
1100,서울특별시,영등포구사선거구,6111907,1119,영등포구,거소투표,,69,67,17,10,17,11,0,8,63,4,2
1100,서울특별시,영등포구사선거구,6111907,1119,영등포구,관외사전투표,,4000,3990,1246,670,1039,476,113,239,3783,207,10
1100,서울특별시,영등포구사선거구,6111907,1119,영등포구,신길제6동,계,15659,7627,1878,1149,1713,1905,379,209,7233,394,8032
1100,서울특별시,영등포구사선거구,6111907,1119,영등포구,신길제6동,관내사전투표,2359,2356,655,385,452,588,101,63,2244,112,3
1100,서울특별시,영등포구사선거구,6111907,1119,영등포구,신길제6동,선거일투표,13300,5271,1223,764,1261,1317,278,146,4989,282,8029
1100,서울특별시,영등포구사선거구,6111907,1119,영등포구,대림제1동,계,13172,6402,1614,1158,1546,1070,184,489,6061,341,6770
1100,서울특별시,영등포구사선거구,6111907,1119,영등포구,대림제1동,관내사전투표,2731,2730,721,531,601,440,72,213,2578,152,1
1100,서울특별시,영등포구사선거구,6111907,1119,영등포구,대림제1동,선거일투표,10441,3672,893,627,945,630,112,276,3483,189,6769
1100,서울특별시,영등포구사선거구,6111907,1119,영등포구,대림제2동,계,12423,5043,1305,1013,1242,723,98,372,4753,290,7380
1100,서울특별시,영등포구사선거구,6111907,1119,영등포구,대림제2동,관내사전투표,1799,1798,487,410,372,232,32,155,1688,110,1
1100,서울특별시,영등포구사선거구,6111907,1119,영등포구,대림제2동,선거일투표,10624,3245,818,603,870,491,66,217,3065,180,7379
1100,서울특별시,영등포구사선거구,6111907,1119,영등포구,대림제3동,계,19375,9410,2034,1346,2530,1098,328,1586,8922,488,9965
1100,서울특별시,영등포구사선거구,6111907,1119,영등포구,대림제3동,관내사전투표,2645,2645,614,455,679,264,83,437,2532,113,0
1100,서울특별시,영등포구사선거구,6111907,1119,영등포구,대림제3동,선거일투표,16730,6765,1420,891,1851,834,245,1149,6390,375,9965
1100,서울특별시,영등포구사선거구,6111907,1119,영등포구,잘못 투입·구분된 투표지,,0,13,3,3,3,3,0,0,12,1,-13
1100,서울특별시,동작구가선거구,6112001,1120,동작구,검색된 결과가 없습니다.
1100,서울특별시,동작구나선거구,6112002,1120,동작구,합계,,49846,26344,11436,12187,2207,25830,514,23502
1100,서울특별시,동작구나선거구,6112002,1120,동작구,거소투표,,50,46,17,14,8,39,7,4
1100,서울특별시,동작구나선거구,6112002,1120,동작구,관외사전투표,,5041,5039,2509,2160,290,4959,80,2
1100,서울특별시,동작구나선거구,6112002,1120,동작구,상도제2동,계,21761,10981,4412,5684,701,10797,184,10780
1100,서울특별시,동작구나선거구,6112002,1120,동작구,상도제2동,관내사전투표,3777,3776,1690,1791,233,3714,62,1
1100,서울특별시,동작구나선거구,6112002,1120,동작구,상도제2동,선거일투표,17984,7205,2722,3893,468,7083,122,10779
1100,서울특별시,동작구나선거구,6112002,1120,동작구,상도제4동,계,22994,10272,4496,4328,1206,10030,242,12722
1100,서울특별시,동작구나선거구,6112002,1120,동작구,상도제4동,관내사전투표,3864,3861,1783,1556,426,3765,96,3
1100,서울특별시,동작구나선거구,6112002,1120,동작구,상도제4동,선거일투표,19130,6411,2713,2772,780,6265,146,12719
1100,서울특별시,동작구나선거구,6112002,1120,동작구,잘못 투입·구분된 투표지,,0,6,2,1,2,5,1,-6
1100,서울특별시,동작구다선거구,6112003,1120,동작구,합계,,55109,29677,13078,12928,3140,29146,531,25432
1100,서울특별시,동작구다선거구,6112003,1120,동작구,거소투표,,74,72,30,24,5,59,13,2
1100,서울특별시,동작구다선거구,6112003,1120,동작구,관외사전투표,,4392,4386,2265,1758,298,4321,65,6
1100,서울특별시,동작구다선거구,6112003,1120,동작구,상도제3동,계,21361,10690,4510,4208,1724,10442,248,10671
1100,서울특별시,동작구다선거구,6112003,1120,동작구,상도제3동,관내사전투표,4312,4310,1921,1621,671,4213,97,2
1100,서울특별시,동작구다선거구,6112003,1120,동작구,상도제3동,선거일투표,17049,6380,2589,2587,1053,6229,151,10669
1100,서울특별시,동작구다선거구,6112003,1120,동작구,대방동,계,29282,14502,6262,6924,1112,14298,204,14780
1100,서울특별시,동작구다선거구,6112003,1120,동작구,대방동,관내사전투표,4224,4210,1945,1908,301,4154,56,14
1100,서울특별시,동작구다선거구,6112003,1120,동작구,대방동,선거일투표,25058,10292,4317,5016,811,10144,148,14766
1100,서울특별시,동작구다선거구,6112003,1120,동작구,잘못 투입·구분된 투표지,,0,27,11,14,1,26,1,-27
1100,서울특별시,동작구라선거구,6112004,1120,동작구,검색된 결과가 없습니다.
1100,서울특별시,동작구마선거구,6112005,1120,동작구,검색된 결과가 없습니다.
1100,서울특별시,동작구바선거구,6112006,1120,동작구,검색된 결과가 없습니다.
1100,서울특별시,동작구사선거구,6112007,1120,동작구,합계,,74257,41086,10499,4217,10800,10672,3084,39272,1814,33171
1100,서울특별시,동작구사선거구,6112007,1120,동작구,거소투표,,75,69,20,5,20,12,2,59,10,6
1100,서울특별시,동작구사선거구,6112007,1120,동작구,관외사전투표,,5103,5098,1592,546,1457,954,316,4865,233,5
1100,서울특별시,동작구사선거구,6112007,1120,동작구,흑석동,계,25726,13672,2755,1470,3866,3955,1074,13120,552,12054
1100,서울특별시,동작구사선거구,6112007,1120,동작구,흑석동,관내사전투표,4555,4547,1005,557,1210,1263,321,4356,191,8
1100,서울특별시,동작구사선거구,6112007,1120,동작구,흑석동,선거일투표,21171,9125,1750,913,2656,2692,753,8764,361,12046
1100,서울특별시,동작구사선거구,6112007,1120,동작구,사당제1동,계,19743,9100,3005,924,2472,1610,661,8672,428,10643
1100,서울특별시,동작구사선거구,6112007,1120,동작구,사당제1동,관내사전투표,2710,2708,979,293,655,438,191,2556,152,2
1100,서울특별시,동작구사선거구,6112007,1120,동작구,사당제1동,선거일투표,17033,6392,2026,631,1817,1172,470,6116,276,10641
1100,서울특별시,동작구사선거구,6112007,1120,동작구,사당제2동,계,23610,13125,3123,1271,2980,4132,1029,12535,590,10485
1100,서울특별시,동작구사선거구,6112007,1120,동작구,사당제2동,관내사전투표,5095,5091,1435,575,1013,1493,340,4856,235,4
1100,서울특별시,동작구사선거구,6112007,1120,동작구,사당제2동,선거일투표,18515,8034,1688,696,1967,2639,689,7679,355,10481
1100,서울특별시,동작구사선거구,6112007,1120,동작구,잘못 투입·구분된 투표지,,0,22,4,1,5,9,2,21,1,-22
1100,서울특별시,관악구가선거구,6112101,1121,관악구,합계,,74001,35242,11504,8152,9271,3496,32423,2819,38759
1100,서울특별시,관악구가선거구,6112101,1121,관악구,거소투표,,63,58,17,10,20,5,52,6,5
1100,서울특별시,관악구가선거구,6112101,1121,관악구,관외사전투표,,4157,4154,1653,806,1158,280,3897,257,3
1100,서울특별시,관악구가선거구,6112101,1121,관악구,보라매동,계,21094,9846,2862,2558,2337,1179,8936,910,11248
1100,서울특별시,관악구가선거구,6112101,1121,관악구,보라매동,관내사전투표,3018,3015,948,911,629,325,2813,202,3
1100,서울특별시,관악구가선거구,6112101,1121,관악구,보라매동,선거일투표,18076,6831,1914,1647,1708,854,6123,708,11245
1100,서울특별시,관악구가선거구,6112101,1121,관악구,은천동,계,27315,13796,3935,3773,3667,1336,12711,1085,13519
1100,서울특별시,관악구가선거구,6112101,1121,관악구,은천동,관내사전투표,4841,4836,1473,1452,1160,390,4475,361,5
1100,서울특별시,관악구가선거구,6112101,1121,관악구,은천동,선거일투표,22474,8960,2462,2321,2507,946,8236,724,13514
1100,서울특별시,관악구가선거구,6112101,1121,관악구,신림동,계,21372,7364,3029,1002,2082,694,6807,557,14008
1100,서울특별시,관악구가선거구,6112101,1121,관악구,신림동,관내사전투표,2886,2884,1289,449,713,235,2686,198,2
1100,서울특별시,관악구가선거구,6112101,1121,관악구,신림동,선거일투표,18486,4480,1740,553,1369,459,4121,359,14006
1100,서울특별시,관악구가선거구,6112101,1121,관악구,잘못 투입·구분된 투표지,,0,24,8,3,7,2,20,4,-24
1100,서울특별시,관악구나선거구,6112102,1121,관악구,합계,,48265,23680,9385,4114,9017,22516,1164,24585
1100,서울특별시,관악구나선거구,6112102,1121,관악구,거소투표,,40,34,11,5,15,31,3,6
1100,서울특별시,관악구나선거구,6112102,1121,관악구,관외사전투표,,3521,3518,1542,541,1317,3400,118,3
1100,서울특별시,관악구나선거구,6112102,1121,관악구,중앙동,계,13663,6040,2436,979,2214,5629,411,7623
1100,서울특별시,관악구나선거구,6112102,1121,관악구,중앙동,관내사전투표,2418,2414,1050,477,788,2315,99,4
1100,서울특별시,관악구나선거구,6112102,1121,관악구,중앙동,선거일투표,11245,3626,1386,502,1426,3314,312,7619
1100,서울특별시,관악구나선거구,6112102,1121,관악구,청룡동,계,31041,14066,5385,2585,5466,13436,630,16975
1100,서울특별시,관악구나선거구,6112102,1121,관악구,청룡동,관내사전투표,3985,3975,1668,799,1406,3873,102,10
1100,서울특별시,관악구나선거구,6112102,1121,관악구,청룡동,선거일투표,27056,10091,3717,1786,4060,9563,528,16965
1100,서울특별시,관악구나선거구,6112102,1121,관악구,잘못 투입·구분된 투표지,,0,22,11,4,5,20,2,-22
1100,서울특별시,관악구다선거구,6112103,1121,관악구,합계,,65391,36408,12007,6856,8581,5927,33371,3037,28983
1100,서울특별시,관악구다선거구,6112103,1121,관악구,거소투표,,73,68,26,8,16,5,55,13,5
1100,서울특별시,관악구다선거구,6112103,1121,관악구,관외사전투표,,4438,4435,1537,984,1052,549,4122,313,3
1100,서울특별시,관악구다선거구,6112103,1121,관악구,성현동,계,23228,12598,3756,2516,2785,2383,11440,1158,10630
1100,서울특별시,관악구다선거구,6112103,1121,관악구,성현동,관내사전투표,3172,3163,957,751,690,500,2898,265,9
1100,서울특별시,관악구다선거구,6112103,1121,관악구,성현동,선거일투표,20056,9435,2799,1765,2095,1883,8542,893,10621
1100,서울특별시,관악구다선거구,6112103,1121,관악구,청림동,계,12441,7347,2573,1232,1827,1174,6806,541,5094
1100,서울특별시,관악구다선거구,6112103,1121,관악구,청림동,관내사전투표,2440,2429,909,453,598,356,2316,113,11
1100,서울특별시,관악구다선거구,6112103,1121,관악구,청림동,선거일투표,10001,4918,1664,779,1229,818,4490,428,5083
1100,서울특별시,관악구다선거구,6112103,1121,관악구,행운동,계,25211,11888,4095,2102,2887,1802,10886,1002,13323
1100,서울특별시,관악구다선거구,6112103,1121,관악구,행운동,관내사전투표,3590,3559,1342,719,737,482,3280,279,31
1100,서울특별시,관악구다선거구,6112103,1121,관악구,행운동,선거일투표,21621,8329,2753,1383,2150,1320,7606,723,13292
1100,서울특별시,관악구다선거구,6112103,1121,관악구,잘못 투입·구분된 투표지,,0,72,20,14,14,14,62,10,-72
1100,서울특별시,관악구라선거구,6112104,1121,관악구,검색된 결과가 없습니다.
1100,서울특별시,관악구마선거구,6112105,1121,관악구,합계,,66282,32230,9310,4908,8159,4589,3587,30553,1677,34052
1100,서울특별시,관악구마선거구,6112105,1121,관악구,거소투표,,72,66,19,9,21,7,5,61,5,6
1100,서울특별시,관악구마선거구,6112105,1121,관악구,관외사전투표,,3479,3472,1112,625,874,345,369,3325,147,7
1100,서울특별시,관악구마선거구,6112105,1121,관악구,신사동,계,20846,8693,2339,1255,1836,1500,1343,8273,420,12153
1100,서울특별시,관악구마선거구,6112105,1121,관악구,신사동,관내사전투표,3431,3426,1060,526,654,567,461,3268,158,5
1100,서울특별시,관악구마선거구,6112105,1121,관악구,신사동,선거일투표,17415,5267,1279,729,1182,933,882,5005,262,12148
1100,서울특별시,관악구마선거구,6112105,1121,관악구,조원동,계,15972,7173,1971,1192,1812,1000,787,6762,411,8799
1100,서울특별시,관악구마선거구,6112105,1121,관악구,조원동,관내사전투표,2888,2868,904,498,654,375,297,2728,140,20
1100,서울특별시,관악구마선거구,6112105,1121,관악구,조원동,선거일투표,13084,4305,1067,694,1158,625,490,4034,271,8779
1100,서울특별시,관악구마선거구,6112105,1121,관악구,미성동,계,25913,12792,3861,1822,3606,1730,1081,12100,692,13121
1100,서울특별시,관악구마선거구,6112105,1121,관악구,미성동,관내사전투표,3856,3848,1348,595,964,465,272,3644,204,8
1100,서울특별시,관악구마선거구,6112105,1121,관악구,미성동,선거일투표,22057,8944,2513,1227,2642,1265,809,8456,488,13113
1100,서울특별시,관악구마선거구,6112105,1121,관악구,잘못 투입·구분된 투표지,,0,34,8,5,10,7,2,32,2,-34
1100,서울특별시,관악구바선거구,6112106,1121,관악구,검색된 결과가 없습니다.
1100,서울특별시,관악구사선거구,6112107,1121,관악구,합계,,60646,28586,12352,12015,2252,760,27379,1207,32060
1100,서울특별시,관악구사선거구,6112107,1121,관악구,거소투표,,55,53,23,13,4,5,45,8,2
1100,서울특별시,관악구사선거구,6112107,1121,관악구,관외사전투표,,4307,4303,2163,1609,330,117,4219,84,4
1100,서울특별시,관악구사선거구,6112107,1121,관악구,서원동,계,20498,8442,3590,3611,699,165,8065,377,12056
1100,서울특별시,관악구사선거구,6112107,1121,관악구,서원동,관내사전투표,3117,3106,1516,1249,238,57,3060,46,11
1100,서울특별시,관악구사선거구,6112107,1121,관악구,서원동,선거일투표,17381,5336,2074,2362,461,108,5005,331,12045
1100,서울특별시,관악구사선거구,6112107,1121,관악구,신원동,계,16244,7125,3044,3014,494,285,6837,288,9119
1100,서울특별시,관악구사선거구,6112107,1121,관악구,신원동,관내사전투표,3105,3101,1491,1233,196,120,3040,61,4
1100,서울특별시,관악구사선거구,6112107,1121,관악구,신원동,선거일투표,13139,4024,1553,1781,298,165,3797,227,9115
1100,서울특별시,관악구사선거구,6112107,1121,관악구,서림동,계,19542,8632,3518,3759,720,188,8185,447,10910
1100,서울특별시,관악구사선거구,6112107,1121,관악구,서림동,관내사전투표,1932,1930,949,733,167,39,1888,42,2
1100,서울특별시,관악구사선거구,6112107,1121,관악구,서림동,선거일투표,17610,6702,2569,3026,553,149,6297,405,10908
1100,서울특별시,관악구사선거구,6112107,1121,관악구,잘못 투입·구분된 투표지,,0,31,14,9,5,0,28,3,-31
1100,서울특별시,관악구아선거구,6112108,1121,관악구,합계,,41638,22266,7958,8610,4407,346,21321,945,19372
1100,서울특별시,관악구아선거구,6112108,1121,관악구,거소투표,,50,41,14,15,7,1,37,4,9
1100,서울특별시,관악구아선거구,6112108,1121,관악구,관외사전투표,,2688,2684,1151,1020,410,46,2627,57,4
1100,서울특별시,관악구아선거구,6112108,1121,관악구,삼성동,계,18289,10229,3636,3982,2079,143,9840,389,8060
1100,서울특별시,관악구아선거구,6112108,1121,관악구,삼성동,관내사전투표,3556,3554,1473,1289,695,44,3501,53,2
1100,서울특별시,관악구아선거구,6112108,1121,관악구,삼성동,선거일투표,14733,6675,2163,2693,1384,99,6339,336,8058
1100,서울특별시,관악구아선거구,6112108,1121,관악구,대학동,계,20611,9286,3153,3580,1908,156,8797,489,11325
1100,서울특별시,관악구아선거구,6112108,1121,관악구,대학동,관내사전투표,3619,3617,1462,1280,772,56,3570,47,2
1100,서울특별시,관악구아선거구,6112108,1121,관악구,대학동,선거일투표,16992,5669,1691,2300,1136,100,5227,442,11323
1100,서울특별시,관악구아선거구,6112108,1121,관악구,잘못 투입·구분된 투표지,,0,26,4,13,3,0,20,6,-26
1100,서울특별시,서초구가선거구,6112201,1122,서초구,합계,,83558,45950,7700,2764,15003,13756,4243,996,44462,1488,37608
1100,서울특별시,서초구가선거구,6112201,1122,서초구,거소투표,,66,65,7,6,19,21,3,1,57,8,1
1100,서울특별시,서초구가선거구,6112201,1122,서초구,관외사전투표,,4719,4715,1097,403,1607,1007,310,84,4508,207,4
1100,서울특별시,서초구가선거구,6112201,1122,서초구,잠원동,계,20664,10938,1722,653,3228,3614,1172,240,10629,309,9726
1100,서울특별시,서초구가선거구,6112201,1122,서초구,잠원동,관내사전투표,2928,2926,517,215,794,942,323,54,2845,81,2
1100,서울특별시,서초구가선거구,6112201,1122,서초구,잠원동,선거일투표,17736,8012,1205,438,2434,2672,849,186,7784,228,9724
1100,서울특별시,서초구가선거구,6112201,1122,서초구,반포1동,계,26603,12536,2216,737,4051,3681,1164,310,12159,377,14067
1100,서울특별시,서초구가선거구,6112201,1122,서초구,반포1동,관내사전투표,3232,3230,647,209,997,927,290,75,3145,85,2
1100,서울특별시,서초구가선거구,6112201,1122,서초구,반포1동,선거일투표,23371,9306,1569,528,3054,2754,874,235,9014,292,14065
1100,서울특별시,서초구가선거구,6112201,1122,서초구,반포3동,계,16952,10033,1288,490,3375,3375,1002,193,9723,310,6919
1100,서울특별시,서초구가선거구,6112201,1122,서초구,반포3동,관내사전투표,3076,3076,440,172,981,1028,299,46,2966,110,0
1100,서울특별시,서초구가선거구,6112201,1122,서초구,반포3동,선거일투표,13876,6957,848,318,2394,2347,703,147,6757,200,6919
1100,서울특별시,서초구가선거구,6112201,1122,서초구,반포4동,계,14554,7648,1368,475,2719,2052,591,167,7372,276,6906
1100,서울특별시,서초구가선거구,6112201,1122,서초구,반포4동,관내사전투표,1918,1916,408,131,694,414,151,33,1831,85,2
1100,서울특별시,서초구가선거구,6112201,1122,서초구,반포4동,선거일투표,12636,5732,960,344,2025,1638,440,134,5541,191,6904
1100,서울특별시,서초구가선거구,6112201,1122,서초구,잘못 투입·구분된 투표지,,0,15,2,0,4,6,1,1,14,1,-15
1100,서울특별시,서초구나선거구,6112202,1122,서초구,합계,,63764,36638,7480,3284,15509,7855,34128,2510,27126
1100,서울특별시,서초구나선거구,6112202,1122,서초구,거소투표,,53,49,10,7,18,7,42,7,4
1100,서울특별시,서초구나선거구,6112202,1122,서초구,관외사전투표,,3672,3656,1014,385,1510,469,3378,278,16
1100,서울특별시,서초구나선거구,6112202,1122,서초구,반포본동,계,570,235,50,18,104,50,222,13,335
1100,서울특별시,서초구나선거구,6112202,1122,서초구,반포본동,관내사전투표,183,183,44,17,79,34,174,9,0
1100,서울특별시,서초구나선거구,6112202,1122,서초구,반포본동,선거일투표,387,52,6,1,25,16,48,4,335
1100,서울특별시,서초구나선거구,6112202,1122,서초구,반포2동,계,11159,6766,789,344,3687,1563,6383,383,4393
1100,서울특별시,서초구나선거구,6112202,1122,서초구,반포2동,관내사전투표,1628,1627,237,102,794,398,1531,96,1
1100,서울특별시,서초구나선거구,6112202,1122,서초구,반포2동,선거일투표,9531,5139,552,242,2893,1165,4852,287,4392
1100,서울특별시,서초구나선거구,6112202,1122,서초구,방배본동,계,16323,9066,1844,745,3811,2082,8482,584,7257
1100,서울특별시,서초구나선거구,6112202,1122,서초구,방배본동,관내사전투표,2807,2805,647,276,1082,648,2653,152,2
1100,서울특별시,서초구나선거구,6112202,1122,서초구,방배본동,선거일투표,13516,6261,1197,469,2729,1434,5829,432,7255
1100,서울특별시,서초구나선거구,6112202,1122,서초구,방배1동,계,13603,7265,1612,797,2697,1607,6713,552,6338
1100,서울특별시,서초구나선거구,6112202,1122,서초구,방배1동,관내사전투표,2232,2231,574,289,719,458,2040,191,1
1100,서울특별시,서초구나선거구,6112202,1122,서초구,방배1동,선거일투표,11371,5034,1038,508,1978,1149,4673,361,6337
1100,서울특별시,서초구나선거구,6112202,1122,서초구,방배4동,계,18384,9570,2157,982,3672,2069,8880,690,8814
1100,서울특별시,서초구나선거구,6112202,1122,서초구,방배4동,관내사전투표,2886,2877,734,361,986,572,2653,224,9
1100,서울특별시,서초구나선거구,6112202,1122,서초구,방배4동,선거일투표,15498,6693,1423,621,2686,1497,6227,466,8805
1100,서울특별시,서초구나선거구,6112202,1122,서초구,잘못 투입·구분된 투표지,,0,31,4,6,10,8,28,3,-31
1100,서울특별시,서초구다선거구,6112203,1122,서초구,검색된 결과가 없습니다.
1100,서울특별시,서초구라선거구,6112204,1122,서초구,합계,,46739,26712,6295,12597,7184,104,26180,532,20027
1100,서울특별시,서초구라선거구,6112204,1122,서초구,거소투표,,38,35,6,11,15,1,33,2,3
1100,서울특별시,서초구라선거구,6112204,1122,서초구,관외사전투표,,3303,3270,963,1599,628,14,3204,66,33
1100,서울특별시,서초구라선거구,6112204,1122,서초구,서초2동,계,20919,10898,2978,4567,3057,43,10645,253,10021
1100,서울특별시,서초구라선거구,6112204,1122,서초구,서초2동,관내사전투표,3530,3528,1029,1374,1038,14,3455,73,2
1100,서울특별시,서초구라선거구,6112204,1122,서초구,서초2동,선거일투표,17389,7370,1949,3193,2019,29,7190,180,10019
1100,서울특별시,서초구라선거구,6112204,1122,서초구,서초4동,계,22479,12464,2343,6388,3478,46,12255,209,10015
1100,서울특별시,서초구라선거구,6112204,1122,서초구,서초4동,관내사전투표,2569,2567,581,1181,764,3,2529,38,2
1100,서울특별시,서초구라선거구,6112204,1122,서초구,서초4동,선거일투표,19910,9897,1762,5207,2714,43,9726,171,10013
1100,서울특별시,서초구라선거구,6112204,1122,서초구,잘못 투입·구분된 투표지,,0,45,5,32,6,0,43,2,-45
1100,서울특별시,서초구마선거구,6112205,1122,서초구,검색된 결과가 없습니다.
1100,서울특별시,강남구가선거구,6112301,1123,강남구,검색된 결과가 없습니다.
1100,서울특별시,강남구나선거구,6112302,1123,강남구,검색된 결과가 없습니다.
1100,서울특별시,강남구다선거구,6112303,1123,강남구,합계,,81332,35540,8979,2490,14286,6813,32568,2972,45792
1100,서울특별시,강남구다선거구,6112303,1123,강남구,거소투표,,75,67,21,7,25,6,59,8,8
1100,서울특별시,강남구다선거구,6112303,1123,강남구,관외사전투표,,5129,5126,1581,469,1964,724,4738,388,3
1100,서울특별시,강남구다선거구,6112303,1123,강남구,논현2동,계,17642,7024,1532,401,3107,1270,6310,714,10618
1100,서울특별시,강남구다선거구,6112303,1123,강남구,논현2동,관내사전투표,1687,1651,420,112,717,250,1499,152,36
1100,서울특별시,강남구다선거구,6112303,1123,강남구,논현2동,선거일투표,15955,5373,1112,289,2390,1020,4811,562,10582
1100,서울특별시,강남구다선거구,6112303,1123,강남구,역삼1동,계,31176,10303,3001,816,4021,1593,9431,872,20873
1100,서울특별시,강남구다선거구,6112303,1123,강남구,역삼1동,관내사전투표,2649,2644,918,298,847,395,2458,186,5
1100,서울특별시,강남구다선거구,6112303,1123,강남구,역삼1동,선거일투표,28527,7659,2083,518,3174,1198,6973,686,20868
1100,서울특별시,강남구다선거구,6112303,1123,강남구,역삼2동,계,27310,12953,2826,792,5142,3216,11976,977,14357
1100,서울특별시,강남구다선거구,6112303,1123,강남구,역삼2동,관내사전투표,3647,3645,890,302,1373,817,3382,263,2
1100,서울특별시,강남구다선거구,6112303,1123,강남구,역삼2동,선거일투표,23663,9308,1936,490,3769,2399,8594,714,14355
1100,서울특별시,강남구다선거구,6112303,1123,강남구,잘못 투입·구분된 투표지,,0,67,18,5,27,4,54,13,-67
1100,서울특별시,강남구라선거구,6112304,1123,강남구,합계,,49192,29501,8270,13571,6899,28740,761,19691
1100,서울특별시,강남구라선거구,6112304,1123,강남구,거소투표,,50,48,16,19,9,44,4,2
1100,서울특별시,강남구라선거구,6112304,1123,강남구,관외사전투표,,3500,3497,1322,1541,573,3436,61,3
1100,서울특별시,강남구라선거구,6112304,1123,강남구,개포1동,계,5926,3815,842,1842,1026,3710,105,2111
1100,서울특별시,강남구라선거구,6112304,1123,강남구,개포1동,관내사전투표,1232,1231,254,615,332,1201,30,1
1100,서울특별시,강남구라선거구,6112304,1123,강남구,개포1동,선거일투표,4694,2584,588,1227,694,2509,75,2110
1100,서울특별시,강남구라선거구,6112304,1123,강남구,개포2동,계,20785,12489,2958,6156,3047,12161,328,8296
1100,서울특별시,강남구라선거구,6112304,1123,강남구,개포2동,관내사전투표,2643,2641,743,1231,639,2613,28,2
1100,서울특별시,강남구라선거구,6112304,1123,강남구,개포2동,선거일투표,18142,9848,2215,4925,2408,9548,300,8294
1100,서울특별시,강남구라선거구,6112304,1123,강남구,개포4동,계,18931,9638,3127,4008,2241,9376,262,9293
1100,서울특별시,강남구라선거구,6112304,1123,강남구,개포4동,관내사전투표,2867,2866,1061,1113,634,2808,58,1
1100,서울특별시,강남구라선거구,6112304,1123,강남구,개포4동,선거일투표,16064,6772,2066,2895,1607,6568,204,9292
1100,서울특별시,강남구라선거구,6112304,1123,강남구,잘못 투입·구분된 투표지,,0,14,5,5,3,13,1,-14
1100,서울특별시,강남구마선거구,6112305,1123,강남구,검색된 결과가 없습니다.
1100,서울특별시,강남구바선거구,6112306,1123,강남구,합계,,49071,27512,10441,12111,3494,306,26352,1160,21559
1100,서울특별시,강남구바선거구,6112306,1123,강남구,거소투표,,57,53,31,15,3,1,50,3,4
1100,서울특별시,강남구바선거구,6112306,1123,강남구,관외사전투표,,3424,3422,1435,1413,435,46,3329,93,2
1100,서울특별시,강남구바선거구,6112306,1123,강남구,수서동,계,12860,7302,2443,3311,1092,78,6924,378,5558
1100,서울특별시,강남구바선거구,6112306,1123,강남구,수서동,관내사전투표,2476,2470,924,1134,305,24,2387,83,6
1100,서울특별시,강남구바선거구,6112306,1123,강남구,수서동,선거일투표,10384,4832,1519,2177,787,54,4537,295,5552
1100,서울특별시,강남구바선거구,6112306,1123,강남구,세곡동,계,32730,16706,6516,7364,1963,181,16024,682,16024
1100,서울특별시,강남구바선거구,6112306,1123,강남구,세곡동,관내사전투표,3960,3945,1753,1694,410,36,3893,52,15
1100,서울특별시,강남구바선거구,6112306,1123,강남구,세곡동,선거일투표,28770,12761,4763,5670,1553,145,12131,630,16009
1100,서울특별시,강남구바선거구,6112306,1123,강남구,잘못 투입·구분된 투표지,,0,29,16,8,1,0,25,4,-29
1100,서울특별시,강남구사선거구,6112307,1123,강남구,합계,,35124,18789,4386,10887,3132,18405,384,16335
1100,서울특별시,강남구사선거구,6112307,1123,강남구,거소투표,,30,27,5,16,3,24,3,3
1100,서울특별시,강남구사선거구,6112307,1123,강남구,관외사전투표,,1957,1955,621,1106,177,1904,51,2
1100,서울특별시,강남구사선거구,6112307,1123,강남구,대치1동,계,16911,10113,1462,6405,2054,9921,192,6798
1100,서울특별시,강남구사선거구,6112307,1123,강남구,대치1동,관내사전투표,2431,2430,421,1474,486,2381,49,1
1100,서울특별시,강남구사선거구,6112307,1123,강남구,대치1동,선거일투표,14480,7683,1041,4931,1568,7540,143,6797
1100,서울특별시,강남구사선거구,6112307,1123,강남구,대치4동,계,16226,6683,2296,3354,895,6545,138,9543
1100,서울특별시,강남구사선거구,6112307,1123,강남구,대치4동,관내사전투표,2204,2204,856,1031,262,2149,55,0
1100,서울특별시,강남구사선거구,6112307,1123,강남구,대치4동,선거일투표,14022,4479,1440,2323,633,4396,83,9543
1100,서울특별시,강남구사선거구,6112307,1123,강남구,잘못 투입·구분된 투표지,,0,11,2,6,3,11,0,-11
1100,서울특별시,강남구아선거구,6112308,1123,강남구,합계,,44392,26506,5414,14628,5965,26007,499,17886
1100,서울특별시,강남구아선거구,6112308,1123,강남구,거소투표,,33,29,9,13,5,27,2,4
1100,서울특별시,강남구아선거구,6112308,1123,강남구,관외사전투표,,3038,3036,787,1671,516,2974,62,2
1100,서울특별시,강남구아선거구,6112308,1123,강남구,도곡1동,계,16755,9347,2553,4475,2139,9167,180,7408
1100,서울특별시,강남구아선거구,6112308,1123,강남구,도곡1동,관내사전투표,2826,2824,887,1248,648,2783,41,2
1100,서울특별시,강남구아선거구,6112308,1123,강남구,도곡1동,선거일투표,13929,6523,1666,3227,1491,6384,139,7406
1100,서울특별시,강남구아선거구,6112308,1123,강남구,도곡2동,계,24566,14079,2064,8461,3301,13826,253,10487
1100,서울특별시,강남구아선거구,6112308,1123,강남구,도곡2동,관내사전투표,2134,2128,429,1205,457,2091,37,6
1100,서울특별시,강남구아선거구,6112308,1123,강남구,도곡2동,선거일투표,22432,11951,1635,7256,2844,11735,216,10481
1100,서울특별시,강남구아선거구,6112308,1123,강남구,잘못 투입·구분된 투표지,,0,15,1,8,4,13,2,-15
1100,서울특별시,강남구자선거구,6112309,1123,강남구,검색된 결과가 없습니다.
1100,서울특별시,송파구가선거구,6112401,1124,송파구,합계,,63592,37076,7883,5928,13625,6604,34040,3036,26516
1100,서울특별시,송파구가선거구,6112401,1124,송파구,거소투표,,58,57,14,11,22,5,52,5,1
1100,서울특별시,송파구가선거구,6112401,1124,송파구,관외사전투표,,3127,3118,883,437,1225,326,2871,247,9
1100,서울특별시,송파구가선거구,6112401,1124,송파구,풍납1동,계,11250,5783,1634,1148,1841,654,5277,506,5467
1100,서울특별시,송파구가선거구,6112401,1124,송파구,풍납1동,관내사전투표,2586,2578,791,564,735,256,2346,232,8
1100,서울특별시,송파구가선거구,6112401,1124,송파구,풍납1동,선거일투표,8664,3205,843,584,1106,398,2931,274,5459
1100,서울특별시,송파구가선거구,6112401,1124,송파구,풍납2동,계,20025,10371,2128,2696,3629,1160,9613,758,9654
1100,서울특별시,송파구가선거구,6112401,1124,송파구,풍납2동,관내사전투표,4055,4042,819,1290,1308,402,3819,223,13
1100,서울특별시,송파구가선거구,6112401,1124,송파구,풍납2동,선거일투표,15970,6329,1309,1406,2321,758,5794,535,9641
1100,서울특별시,송파구가선거구,6112401,1124,송파구,잠실4동,계,15814,9548,1801,917,3439,2488,8645,903,6266
1100,서울특별시,송파구가선거구,6112401,1124,송파구,잠실4동,관내사전투표,3108,3093,659,361,1094,755,2869,224,15
1100,서울특별시,송파구가선거구,6112401,1124,송파구,잠실4동,선거일투표,12706,6455,1142,556,2345,1733,5776,679,6251
1100,서울특별시,송파구가선거구,6112401,1124,송파구,잠실6동,계,13318,8128,1407,705,3451,1964,7527,601,5190
1100,서울특별시,송파구가선거구,6112401,1124,송파구,잠실6동,관내사전투표,3222,3216,603,319,1306,753,2981,235,6
1100,서울특별시,송파구가선거구,6112401,1124,송파구,잠실6동,선거일투표,10096,4912,804,386,2145,1211,4546,366,5184
1100,서울특별시,송파구가선거구,6112401,1124,송파구,잘못 투입·구분된 투표지,,0,71,16,14,18,7,55,16,-71
1100,서울특별시,송파구나선거구,6112402,1124,송파구,검색된 결과가 없습니다.
1100,서울특별시,송파구다선거구,6112403,1124,송파구,검색된 결과가 없습니다.
1100,서울특별시,송파구라선거구,6112404,1124,송파구,검색된 결과가 없습니다.
1100,서울특별시,송파구마선거구,6112405,1124,송파구,합계,,60303,33088,7175,2879,12406,6816,2364,31640,1448,27215
1100,서울특별시,송파구마선거구,6112405,1124,송파구,거소투표,,53,49,10,7,14,12,1,44,5,4
1100,서울특별시,송파구마선거구,6112405,1124,송파구,관외사전투표,,3121,3115,835,336,1233,404,135,2943,172,6
1100,서울특별시,송파구마선거구,6112405,1124,송파구,잠실본동,계,23983,10199,2742,1471,3053,1723,757,9746,453,13784
1100,서울특별시,송파구마선거구,6112405,1124,송파구,잠실본동,관내사전투표,3778,3771,1070,650,1045,597,261,3623,148,7
1100,서울특별시,송파구마선거구,6112405,1124,송파구,잠실본동,선거일투표,20205,6428,1672,821,2008,1126,496,6123,305,13777
1100,서울특별시,송파구마선거구,6112405,1124,송파구,잠실2동,계,25021,14254,2818,809,5798,2927,1263,13615,639,10767
1100,서울특별시,송파구마선거구,6112405,1124,송파구,잠실2동,관내사전투표,3998,3955,902,283,1529,798,283,3795,160,43
1100,서울특별시,송파구마선거구,6112405,1124,송파구,잠실2동,선거일투표,21023,10299,1916,526,4269,2129,980,9820,479,10724
1100,서울특별시,송파구마선거구,6112405,1124,송파구,잠실7동,계,8125,5385,744,252,2273,1739,205,5213,172,2740
1100,서울특별시,송파구마선거구,6112405,1124,송파구,잠실7동,관내사전투표,1841,1816,327,113,708,553,65,1766,50,25
1100,서울특별시,송파구마선거구,6112405,1124,송파구,잠실7동,선거일투표,6284,3569,417,139,1565,1186,140,3447,122,2715
1100,서울특별시,송파구마선거구,6112405,1124,송파구,잘못 투입·구분된 투표지,,0,86,26,4,35,11,3,79,7,-86
1100,서울특별시,송파구바선거구,6112406,1124,송파구,합계,,55269,30526,10048,18671,582,29301,1225,24743
1100,서울특별시,송파구바선거구,6112406,1124,송파구,거소투표,,81,73,19,49,1,69,4,8
1100,서울특별시,송파구바선거구,6112406,1124,송파구,관외사전투표,,4048,4039,1607,2295,81,3983,56,9
1100,서울특별시,송파구바선거구,6112406,1124,송파구,삼전동,계,25726,11183,5019,5176,243,10438,745,14543
1100,서울특별시,송파구바선거구,6112406,1124,송파구,삼전동,관내사전투표,3567,3564,1791,1606,59,3456,108,3
1100,서울특별시,송파구바선거구,6112406,1124,송파구,삼전동,선거일투표,22159,7619,3228,3570,184,6982,637,14540
1100,서울특별시,송파구바선거구,6112406,1124,송파구,잠실3동,계,25414,15194,3388,11134,255,14777,417,10220
1100,서울특별시,송파구바선거구,6112406,1124,송파구,잠실3동,관내사전투표,3296,3291,837,2346,46,3229,62,5
1100,서울특별시,송파구바선거구,6112406,1124,송파구,잠실3동,선거일투표,22118,11903,2551,8788,209,11548,355,10215
1100,서울특별시,송파구바선거구,6112406,1124,송파구,잘못 투입·구분된 투표지,,0,37,15,17,2,34,3,-37
1100,서울특별시,송파구사선거구,6112407,1124,송파구,검색된 결과가 없습니다.
1100,서울특별시,송파구아선거구,6112408,1124,송파구,합계,,76799,43090,18251,18173,2302,2693,41419,1671,33709
1100,서울특별시,송파구아선거구,6112408,1124,송파구,거소투표,,81,77,33,28,9,4,74,3,4
1100,서울특별시,송파구아선거구,6112408,1124,송파구,관외사전투표,,5356,5341,2473,2195,299,254,5221,120,15
1100,서울특별시,송파구아선거구,6112408,1124,송파구,거여2동,계,18556,10049,4040,4457,543,589,9629,420,8507
1100,서울특별시,송파구아선거구,6112408,1124,송파구,거여2동,관내사전투표,3247,3239,1520,1384,135,154,3193,46,8
1100,서울특별시,송파구아선거구,6112408,1124,송파구,거여2동,선거일투표,15309,6810,2520,3073,408,435,6436,374,8499
1100,서울특별시,송파구아선거구,6112408,1124,송파구,장지동,계,23644,12192,5176,5180,714,498,11568,624,11452
1100,서울특별시,송파구아선거구,6112408,1124,송파구,장지동,관내사전투표,3569,3569,1763,1420,179,112,3474,95,0
1100,서울특별시,송파구아선거구,6112408,1124,송파구,장지동,선거일투표,20075,8623,3413,3760,535,386,8094,529,11452
1100,서울특별시,송파구아선거구,6112408,1124,송파구,위례동,계,29162,15371,6511,6286,730,1343,14870,501,13791
1100,서울특별시,송파구아선거구,6112408,1124,송파구,위례동,관내사전투표,4335,4322,1992,1771,196,284,4243,79,13
1100,서울특별시,송파구아선거구,6112408,1124,송파구,위례동,선거일투표,24827,11049,4519,4515,534,1059,10627,422,13778
1100,서울특별시,송파구아선거구,6112408,1124,송파구,잘못 투입·구분된 투표지,,0,60,18,27,7,5,57,3,-60
1100,서울특별시,송파구자선거구,6112409,1124,송파구,검색된 결과가 없습니다.
1100,서울특별시,송파구차선거구,6112410,1124,송파구,검색된 결과가 없습니다.
1100,서울특별시,강동구가선거구,6112501,1125,강동구,합계,,84457,48879,12601,8629,16750,7554,45534,3345,35578
1100,서울특별시,강동구가선거구,6112501,1125,강동구,거소투표,,169,156,40,21,43,21,125,31,13
1100,서울특별시,강동구가선거구,6112501,1125,강동구,관외사전투표,,5386,5380,1662,934,1859,587,5042,338,6
1100,서울특별시,강동구가선거구,6112501,1125,강동구,강일동,계,25239,13230,3637,3024,4332,1287,12280,950,12009
1100,서울특별시,강동구가선거구,6112501,1125,강동구,강일동,관내사전투표,4232,4223,1246,994,1302,395,3937,286,9
1100,서울특별시,강동구가선거구,6112501,1125,강동구,강일동,선거일투표,21007,9007,2391,2030,3030,892,8343,664,12000
1100,서울특별시,강동구가선거구,6112501,1125,강동구,상일제1동,계,28190,16031,3827,2204,5510,3360,14901,1130,12159
1100,서울특별시,강동구가선거구,6112501,1125,강동구,상일제1동,관내사전투표,4213,4205,1030,616,1468,827,3941,264,8
1100,서울특별시,강동구가선거구,6112501,1125,강동구,상일제1동,선거일투표,23977,11826,2797,1588,4042,2533,10960,866,12151
1100,서울특별시,강동구가선거구,6112501,1125,강동구,상일제2동,계,8449,4482,1422,865,1383,514,4184,298,3967
1100,서울특별시,강동구가선거구,6112501,1125,강동구,상일제2동,관내사전투표,1487,1484,503,302,427,174,1406,78,3
1100,서울특별시,강동구가선거구,6112501,1125,강동구,상일제2동,선거일투표,6962,2998,919,563,956,340,2778,220,3964
1100,서울특별시,강동구가선거구,6112501,1125,강동구,고덕제2동,계,17024,9544,2000,1575,3601,1779,8955,589,7480
1100,서울특별시,강동구가선거구,6112501,1125,강동구,고덕제2동,관내사전투표,2787,2784,632,480,1011,444,2567,217,3
1100,서울특별시,강동구가선거구,6112501,1125,강동구,고덕제2동,선거일투표,14237,6760,1368,1095,2590,1335,6388,372,7477
1100,서울특별시,강동구가선거구,6112501,1125,강동구,잘못 투입·구분된 투표지,,0,56,13,6,22,6,47,9,-56
1100,서울특별시,강동구나선거구,6112502,1125,강동구,합계,,77180,42001,11856,5460,17519,4327,39162,2839,35179
1100,서울특별시,강동구나선거구,6112502,1125,강동구,거소투표,,93,86,23,9,30,13,75,11,7
1100,서울특별시,강동구나선거구,6112502,1125,강동구,관외사전투표,,4883,4880,1644,663,1908,349,4564,316,3
1100,서울특별시,강동구나선거구,6112502,1125,강동구,명일제1동,계,20432,11149,2978,1339,4876,1239,10432,717,9283
1100,서울특별시,강동구나선거구,6112502,1125,강동구,명일제1동,관내사전투표,3815,3812,1051,497,1606,416,3570,242,3
1100,서울특별시,강동구나선거구,6112502,1125,강동구,명일제1동,선거일투표,16617,7337,1927,842,3270,823,6862,475,9280
1100,서울특별시,강동구나선거구,6112502,1125,강동구,명일제2동,계,13854,8420,2310,870,3685,1007,7872,548,5434
1100,서울특별시,강동구나선거구,6112502,1125,강동구,명일제2동,관내사전투표,2681,2673,801,303,1123,267,2494,179,8
1100,서울특별시,강동구나선거구,6112502,1125,강동구,명일제2동,선거일투표,11173,5747,1509,567,2562,740,5378,369,5426
1100,서울특별시,강동구나선거구,6112502,1125,강동구,길동,계,37918,17415,4883,2568,7003,1717,16171,1244,20503
1100,서울특별시,강동구나선거구,6112502,1125,강동구,길동,관내사전투표,5128,5112,1437,835,1999,483,4754,358,16
1100,서울특별시,강동구나선거구,6112502,1125,강동구,길동,선거일투표,32790,12303,3446,1733,5004,1234,11417,886,20487
1100,서울특별시,강동구나선거구,6112502,1125,강동구,잘못 투입·구분된 투표지,,0,51,18,11,17,2,48,3,-51
1100,서울특별시,강동구다선거구,6112503,1125,강동구,합계,,76201,42562,13522,4370,15224,6565,39681,2881,33639
1100,서울특별시,강동구다선거구,6112503,1125,강동구,거소투표,,152,142,42,13,62,9,126,16,10
1100,서울특별시,강동구다선거구,6112503,1125,강동구,관외사전투표,,4152,4147,1514,460,1465,442,3881,266,5
1100,서울특별시,강동구다선거구,6112503,1125,강동구,고덕제1동,계,17043,9798,2972,856,3558,1791,9177,621,7245
1100,서울특별시,강동구다선거구,6112503,1125,강동구,고덕제1동,관내사전투표,3218,3210,1015,310,1152,531,3008,202,8
1100,서울특별시,강동구다선거구,6112503,1125,강동구,고덕제1동,선거일투표,13825,6588,1957,546,2406,1260,6169,419,7237
1100,서울특별시,강동구다선거구,6112503,1125,강동구,암사제1동,계,27845,12589,4059,1499,4370,1663,11591,998,15256
1100,서울특별시,강동구다선거구,6112503,1125,강동구,암사제1동,관내사전투표,3933,3924,1336,531,1307,473,3647,277,9
1100,서울특별시,강동구다선거구,6112503,1125,강동구,암사제1동,선거일투표,23912,8665,2723,968,3063,1190,7944,721,15247
1100,서울특별시,강동구다선거구,6112503,1125,강동구,암사제2동,계,12937,7440,2468,728,2520,1232,6948,492,5497
1100,서울특별시,강동구다선거구,6112503,1125,강동구,암사제2동,관내사전투표,3488,3465,1214,387,1090,524,3215,250,23
1100,서울특별시,강동구다선거구,6112503,1125,강동구,암사제2동,선거일투표,9449,3975,1254,341,1430,708,3733,242,5474
1100,서울특별시,강동구다선거구,6112503,1125,강동구,암사제3동,계,14072,8379,2451,803,3223,1417,7894,485,5693
1100,서울특별시,강동구다선거구,6112503,1125,강동구,암사제3동,관내사전투표,2989,2985,883,334,1172,472,2861,124,4
1100,서울특별시,강동구다선거구,6112503,1125,강동구,암사제3동,선거일투표,11083,5394,1568,469,2051,945,5033,361,5689
1100,서울특별시,강동구다선거구,6112503,1125,강동구,잘못 투입·구분된 투표지,,0,67,16,11,26,11,64,3,-67
1100,서울특별시,강동구라선거구,6112504,1125,강동구,검색된 결과가 없습니다.
1100,서울특별시,강동구마선거구,6112505,1125,강동구,검색된 결과가 없습니다.
1100,서울특별시,강동구바선거구,6112506,1125,강동구,합계,,80977,42485,11407,6369,11832,8450,1412,196,593,40259,2226,38492
1100,서울특별시,강동구바선거구,6112506,1125,강동구,거소투표,,96,91,19,16,23,15,3,0,3,79,12,5
1100,서울특별시,강동구바선거구,6112506,1125,강동구,관외사전투표,,4604,4603,1465,693,1308,600,186,24,54,4330,273,1
1100,서울특별시,강동구바선거구,6112506,1125,강동구,성내제1동,계,16153,8445,2186,1331,2291,1812,288,41,119,8068,377,7708
1100,서울특별시,강동구바선거구,6112506,1125,강동구,성내제1동,관내사전투표,3034,3029,830,523,761,618,97,13,45,2887,142,5
1100,서울특별시,강동구바선거구,6112506,1125,강동구,성내제1동,선거일투표,13119,5416,1356,808,1530,1194,191,28,74,5181,235,7703
1100,서울특별시,강동구바선거구,6112506,1125,강동구,성내제2동,계,20210,9188,2578,1290,2462,1825,325,54,101,8635,553,11022
1100,서울특별시,강동구바선거구,6112506,1125,강동구,성내제2동,관내사전투표,3506,3501,1079,488,893,663,88,15,43,3269,232,5
1100,서울특별시,강동구바선거구,6112506,1125,강동구,성내제2동,선거일투표,16704,5687,1499,802,1569,1162,237,39,58,5366,321,11017
1100,서울특별시,강동구바선거구,6112506,1125,강동구,성내제3동,계,19806,9821,2718,1420,2673,2081,323,35,105,9355,466,9985
1100,서울특별시,강동구바선거구,6112506,1125,강동구,성내제3동,관내사전투표,3829,3825,1189,551,1029,765,97,10,39,3680,145,4
1100,서울특별시,강동구바선거구,6112506,1125,강동구,성내제3동,선거일투표,15977,5996,1529,869,1644,1316,226,25,66,5675,321,9981
1100,서울특별시,강동구바선거구,6112506,1125,강동구,둔촌제2동,계,20108,10306,2427,1616,3070,2112,287,42,211,9765,541,9802
1100,서울특별시,강동구바선거구,6112506,1125,강동구,둔촌제2동,관내사전투표,3147,3135,835,494,877,596,68,6,66,2942,193,12
1100,서울특별시,강동구바선거구,6112506,1125,강동구,둔촌제2동,선거일투표,16961,7171,1592,1122,2193,1516,219,36,145,6823,348,9790
1100,서울특별시,강동구바선거구,6112506,1125,강동구,잘못 투입·구분된 투표지,,0,31,14,3,5,5,0,0,0,27,4,-312600,부산광역시,중구가선거구,6260101,2601,중구,합계,,19860,9781,2248,1608,2875,2145,8876,905,10079
2600,부산광역시,중구가선거구,6260101,2601,중구,거소투표,,34,33,8,4,10,7,29,4,1
2600,부산광역시,중구가선거구,6260101,2601,중구,관외사전투표,,1456,1456,409,263,446,218,1336,120,0
2600,부산광역시,중구가선거구,6260101,2601,중구,중앙동,계,2793,901,246,138,294,158,836,65,1892
2600,부산광역시,중구가선거구,6260101,2601,중구,중앙동,관내사전투표,296,296,91,51,88,49,279,17,0
2600,부산광역시,중구가선거구,6260101,2601,중구,중앙동,선거일투표,2497,605,155,87,206,109,557,48,1892
2600,부산광역시,중구가선거구,6260101,2601,중구,대청동,계,5427,2517,578,427,798,480,2283,234,2910
2600,부산광역시,중구가선거구,6260101,2601,중구,대청동,관내사전투표,936,935,216,175,291,182,864,71,1
2600,부산광역시,중구가선거구,6260101,2601,중구,대청동,선거일투표,4491,1582,362,252,507,298,1419,163,2909
2600,부산광역시,중구가선거구,6260101,2601,중구,영주제1동,계,4150,1659,375,246,484,383,1488,171,2491
2600,부산광역시,중구가선거구,6260101,2601,중구,영주제1동,관내사전투표,587,586,131,87,162,152,532,54,1
2600,부산광역시,중구가선거구,6260101,2601,중구,영주제1동,선거일투표,3563,1073,244,159,322,231,956,117,2490
2600,부산광역시,중구가선거구,6260101,2601,중구,영주제2동,계,6000,3214,632,529,843,899,2903,311,2786
2600,부산광역시,중구가선거구,6260101,2601,중구,영주제2동,관내사전투표,905,905,194,141,244,235,814,91,0
2600,부산광역시,중구가선거구,6260101,2601,중구,영주제2동,선거일투표,5095,2309,438,388,599,664,2089,220,2786
2600,부산광역시,중구가선거구,6260101,2601,중구,잘못 투입·구분된 투표지,,0,1,0,1,0,0,1,0,-1
2600,부산광역시,중구나선거구,6260102,2601,중구,합계,,18376,9347,1765,1777,3304,1667,8513,834,9029
2600,부산광역시,중구나선거구,6260102,2601,중구,거소투표,,26,25,6,7,9,2,24,1,1
2600,부산광역시,중구나선거구,6260102,2601,중구,관외사전투표,,881,880,213,149,299,135,796,84,1
2600,부산광역시,중구나선거구,6260102,2601,중구,동광동,계,2279,1071,295,146,385,167,993,78,1208
2600,부산광역시,중구나선거구,6260102,2601,중구,동광동,관내사전투표,416,415,122,63,141,52,378,37,1
2600,부산광역시,중구나선거구,6260102,2601,중구,동광동,선거일투표,1863,656,173,83,244,115,615,41,1207
2600,부산광역시,중구나선거구,6260102,2601,중구,보수동,계,9145,4333,767,932,1535,722,3956,377,4812
2600,부산광역시,중구나선거구,6260102,2601,중구,보수동,관내사전투표,1500,1500,283,359,511,215,1368,132,0
2600,부산광역시,중구나선거구,6260102,2601,중구,보수동,선거일투표,7645,2833,484,573,1024,507,2588,245,4812
2600,부산광역시,중구나선거구,6260102,2601,중구,부평동,계,4265,2130,355,408,717,461,1941,189,2135
2600,부산광역시,중구나선거구,6260102,2601,중구,부평동,관내사전투표,947,947,174,197,298,188,857,90,0
2600,부산광역시,중구나선거구,6260102,2601,중구,부평동,선거일투표,3318,1183,181,211,419,273,1084,99,2135
2600,부산광역시,중구나선거구,6260102,2601,중구,광복동,계,935,498,72,85,190,100,447,51,437
2600,부산광역시,중구나선거구,6260102,2601,중구,광복동,관내사전투표,241,241,38,46,93,49,226,15,0
2600,부산광역시,중구나선거구,6260102,2601,중구,광복동,선거일투표,694,257,34,39,97,51,221,36,437
2600,부산광역시,중구나선거구,6260102,2601,중구,남포동,계,845,408,56,50,169,80,355,53,437
2600,부산광역시,중구나선거구,6260102,2601,중구,남포동,관내사전투표,163,163,26,22,61,27,136,27,0
2600,부산광역시,중구나선거구,6260102,2601,중구,남포동,선거일투표,682,245,30,28,108,53,219,26,437
2600,부산광역시,중구나선거구,6260102,2601,중구,잘못 투입·구분된 투표지,,0,2,1,0,0,0,1,1,-2
2600,부산광역시,서구가선거구,6260201,2602,서구,합계,,50179,26212,5591,3201,10312,3989,1667,24760,1452,23967
2600,부산광역시,서구가선거구,6260201,2602,서구,거소투표,,69,64,17,10,21,11,2,61,3,5
2600,부산광역시,서구가선거구,6260201,2602,서구,관외사전투표,,2433,2431,732,323,843,272,104,2274,157,2
2600,부산광역시,서구가선거구,6260201,2602,서구,동대신제1동,계,4904,2507,493,250,1043,383,199,2368,139,2397
2600,부산광역시,서구가선거구,6260201,2602,서구,동대신제1동,관내사전투표,901,897,180,93,367,130,64,834,63,4
2600,부산광역시,서구가선거구,6260201,2602,서구,동대신제1동,선거일투표,4003,1610,313,157,676,253,135,1534,76,2393
2600,부산광역시,서구가선거구,6260201,2602,서구,동대신제2동,계,5936,2827,503,308,1266,346,243,2666,161,3109
2600,부산광역시,서구가선거구,6260201,2602,서구,동대신제2동,관내사전투표,888,888,176,106,375,118,83,858,30,0
2600,부산광역시,서구가선거구,6260201,2602,서구,동대신제2동,선거일투표,5048,1939,327,202,891,228,160,1808,131,3109
2600,부산광역시,서구가선거구,6260201,2602,서구,동대신제3동,계,6896,3483,689,347,1364,450,453,3303,180,3413
2600,부산광역시,서구가선거구,6260201,2602,서구,동대신제3동,관내사전투표,1602,1602,309,174,598,221,219,1521,81,0
2600,부산광역시,서구가선거구,6260201,2602,서구,동대신제3동,선거일투표,5294,1881,380,173,766,229,234,1782,99,3413
2600,부산광역시,서구가선거구,6260201,2602,서구,서대신제1동,계,11144,5637,1229,686,2054,1099,266,5334,303,5507
2600,부산광역시,서구가선거구,6260201,2602,서구,서대신제1동,관내사전투표,1981,1980,456,264,725,328,96,1869,111,1
2600,부산광역시,서구가선거구,6260201,2602,서구,서대신제1동,선거일투표,9163,3657,773,422,1329,771,170,3465,192,5506
2600,부산광역시,서구가선거구,6260201,2602,서구,서대신제3동,계,6182,3026,605,376,1219,530,120,2850,176,3156
2600,부산광역시,서구가선거구,6260201,2602,서구,서대신제3동,관내사전투표,1237,1236,259,170,484,213,35,1161,75,1
2600,부산광역시,서구가선거구,6260201,2602,서구,서대신제3동,선거일투표,4945,1790,346,206,735,317,85,1689,101,3155
2600,부산광역시,서구가선거구,6260201,2602,서구,서대신제4동,계,6199,3315,639,575,1268,518,148,3148,167,2884
2600,부산광역시,서구가선거구,6260201,2602,서구,서대신제4동,관내사전투표,1331,1331,277,234,481,189,68,1249,82,0
2600,부산광역시,서구가선거구,6260201,2602,서구,서대신제4동,선거일투표,4868,1984,362,341,787,329,80,1899,85,2884
2600,부산광역시,서구가선거구,6260201,2602,서구,부민동,계,6416,2915,684,324,1231,380,130,2749,166,3501
2600,부산광역시,서구가선거구,6260201,2602,서구,부민동,관내사전투표,1120,1120,277,142,454,131,49,1053,67,0
2600,부산광역시,서구가선거구,6260201,2602,서구,부민동,선거일투표,5296,1795,407,182,777,249,81,1696,99,3501
2600,부산광역시,서구가선거구,6260201,2602,서구,잘못 투입·구분된 투표지,,0,7,0,2,3,0,2,7,0,-7
2600,부산광역시,서구나선거구,6260202,2602,서구,합계,,43247,20829,3698,2595,7168,3782,2162,19405,1424,22418
2600,부산광역시,서구나선거구,6260202,2602,서구,거소투표,,116,112,29,11,32,16,5,93,19,4
2600,부산광역시,서구나선거구,6260202,2602,서구,관외사전투표,,1838,1837,484,226,598,318,95,1721,116,1
2600,부산광역시,서구나선거구,6260202,2602,서구,아미동,계,5785,2525,478,254,882,484,235,2333,192,3260
2600,부산광역시,서구나선거구,6260202,2602,서구,아미동,관내사전투표,773,771,152,87,260,137,68,704,67,2
2600,부산광역시,서구나선거구,6260202,2602,서구,아미동,선거일투표,5012,1754,326,167,622,347,167,1629,125,3258
2600,부산광역시,서구나선거구,6260202,2602,서구,초장동,계,3734,1623,290,179,524,364,134,1491,132,2111
2600,부산광역시,서구나선거구,6260202,2602,서구,초장동,관내사전투표,727,727,147,82,238,149,49,665,62,0
2600,부산광역시,서구나선거구,6260202,2602,서구,초장동,선거일투표,3007,896,143,97,286,215,85,826,70,2111
2600,부산광역시,서구나선거구,6260202,2602,서구,충무동,계,8758,3996,731,434,1398,864,310,3737,259,4762
2600,부산광역시,서구나선거구,6260202,2602,서구,충무동,관내사전투표,1618,1618,308,173,540,341,131,1493,125,0
2600,부산광역시,서구나선거구,6260202,2602,서구,충무동,선거일투표,7140,2378,423,261,858,523,179,2244,134,4762
2600,부산광역시,서구나선거구,6260202,2602,서구,남부민제1동,계,4497,2295,356,268,798,491,236,2149,146,2202
2600,부산광역시,서구나선거구,6260202,2602,서구,남부민제1동,관내사전투표,964,964,173,114,326,202,99,914,50,0
2600,부산광역시,서구나선거구,6260202,2602,서구,남부민제1동,선거일투표,3533,1331,183,154,472,289,137,1235,96,2202
2600,부산광역시,서구나선거구,6260202,2602,서구,남부민제2동,계,7858,3668,579,470,1254,596,523,3422,246,4190
2600,부산광역시,서구나선거구,6260202,2602,서구,남부민제2동,관내사전투표,1141,1140,199,145,378,167,167,1056,84,1
2600,부산광역시,서구나선거구,6260202,2602,서구,남부민제2동,선거일투표,6717,2528,380,325,876,429,356,2366,162,4189
2600,부산광역시,서구나선거구,6260202,2602,서구,암남동,계,10661,4766,751,750,1679,648,624,4452,314,5895
2600,부산광역시,서구나선거구,6260202,2602,서구,암남동,관내사전투표,1357,1357,214,235,474,176,169,1268,89,0
2600,부산광역시,서구나선거구,6260202,2602,서구,암남동,선거일투표,9304,3409,537,515,1205,472,455,3184,225,5895
2600,부산광역시,서구나선거구,6260202,2602,서구,잘못 투입·구분된 투표지,,0,7,0,3,3,1,0,7,0,-7
2600,부산광역시,동구가선거구,6260301,2603,동구,합계,,43205,21554,4165,3637,6300,4946,19048,2506,21651
2600,부산광역시,동구가선거구,6260301,2603,동구,거소투표,,75,68,14,6,23,8,51,17,7
2600,부산광역시,동구가선거구,6260301,2603,동구,관외사전투표,,1969,1968,468,383,647,267,1765,203,1
2600,부산광역시,동구가선거구,6260301,2603,동구,초량제1동,계,4412,1811,384,299,544,358,1585,226,2601
2600,부산광역시,동구가선거구,6260301,2603,동구,초량제1동,관내사전투표,768,765,178,120,219,146,663,102,3
2600,부산광역시,동구가선거구,6260301,2603,동구,초량제1동,선거일투표,3644,1046,206,179,325,212,922,124,2598
2600,부산광역시,동구가선거구,6260301,2603,동구,초량제2동,계,5097,2297,384,341,733,540,1998,299,2800
2600,부산광역시,동구가선거구,6260301,2603,동구,초량제2동,관내사전투표,1032,1030,178,151,318,243,890,140,2
2600,부산광역시,동구가선거구,6260301,2603,동구,초량제2동,선거일투표,4065,1267,206,190,415,297,1108,159,2798
2600,부산광역시,동구가선거구,6260301,2603,동구,초량제3동,계,10721,4711,1039,856,1474,826,4195,516,6010
2600,부산광역시,동구가선거구,6260301,2603,동구,초량제3동,관내사전투표,1925,1925,428,357,573,363,1721,204,0
2600,부산광역시,동구가선거구,6260301,2603,동구,초량제3동,선거일투표,8796,2786,611,499,901,463,2474,312,6010
2600,부산광역시,동구가선거구,6260301,2603,동구,초량제6동,계,5269,2567,423,402,727,660,2212,355,2702
2600,부산광역시,동구가선거구,6260301,2603,동구,초량제6동,관내사전투표,1146,1141,211,172,277,318,978,163,5
2600,부산광역시,동구가선거구,6260301,2603,동구,초량제6동,선거일투표,4123,1426,212,230,450,342,1234,192,2697
2600,부산광역시,동구가선거구,6260301,2603,동구,수정제1동,계,3726,1987,382,333,554,517,1786,201,1739
2600,부산광역시,동구가선거구,6260301,2603,동구,수정제1동,관내사전투표,1091,1088,199,183,302,298,982,106,3
2600,부산광역시,동구가선거구,6260301,2603,동구,수정제1동,선거일투표,2635,899,183,150,252,219,804,95,1736
2600,부산광역시,동구가선거구,6260301,2603,동구,수정제2동,계,8589,4385,796,738,1159,1251,3944,441,4204
2600,부산광역시,동구가선거구,6260301,2603,동구,수정제2동,관내사전투표,1700,1698,333,325,419,456,1533,165,2
2600,부산광역시,동구가선거구,6260301,2603,동구,수정제2동,선거일투표,6889,2687,463,413,740,795,2411,276,4202
2600,부산광역시,동구가선거구,6260301,2603,동구,수정제4동,계,3347,1738,271,275,435,512,1493,245,1609
2600,부산광역시,동구가선거구,6260301,2603,동구,수정제4동,관내사전투표,814,813,130,137,186,255,708,105,1
2600,부산광역시,동구가선거구,6260301,2603,동구,수정제4동,선거일투표,2533,925,141,138,249,257,785,140,1608
2600,부산광역시,동구가선거구,6260301,2603,동구,잘못 투입·구분된 투표지,,0,22,4,4,4,7,19,3,-22
2600,부산광역시,동구나선거구,6260302,2603,동구,합계,,37664,19269,5763,8379,2962,555,824,18483,786,18395
2600,부산광역시,동구나선거구,6260302,2603,동구,거소투표,,60,54,11,25,11,3,1,51,3,6
2600,부산광역시,동구나선거구,6260302,2603,동구,관외사전투표,,1924,1924,764,778,237,37,44,1860,64,0
2600,부산광역시,동구나선거구,6260302,2603,동구,수정제5동,계,4545,2331,669,1053,373,74,69,2238,93,2214
2600,부산광역시,동구나선거구,6260302,2603,동구,수정제5동,관내사전투표,1135,1134,338,517,160,34,32,1081,53,1
2600,부산광역시,동구나선거구,6260302,2603,동구,수정제5동,선거일투표,3410,1197,331,536,213,40,37,1157,40,2213
2600,부산광역시,동구나선거구,6260302,2603,동구,좌천동,계,10205,4962,1512,2128,852,126,138,4756,206,5243
2600,부산광역시,동구나선거구,6260302,2603,동구,좌천동,관내사전투표,1888,1887,651,801,303,34,39,1828,59,1
2600,부산광역시,동구나선거구,6260302,2603,동구,좌천동,선거일투표,8317,3075,861,1327,549,92,99,2928,147,5242
2600,부산광역시,동구나선거구,6260302,2603,동구,범일제1동,계,10266,4820,1367,2112,849,98,143,4569,251,5446
2600,부산광역시,동구나선거구,6260302,2603,동구,범일제1동,관내사전투표,1612,1611,485,699,294,30,40,1548,63,1
2600,부산광역시,동구나선거구,6260302,2603,동구,범일제1동,선거일투표,8654,3209,882,1413,555,68,103,3021,188,5445
2600,부산광역시,동구나선거구,6260302,2603,동구,범일제2동,계,7194,3424,936,1525,361,169,335,3326,98,3770
2600,부산광역시,동구나선거구,6260302,2603,동구,범일제2동,관내사전투표,1146,1146,342,473,122,59,127,1123,23,0
2600,부산광역시,동구나선거구,6260302,2603,동구,범일제2동,선거일투표,6048,2278,594,1052,239,110,208,2203,75,3770
2600,부산광역시,동구나선거구,6260302,2603,동구,범일제5동,계,3470,1743,501,756,275,47,93,1672,71,1727
2600,부산광역시,동구나선거구,6260302,2603,동구,범일제5동,관내사전투표,477,474,127,189,97,9,25,447,27,3
2600,부산광역시,동구나선거구,6260302,2603,동구,범일제5동,선거일투표,2993,1269,374,567,178,38,68,1225,44,1724
2600,부산광역시,동구나선거구,6260302,2603,동구,잘못 투입·구분된 투표지,,0,11,3,2,4,1,1,11,0,-11
2600,부산광역시,영도구가선거구,6260401,2604,영도구,합계,,47255,24339,5018,3386,8314,2504,3215,22437,1902,22916
2600,부산광역시,영도구가선거구,6260401,2604,영도구,거소투표,,79,77,11,11,38,4,3,67,10,2
2600,부산광역시,영도구가선거구,6260401,2604,영도구,관외사전투표,,1811,1809,506,262,591,157,171,1687,122,2
2600,부산광역시,영도구가선거구,6260401,2604,영도구,남항동,계,9636,4570,901,626,1700,630,361,4218,352,5066
2600,부산광역시,영도구가선거구,6260401,2604,영도구,남항동,관내사전투표,1815,1814,379,263,686,217,134,1679,135,1
2600,부산광역시,영도구가선거구,6260401,2604,영도구,남항동,선거일투표,7821,2756,522,363,1014,413,227,2539,217,5065
2600,부산광역시,영도구가선거구,6260401,2604,영도구,영선제1동,계,3369,1664,334,235,558,175,214,1516,148,1705
2600,부산광역시,영도구가선거구,6260401,2604,영도구,영선제1동,관내사전투표,780,777,168,106,253,81,95,703,74,3
2600,부산광역시,영도구가선거구,6260401,2604,영도구,영선제1동,선거일투표,2589,887,166,129,305,94,119,813,74,1702
2600,부산광역시,영도구가선거구,6260401,2604,영도구,영선제2동,계,7898,4553,923,623,1652,471,472,4141,412,3345
2600,부산광역시,영도구가선거구,6260401,2604,영도구,영선제2동,관내사전투표,2303,2301,482,328,805,234,231,2080,221,2
2600,부산광역시,영도구가선거구,6260401,2604,영도구,영선제2동,선거일투표,5595,2252,441,295,847,237,241,2061,191,3343
2600,부산광역시,영도구가선거구,6260401,2604,영도구,신선동,계,6900,3098,724,474,1035,338,275,2846,252,3802
2600,부산광역시,영도구가선거구,6260401,2604,영도구,신선동,관내사전투표,1164,1163,279,205,374,101,97,1056,107,1
2600,부산광역시,영도구가선거구,6260401,2604,영도구,신선동,선거일투표,5736,1935,445,269,661,237,178,1790,145,3801
2600,부산광역시,영도구가선거구,6260401,2604,영도구,봉래제1동,계,6059,3184,563,435,1093,292,549,2932,252,2875
2600,부산광역시,영도구가선거구,6260401,2604,영도구,봉래제1동,관내사전투표,1669,1666,302,209,587,133,295,1526,140,3
2600,부산광역시,영도구가선거구,6260401,2604,영도구,봉래제1동,선거일투표,4390,1518,261,226,506,159,254,1406,112,2872
2600,부산광역시,영도구가선거구,6260401,2604,영도구,봉래제2동,계,6497,3172,564,404,834,237,943,2982,190,3325
2600,부산광역시,영도구가선거구,6260401,2604,영도구,봉래제2동,관내사전투표,843,842,177,111,222,65,220,795,47,1
2600,부산광역시,영도구가선거구,6260401,2604,영도구,봉래제2동,선거일투표,5654,2330,387,293,612,172,723,2187,143,3324
2600,부산광역시,영도구가선거구,6260401,2604,영도구,청학제1동,계,5006,2200,488,312,811,198,227,2036,164,2806
2600,부산광역시,영도구가선거구,6260401,2604,영도구,청학제1동,관내사전투표,795,795,169,115,305,71,86,746,49,0
2600,부산광역시,영도구가선거구,6260401,2604,영도구,청학제1동,선거일투표,4211,1405,319,197,506,127,141,1290,115,2806
2600,부산광역시,영도구가선거구,6260401,2604,영도구,잘못 투입·구분된 투표지,,0,12,4,4,2,2,0,12,0,-12
2600,부산광역시,영도구나선거구,6260402,2604,영도구,합계,,52140,25885,6801,3498,8685,3781,149,693,23607,2278,26255
2600,부산광역시,영도구나선거구,6260402,2604,영도구,거소투표,,134,129,37,19,34,15,3,8,116,13,5
2600,부산광역시,영도구나선거구,6260402,2604,영도구,관외사전투표,,2469,2469,765,366,756,301,9,61,2258,211,0
2600,부산광역시,영도구나선거구,6260402,2604,영도구,청학제2동,계,14312,6414,1559,912,2464,834,42,163,5974,440,7898
2600,부산광역시,영도구나선거구,6260402,2604,영도구,청학제2동,관내사전투표,1722,1719,460,257,637,237,7,27,1625,94,3
2600,부산광역시,영도구나선거구,6260402,2604,영도구,청학제2동,선거일투표,12590,4695,1099,655,1827,597,35,136,4349,346,7895
2600,부산광역시,영도구나선거구,6260402,2604,영도구,동삼제1동,계,22933,10766,2964,1407,3313,1769,57,220,9730,1036,12167
2600,부산광역시,영도구나선거구,6260402,2604,영도구,동삼제1동,관내사전투표,4180,4174,1176,611,1250,628,19,74,3758,416,6
2600,부산광역시,영도구나선거구,6260402,2604,영도구,동삼제1동,선거일투표,18753,6592,1788,796,2063,1141,38,146,5972,620,12161
2600,부산광역시,영도구나선거구,6260402,2604,영도구,동삼제2동,계,3223,1574,409,188,558,239,9,30,1433,141,1649
2600,부산광역시,영도구나선거구,6260402,2604,영도구,동삼제2동,관내사전투표,761,760,200,95,267,110,2,9,683,77,1
2600,부산광역시,영도구나선거구,6260402,2604,영도구,동삼제2동,선거일투표,2462,814,209,93,291,129,7,21,750,64,1648
2600,부산광역시,영도구나선거구,6260402,2604,영도구,동삼제3동,계,9069,4520,1065,606,1554,620,29,210,4084,436,4549
2600,부산광역시,영도구나선거구,6260402,2604,영도구,동삼제3동,관내사전투표,2023,2022,505,284,676,260,12,90,1827,195,1
2600,부산광역시,영도구나선거구,6260402,2604,영도구,동삼제3동,선거일투표,7046,2498,560,322,878,360,17,120,2257,241,4548
2600,부산광역시,영도구나선거구,6260402,2604,영도구,잘못 투입·구분된 투표지,,0,13,2,0,6,3,0,1,12,1,-13
2600,부산광역시,부산진구가선거구,6260501,2605,부산진구,합계,,43448,19551,6712,9617,2266,18595,956,23897
2600,부산광역시,부산진구가선거구,6260501,2605,부산진구,거소투표,,60,58,17,32,5,54,4,2
2600,부산광역시,부산진구가선거구,6260501,2605,부산진구,관외사전투표,,2317,2311,1031,990,219,2240,71,6
2600,부산광역시,부산진구가선거구,6260501,2605,부산진구,부전제1동,계,14111,5243,1690,2673,579,4942,301,8868
2600,부산광역시,부산진구가선거구,6260501,2605,부산진구,부전제1동,관내사전투표,1568,1564,502,837,170,1509,55,4
2600,부산광역시,부산진구가선거구,6260501,2605,부산진구,부전제1동,선거일투표,12543,3679,1188,1836,409,3433,246,8864
2600,부산광역시,부산진구가선거구,6260501,2605,부산진구,양정제1동,계,17056,8617,2815,4369,1108,8292,325,8439
2600,부산광역시,부산진구가선거구,6260501,2605,부산진구,양정제1동,관내사전투표,2633,2627,992,1254,305,2551,76,6
2600,부산광역시,부산진구가선거구,6260501,2605,부산진구,양정제1동,선거일투표,14423,5990,1823,3115,803,5741,249,8433
2600,부산광역시,부산진구가선거구,6260501,2605,부산진구,양정제2동,계,9904,3295,1148,1542,355,3045,250,6609
2600,부산광역시,부산진구가선거구,6260501,2605,부산진구,양정제2동,관내사전투표,737,736,245,353,108,706,30,1
2600,부산광역시,부산진구가선거구,6260501,2605,부산진구,양정제2동,선거일투표,9167,2559,903,1189,247,2339,220,6608
2600,부산광역시,부산진구가선거구,6260501,2605,부산진구,잘못 투입·구분된 투표지,,0,27,11,11,0,22,5,-27
2600,부산광역시,부산진구나선거구,6260502,2605,부산진구,합계,,37017,19569,5996,10426,2142,18564,1005,17448
2600,부산광역시,부산진구나선거구,6260502,2605,부산진구,거소투표,,83,79,28,33,9,70,9,4
2600,부산광역시,부산진구나선거구,6260502,2605,부산진구,관외사전투표,,1813,1811,753,876,131,1760,51,2
2600,부산광역시,부산진구나선거구,6260502,2605,부산진구,연지동,계,16632,8414,2662,4334,1029,8025,389,8218
2600,부산광역시,부산진구나선거구,6260502,2605,부산진구,연지동,관내사전투표,2525,2520,903,1260,285,2448,72,5
2600,부산광역시,부산진구나선거구,6260502,2605,부산진구,연지동,선거일투표,14107,5894,1759,3074,744,5577,317,8213
2600,부산광역시,부산진구나선거구,6260502,2605,부산진구,초읍동,계,18489,9241,2549,5172,971,8692,549,9248
2600,부산광역시,부산진구나선거구,6260502,2605,부산진구,초읍동,관내사전투표,3007,3003,876,1732,292,2900,103,4
2600,부산광역시,부산진구나선거구,6260502,2605,부산진구,초읍동,선거일투표,15482,6238,1673,3440,679,5792,446,9244
2600,부산광역시,부산진구나선거구,6260502,2605,부산진구,잘못 투입·구분된 투표지,,0,24,4,11,2,17,7,-24
2600,부산광역시,부산진구다선거구,6260503,2605,부산진구,합계,,34740,17035,6288,9180,514,227,16209,826,17705
2600,부산광역시,부산진구다선거구,6260503,2605,부산진구,거소투표,,55,52,14,33,1,2,50,2,3
2600,부산광역시,부산진구다선거구,6260503,2605,부산진구,관외사전투표,,2143,2142,961,1034,72,35,2102,40,1
2600,부산광역시,부산진구다선거구,6260503,2605,부산진구,부암제1동,계,18333,7753,2750,4347,167,81,7345,408,10580
2600,부산광역시,부산진구다선거구,6260503,2605,부산진구,부암제1동,관내사전투표,2264,2261,868,1284,53,13,2218,43,3
2600,부산광역시,부산진구다선거구,6260503,2605,부산진구,부암제1동,선거일투표,16069,5492,1882,3063,114,68,5127,365,10577
2600,부산광역시,부산진구다선거구,6260503,2605,부산진구,부암제3동,계,14209,7082,2562,3764,274,109,6709,373,7127
2600,부산광역시,부산진구다선거구,6260503,2605,부산진구,부암제3동,관내사전투표,2512,2504,1006,1311,92,31,2440,64,8
2600,부산광역시,부산진구다선거구,6260503,2605,부산진구,부암제3동,선거일투표,11697,4578,1556,2453,182,78,4269,309,7119
2600,부산광역시,부산진구다선거구,6260503,2605,부산진구,잘못 투입·구분된 투표지,,0,6,1,2,0,0,3,3,-6
2600,부산광역시,부산진구라선거구,6260504,2605,부산진구,합계,,39246,19935,7281,6147,5440,18868,1067,19311
2600,부산광역시,부산진구라선거구,6260504,2605,부산진구,거소투표,,60,54,19,23,8,50,4,6
2600,부산광역시,부산진구라선거구,6260504,2605,부산진구,관외사전투표,,1831,1831,842,575,364,1781,50,0
2600,부산광역시,부산진구라선거구,6260504,2605,부산진구,당감제1동,계,19324,9290,3278,2760,2690,8728,562,10034
2600,부산광역시,부산진구라선거구,6260504,2605,부산진구,당감제1동,관내사전투표,2632,2623,942,747,846,2535,88,9
2600,부산광역시,부산진구라선거구,6260504,2605,부산진구,당감제1동,선거일투표,16692,6667,2336,2013,1844,6193,474,10025
2600,부산광역시,부산진구라선거구,6260504,2605,부산진구,당감제2동,계,8531,4399,1489,1560,1178,4227,172,4132
2600,부산광역시,부산진구라선거구,6260504,2605,부산진구,당감제2동,관내사전투표,1263,1263,419,422,383,1224,39,0
2600,부산광역시,부산진구라선거구,6260504,2605,부산진구,당감제2동,선거일투표,7268,3136,1070,1138,795,3003,133,4132
2600,부산광역시,부산진구라선거구,6260504,2605,부산진구,당감제4동,계,9500,4342,1648,1223,1196,4067,275,5158
2600,부산광역시,부산진구라선거구,6260504,2605,부산진구,당감제4동,관내사전투표,1681,1679,641,492,483,1616,63,2
2600,부산광역시,부산진구라선거구,6260504,2605,부산진구,당감제4동,선거일투표,7819,2663,1007,731,713,2451,212,5156
2600,부산광역시,부산진구라선거구,6260504,2605,부산진구,잘못 투입·구분된 투표지,,0,19,5,6,4,15,4,-19
2600,부산광역시,부산진구마선거구,6260505,2605,부산진구,검색된 결과가 없습니다.
2600,부산광역시,부산진구바선거구,6260506,2605,부산진구,합계,,38680,16529,5309,7395,2015,900,15619,910,22151
2600,부산광역시,부산진구바선거구,6260506,2605,부산진구,거소투표,,60,55,11,28,9,2,50,5,5
2600,부산광역시,부산진구바선거구,6260506,2605,부산진구,관외사전투표,,2019,2017,846,821,193,92,1952,65,2
2600,부산광역시,부산진구바선거구,6260506,2605,부산진구,부전제2동,계,9048,3276,958,1609,392,133,3092,184,5772
2600,부산광역시,부산진구바선거구,6260506,2605,부산진구,부전제2동,관내사전투표,679,678,284,299,60,20,663,15,1
2600,부산광역시,부산진구바선거구,6260506,2605,부산진구,부전제2동,선거일투표,8369,2598,674,1310,332,113,2429,169,5771
2600,부산광역시,부산진구바선거구,6260506,2605,부산진구,범천제1동,계,10555,3604,1102,1740,476,109,3427,177,6951
2600,부산광역시,부산진구바선거구,6260506,2605,부산진구,범천제1동,관내사전투표,1355,1353,459,627,154,41,1281,72,2
2600,부산광역시,부산진구바선거구,6260506,2605,부산진구,범천제1동,선거일투표,9200,2251,643,1113,322,68,2146,105,6949
2600,부산광역시,부산진구바선거구,6260506,2605,부산진구,범천제2동,계,16998,7553,2385,3188,944,563,7080,473,9445
2600,부산광역시,부산진구바선거구,6260506,2605,부산진구,범천제2동,관내사전투표,2555,2543,805,1014,349,254,2422,121,12
2600,부산광역시,부산진구바선거구,6260506,2605,부산진구,범천제2동,선거일투표,14443,5010,1580,2174,595,309,4658,352,9433
2600,부산광역시,부산진구바선거구,6260506,2605,부산진구,잘못 투입·구분된 투표지,,0,24,7,9,1,1,18,6,-24
2600,부산광역시,부산진구사선거구,6260507,2605,부산진구,검색된 결과가 없습니다.
2600,부산광역시,부산진구아선거구,6260508,2605,부산진구,검색된 결과가 없습니다.
2600,부산광역시,동래구가선거구,6260601,2606,동래구,합계,,36111,18646,5919,11674,722,18315,331,17465
2600,부산광역시,동래구가선거구,6260601,2606,동래구,거소투표,,123,116,39,59,6,104,12,7
2600,부산광역시,동래구가선거구,6260601,2606,동래구,관외사전투표,,1993,1990,766,1108,77,1951,39,3
2600,부산광역시,동래구가선거구,6260601,2606,동래구,수민동,계,25631,12151,3984,7517,479,11980,171,13480
2600,부산광역시,동래구가선거구,6260601,2606,동래구,수민동,관내사전투표,3556,3478,1257,2055,121,3433,45,78
2600,부산광역시,동래구가선거구,6260601,2606,동래구,수민동,선거일투표,22075,8673,2727,5462,358,8547,126,13402
2600,부산광역시,동래구가선거구,6260601,2606,동래구,복산동,계,8364,4305,1102,2937,159,4198,107,4059
2600,부산광역시,동래구가선거구,6260601,2606,동래구,복산동,관내사전투표,1725,1725,484,1129,57,1670,55,0
2600,부산광역시,동래구가선거구,6260601,2606,동래구,복산동,선거일투표,6639,2580,618,1808,102,2528,52,4059
2600,부산광역시,동래구가선거구,6260601,2606,동래구,잘못 투입·구분된 투표지,,0,84,28,53,1,82,2,-84
2600,부산광역시,동래구나선거구,6260602,2606,동래구,합계,,39399,18676,6414,9023,2809,18246,430,20723
2600,부산광역시,동래구나선거구,6260602,2606,동래구,거소투표,,50,50,17,21,10,48,2,0
2600,부산광역시,동래구나선거구,6260602,2606,동래구,관외사전투표,,2436,2436,1065,1042,271,2378,58,0
2600,부산광역시,동래구나선거구,6260602,2606,동래구,명륜동,계,17980,8574,2960,4245,1210,8415,159,9406
2600,부산광역시,동래구나선거구,6260602,2606,동래구,명륜동,관내사전투표,2373,2371,822,1168,338,2328,43,2
2600,부산광역시,동래구나선거구,6260602,2606,동래구,명륜동,선거일투표,15607,6203,2138,3077,872,6087,116,9404
2600,부산광역시,동래구나선거구,6260602,2606,동래구,온천제1동,계,18933,7612,2370,3714,1318,7402,210,11321
2600,부산광역시,동래구나선거구,6260602,2606,동래구,온천제1동,관내사전투표,2033,2032,639,929,389,1957,75,1
2600,부산광역시,동래구나선거구,6260602,2606,동래구,온천제1동,선거일투표,16900,5580,1731,2785,929,5445,135,11320
2600,부산광역시,동래구나선거구,6260602,2606,동래구,잘못 투입·구분된 투표지,,0,4,2,1,0,3,1,-4
2600,부산광역시,동래구다선거구,6260603,2606,동래구,합계,,53145,26106,7840,10487,5882,1101,25310,796,27039
2600,부산광역시,동래구다선거구,6260603,2606,동래구,거소투표,,79,75,17,26,14,2,59,16,4
2600,부산광역시,동래구다선거구,6260603,2606,동래구,관외사전투표,,3629,3624,1345,1321,705,145,3516,108,5
2600,부산광역시,동래구다선거구,6260603,2606,동래구,온천제2동,계,18822,9912,2968,4345,1961,361,9635,277,8910
2600,부산광역시,동래구다선거구,6260603,2606,동래구,온천제2동,관내사전투표,3032,3026,917,1300,594,121,2932,94,6
2600,부산광역시,동래구다선거구,6260603,2606,동래구,온천제2동,선거일투표,15790,6886,2051,3045,1367,240,6703,183,8904
2600,부산광역시,동래구다선거구,6260603,2606,동래구,온천제3동,계,30615,12456,3500,4776,3195,590,12061,395,18159
2600,부산광역시,동래구다선거구,6260603,2606,동래구,온천제3동,관내사전투표,2071,2047,636,757,488,100,1981,66,24
2600,부산광역시,동래구다선거구,6260603,2606,동래구,온천제3동,선거일투표,28544,10409,2864,4019,2707,490,10080,329,18135
2600,부산광역시,동래구다선거구,6260603,2606,동래구,잘못 투입·구분된 투표지,,0,39,10,19,7,3,39,0,-39
2600,부산광역시,동래구라선거구,6260604,2606,동래구,합계,,44083,22357,5796,3151,7248,4383,20578,1779,21726
2600,부산광역시,동래구라선거구,6260604,2606,동래구,거소투표,,57,54,12,7,12,14,45,9,3
2600,부산광역시,동래구라선거구,6260604,2606,동래구,관외사전투표,,2203,2191,703,268,670,341,1982,209,12
2600,부산광역시,동래구라선거구,6260604,2606,동래구,사직제1동,계,8813,4306,987,581,1606,804,3978,328,4507
2600,부산광역시,동래구라선거구,6260604,2606,동래구,사직제1동,관내사전투표,1768,1761,427,240,613,299,1579,182,7
2600,부산광역시,동래구라선거구,6260604,2606,동래구,사직제1동,선거일투표,7045,2545,560,341,993,505,2399,146,4500
2600,부산광역시,동래구라선거구,6260604,2606,동래구,사직제2동,계,19556,9468,2509,1599,2957,1709,8774,694,10088
2600,부산광역시,동래구라선거구,6260604,2606,동래구,사직제2동,관내사전투표,2832,2823,788,499,876,446,2609,214,9
2600,부산광역시,동래구라선거구,6260604,2606,동래구,사직제2동,선거일투표,16724,6645,1721,1100,2081,1263,6165,480,10079
2600,부산광역시,동래구라선거구,6260604,2606,동래구,사직제3동,계,13454,6308,1579,691,1991,1510,5771,537,7146
2600,부산광역시,동래구라선거구,6260604,2606,동래구,사직제3동,관내사전투표,1873,1872,470,215,570,432,1687,185,1
2600,부산광역시,동래구라선거구,6260604,2606,동래구,사직제3동,선거일투표,11581,4436,1109,476,1421,1078,4084,352,7145
2600,부산광역시,동래구라선거구,6260604,2606,동래구,잘못 투입·구분된 투표지,,0,30,6,5,12,5,28,2,-30
2600,부산광역시,동래구마선거구,6260605,2606,동래구,합계,,61296,30986,7476,2510,13902,4047,920,28855,2131,30310
2600,부산광역시,동래구마선거구,6260605,2606,동래구,거소투표,,79,71,22,5,26,5,4,62,9,8
2600,부산광역시,동래구마선거구,6260605,2606,동래구,관외사전투표,,2596,2589,746,233,1103,257,71,2410,179,7
2600,부산광역시,동래구마선거구,6260605,2606,동래구,안락제1동,계,12557,6177,1420,519,2806,845,148,5738,439,6380
2600,부산광역시,동래구마선거구,6260605,2606,동래구,안락제1동,관내사전투표,2053,2050,539,176,894,256,46,1911,139,3
2600,부산광역시,동래구마선거구,6260605,2606,동래구,안락제1동,선거일투표,10504,4127,881,343,1912,589,102,3827,300,6377
2600,부산광역시,동래구마선거구,6260605,2606,동래구,안락제2동,계,21830,10699,2635,875,4493,1603,424,10030,669,11131
2600,부산광역시,동래구마선거구,6260605,2606,동래구,안락제2동,관내사전투표,2697,2693,672,212,1059,420,126,2489,204,4
2600,부산광역시,동래구마선거구,6260605,2606,동래구,안락제2동,선거일투표,19133,8006,1963,663,3434,1183,298,7541,465,11127
2600,부산광역시,동래구마선거구,6260605,2606,동래구,명장제1동,계,11781,5824,1321,437,2784,684,143,5369,455,5957
2600,부산광역시,동래구마선거구,6260605,2606,동래구,명장제1동,관내사전투표,1996,1991,480,150,933,219,40,1822,169,5
2600,부산광역시,동래구마선거구,6260605,2606,동래구,명장제1동,선거일투표,9785,3833,841,287,1851,465,103,3547,286,5952
2600,부산광역시,동래구마선거구,6260605,2606,동래구,명장제2동,계,12453,5600,1323,439,2679,649,130,5220,380,6853
2600,부산광역시,동래구마선거구,6260605,2606,동래구,명장제2동,관내사전투표,1834,1827,444,147,849,210,35,1685,142,7
2600,부산광역시,동래구마선거구,6260605,2606,동래구,명장제2동,선거일투표,10619,3773,879,292,1830,439,95,3535,238,6846
2600,부산광역시,동래구마선거구,6260605,2606,동래구,잘못 투입·구분된 투표지,,0,26,9,2,11,4,0,26,0,-26
2600,부산광역시,남구가선거구,6260701,2607,남구,검색된 결과가 없습니다.
2600,부산광역시,남구나선거구,6260702,2607,남구,합계,,36155,19474,6088,10386,2446,18920,554,16681
2600,부산광역시,남구나선거구,6260702,2607,남구,거소투표,,74,71,25,36,4,65,6,3
2600,부산광역시,남구나선거구,6260702,2607,남구,관외사전투표,,2014,2013,791,994,186,1971,42,1
2600,부산광역시,남구나선거구,6260702,2607,남구,용당동,계,6555,3269,997,1846,355,3198,71,3286
2600,부산광역시,남구나선거구,6260702,2607,남구,용당동,관내사전투표,839,839,276,438,99,813,26,0
2600,부산광역시,남구나선거구,6260702,2607,남구,용당동,선거일투표,5716,2430,721,1408,256,2385,45,3286
2600,부산광역시,남구나선거구,6260702,2607,남구,감만제1동,계,10935,5443,1828,2758,696,5282,161,5492
2600,부산광역시,남구나선거구,6260702,2607,남구,감만제1동,관내사전투표,1981,1979,708,984,235,1927,52,2
2600,부산광역시,남구나선거구,6260702,2607,남구,감만제1동,선거일투표,8954,3464,1120,1774,461,3355,109,5490
2600,부산광역시,남구나선거구,6260702,2607,남구,감만제2동,계,5934,3046,875,1622,453,2950,96,2888
2600,부산광역시,남구나선거구,6260702,2607,남구,감만제2동,관내사전투표,1445,1440,466,721,201,1388,52,5
2600,부산광역시,남구나선거구,6260702,2607,남구,감만제2동,선거일투표,4489,1606,409,901,252,1562,44,2883
2600,부산광역시,남구나선거구,6260702,2607,남구,우암동,계,10643,5615,1567,3123,747,5437,178,5028
2600,부산광역시,남구나선거구,6260702,2607,남구,우암동,관내사전투표,1162,1161,343,655,138,1136,25,1
2600,부산광역시,남구나선거구,6260702,2607,남구,우암동,선거일투표,9481,4454,1224,2468,609,4301,153,5027
2600,부산광역시,남구나선거구,6260702,2607,남구,잘못 투입·구분된 투표지,,0,17,5,7,5,17,0,-17
2600,부산광역시,남구다선거구,6260703,2607,남구,합계,,41311,21041,7646,10187,2420,20253,788,20270
2600,부산광역시,남구다선거구,6260703,2607,남구,거소투표,,60,55,24,24,2,50,5,5
2600,부산광역시,남구다선거구,6260703,2607,남구,관외사전투표,,2045,2042,931,897,155,1983,59,3
2600,부산광역시,남구다선거구,6260703,2607,남구,문현제1동,계,11435,5759,2175,2617,782,5574,185,5676
2600,부산광역시,남구다선거구,6260703,2607,남구,문현제1동,관내사전투표,2557,2554,968,1164,331,2463,91,3
2600,부산광역시,남구다선거구,6260703,2607,남구,문현제1동,선거일투표,8878,3205,1207,1453,451,3111,94,5673
2600,부산광역시,남구다선거구,6260703,2607,남구,문현제2동,계,7385,3054,983,1600,314,2897,157,4331
2600,부산광역시,남구다선거구,6260703,2607,남구,문현제2동,관내사전투표,1165,1162,384,592,130,1106,56,3
2600,부산광역시,남구다선거구,6260703,2607,남구,문현제2동,선거일투표,6220,1892,599,1008,184,1791,101,4328
2600,부산광역시,남구다선거구,6260703,2607,남구,문현제3동,계,13167,6349,2313,3138,695,6146,203,6818
2600,부산광역시,남구다선거구,6260703,2607,남구,문현제3동,관내사전투표,2195,2158,825,1032,240,2097,61,37
2600,부산광역시,남구다선거구,6260703,2607,남구,문현제3동,선거일투표,10972,4191,1488,2106,455,4049,142,6781
2600,부산광역시,남구다선거구,6260703,2607,남구,문현제4동,계,7219,3729,1197,1887,466,3550,179,3490
2600,부산광역시,남구다선거구,6260703,2607,남구,문현제4동,관내사전투표,1438,1435,518,674,178,1370,65,3
2600,부산광역시,남구다선거구,6260703,2607,남구,문현제4동,선거일투표,5781,2294,679,1213,288,2180,114,3487
2600,부산광역시,남구다선거구,6260703,2607,남구,잘못 투입·구분된 투표지,,0,53,23,24,6,53,0,-53
2600,부산광역시,남구라선거구,6260704,2607,남구,검색된 결과가 없습니다.
2600,부산광역시,남구마선거구,6260705,2607,남구,합계,,69305,37810,9201,3793,12193,8434,33621,4189,31495
2600,부산광역시,남구마선거구,6260705,2607,남구,거소투표,,162,152,50,19,56,15,140,12,10
2600,부산광역시,남구마선거구,6260705,2607,남구,관외사전투표,,2997,2990,905,352,952,441,2650,340,7
2600,부산광역시,남구마선거구,6260705,2607,남구,용호제1동,계,32984,16521,3629,1737,4940,4409,14715,1806,16463
2600,부산광역시,남구마선거구,6260705,2607,남구,용호제1동,관내사전투표,2741,2738,627,344,754,699,2424,314,3
2600,부산광역시,남구마선거구,6260705,2607,남구,용호제1동,선거일투표,30243,13783,3002,1393,4186,3710,12291,1492,16460
2600,부산광역시,남구마선거구,6260705,2607,남구,용호제2동,계,13337,7129,1835,591,2574,1379,6379,750,6208
2600,부산광역시,남구마선거구,6260705,2607,남구,용호제2동,관내사전투표,2074,2073,537,185,742,358,1822,251,1
2600,부산광역시,남구마선거구,6260705,2607,남구,용호제2동,선거일투표,11263,5056,1298,406,1832,1021,4557,499,6207
2600,부산광역시,남구마선거구,6260705,2607,남구,용호제3동,계,12297,7035,1706,661,2311,1549,6227,808,5262
2600,부산광역시,남구마선거구,6260705,2607,남구,용호제3동,관내사전투표,3665,3662,936,365,1097,832,3230,432,3
2600,부산광역시,남구마선거구,6260705,2607,남구,용호제3동,선거일투표,8632,3373,770,296,1214,717,2997,376,5259
2600,부산광역시,남구마선거구,6260705,2607,남구,용호제4동,계,7528,3962,1074,427,1355,638,3494,468,3566
2600,부산광역시,남구마선거구,6260705,2607,남구,용호제4동,관내사전투표,1988,1987,575,220,648,293,1736,251,1
2600,부산광역시,남구마선거구,6260705,2607,남구,용호제4동,선거일투표,5540,1975,499,207,707,345,1758,217,3565
2600,부산광역시,남구마선거구,6260705,2607,남구,잘못 투입·구분된 투표지,,0,21,2,6,5,3,16,5,-21
2600,부산광역시,북구가선거구,6260801,2608,북구,합계,,65912,30636,7473,3915,8593,7352,27333,3303,35276
2600,부산광역시,북구가선거구,6260801,2608,북구,거소투표,,86,82,22,8,25,16,71,11,4
2600,부산광역시,북구가선거구,6260801,2608,북구,관외사전투표,,2558,2557,810,333,688,452,2283,274,1
2600,부산광역시,북구가선거구,6260801,2608,북구,구포제1동,계,14644,6867,1641,905,2187,1423,6156,711,7777
2600,부산광역시,북구가선거구,6260801,2608,북구,구포제1동,관내사전투표,2650,2646,583,351,880,514,2328,318,4
2600,부산광역시,북구가선거구,6260801,2608,북구,구포제1동,선거일투표,11994,4221,1058,554,1307,909,3828,393,7773
2600,부산광역시,북구가선거구,6260801,2608,북구,구포제2동,계,21299,9488,2265,1260,2614,2297,8436,1052,11811
2600,부산광역시,북구가선거구,6260801,2608,북구,구포제2동,관내사전투표,2445,2442,627,361,661,512,2161,281,3
2600,부산광역시,북구가선거구,6260801,2608,북구,구포제2동,선거일투표,18854,7046,1638,899,1953,1785,6275,771,11808
2600,부산광역시,북구가선거구,6260801,2608,북구,구포제3동,계,16762,6874,1547,866,1645,2074,6132,742,9888
2600,부산광역시,북구가선거구,6260801,2608,북구,구포제3동,관내사전투표,2547,2545,579,354,565,743,2241,304,2
2600,부산광역시,북구가선거구,6260801,2608,북구,구포제3동,선거일투표,14215,4329,968,512,1080,1331,3891,438,9886
2600,부산광역시,북구가선거구,6260801,2608,북구,덕천제2동,계,10563,4734,1178,539,1423,1084,4224,510,5829
2600,부산광역시,북구가선거구,6260801,2608,북구,덕천제2동,관내사전투표,1486,1479,414,166,422,328,1330,149,7
2600,부산광역시,북구가선거구,6260801,2608,북구,덕천제2동,선거일투표,9077,3255,764,373,1001,756,2894,361,5822
2600,부산광역시,북구가선거구,6260801,2608,북구,잘못 투입·구분된 투표지,,0,34,10,4,11,6,31,3,-34
2600,부산광역시,북구나선거구,6260802,2608,북구,검색된 결과가 없습니다.
2600,부산광역시,북구다선거구,6260803,2608,북구,합계,,38892,20746,7330,7459,5301,20090,656,18146
2600,부산광역시,북구다선거구,6260803,2608,북구,거소투표,,57,57,20,20,14,54,3,0
2600,부산광역시,북구다선거구,6260803,2608,북구,관외사전투표,,1783,1781,779,668,297,1744,37,2
2600,부산광역시,북구다선거구,6260803,2608,북구,만덕제2동,계,21445,10746,3668,3540,3211,10419,327,10699
2600,부산광역시,북구다선거구,6260803,2608,북구,만덕제2동,관내사전투표,3392,3386,1197,1088,1035,3320,66,6
2600,부산광역시,북구다선거구,6260803,2608,북구,만덕제2동,선거일투표,18053,7360,2471,2452,2176,7099,261,10693
2600,부산광역시,북구다선거구,6260803,2608,북구,만덕제3동,계,15607,8142,2857,3222,1777,7856,286,7465
2600,부산광역시,북구다선거구,6260803,2608,북구,만덕제3동,관내사전투표,2795,2791,1052,1099,576,2727,64,4
2600,부산광역시,북구다선거구,6260803,2608,북구,만덕제3동,선거일투표,12812,5351,1805,2123,1201,5129,222,7461
2600,부산광역시,북구다선거구,6260803,2608,북구,잘못 투입·구분된 투표지,,0,20,6,9,2,17,3,-20
2600,부산광역시,북구라선거구,6260804,2608,북구,합계,,48356,25028,7799,13737,643,2114,24293,735,23328
2600,부산광역시,북구라선거구,6260804,2608,북구,거소투표,,104,103,33,46,4,9,92,11,1
2600,부산광역시,북구라선거구,6260804,2608,북구,관외사전투표,,2192,2191,884,1043,68,153,2148,43,1
2600,부산광역시,북구라선거구,6260804,2608,북구,금곡동,계,32074,16174,4854,9040,328,1418,15640,534,15900
2600,부산광역시,북구라선거구,6260804,2608,북구,금곡동,관내사전투표,3205,3205,1112,1730,57,262,3161,44,0
2600,부산광역시,북구라선거구,6260804,2608,북구,금곡동,선거일투표,28869,12969,3742,7310,271,1156,12479,490,15900
2600,부산광역시,북구라선거구,6260804,2608,북구,화명제2동,계,13986,6550,2028,3601,243,532,6404,146,7436
2600,부산광역시,북구라선거구,6260804,2608,북구,화명제2동,관내사전투표,1920,1918,653,1016,62,142,1873,45,2
2600,부산광역시,북구라선거구,6260804,2608,북구,화명제2동,선거일투표,12066,4632,1375,2585,181,390,4531,101,7434
2600,부산광역시,북구라선거구,6260804,2608,북구,잘못 투입·구분된 투표지,,0,10,0,7,0,2,9,1,-10
2600,부산광역시,북구마선거구,6260805,2608,북구,합계,,58132,31860,6653,7871,10056,4557,29137,2723,26272
2600,부산광역시,북구마선거구,6260805,2608,북구,거소투표,,64,59,12,11,23,7,53,6,5
2600,부산광역시,북구마선거구,6260805,2608,북구,관외사전투표,,2773,2772,726,581,908,308,2523,249,1
2600,부산광역시,북구마선거구,6260805,2608,북구,화명제1동,계,31954,16127,3452,3402,5410,2422,14686,1441,15827
2600,부산광역시,북구마선거구,6260805,2608,북구,화명제1동,관내사전투표,3577,3538,756,815,1110,563,3244,294,39
2600,부산광역시,북구마선거구,6260805,2608,북구,화명제1동,선거일투표,28377,12589,2696,2587,4300,1859,11442,1147,15788
2600,부산광역시,북구마선거구,6260805,2608,북구,화명제3동,계,23341,12849,2450,3867,3695,1814,11826,1023,10492
2600,부산광역시,북구마선거구,6260805,2608,북구,화명제3동,관내사전투표,3370,3365,678,1050,903,461,3092,273,5
2600,부산광역시,북구마선거구,6260805,2608,북구,화명제3동,선거일투표,19971,9484,1772,2817,2792,1353,8734,750,10487
2600,부산광역시,북구마선거구,6260805,2608,북구,잘못 투입·구분된 투표지,,0,53,13,10,20,6,49,4,-53
2600,부산광역시,해운대구가선거구,6260901,2609,해운대구,검색된 결과가 없습니다.
2600,부산광역시,해운대구나선거구,6260902,2609,해운대구,합계,,48606,24835,4764,1517,8445,4858,3342,513,23439,1396,23771
2600,부산광역시,해운대구나선거구,6260902,2609,해운대구,거소투표,,49,43,7,2,10,6,10,2,37,6,6
2600,부산광역시,해운대구나선거구,6260902,2609,해운대구,관외사전투표,,2408,2401,570,187,885,363,204,53,2262,139,7
2600,부산광역시,해운대구나선거구,6260902,2609,해운대구,우제2동,계,23917,11558,2564,702,3815,2384,1123,325,10913,645,12359
2600,부산광역시,해운대구나선거구,6260902,2609,해운대구,우제2동,관내사전투표,3004,3000,736,211,916,606,255,110,2834,166,4
2600,부산광역시,해운대구나선거구,6260902,2609,해운대구,우제2동,선거일투표,20913,8558,1828,491,2899,1778,868,215,8079,479,12355
2600,부산광역시,해운대구나선거구,6260902,2609,해운대구,우제3동,계,22232,10714,1605,619,3701,2076,1983,133,10117,597,11518
2600,부산광역시,해운대구나선거구,6260902,2609,해운대구,우제3동,관내사전투표,3213,3110,534,200,1035,583,539,24,2915,195,103
2600,부산광역시,해운대구나선거구,6260902,2609,해운대구,우제3동,선거일투표,19019,7604,1071,419,2666,1493,1444,109,7202,402,11415
2600,부산광역시,해운대구나선거구,6260902,2609,해운대구,잘못 투입·구분된 투표지,,0,119,18,7,34,29,22,0,110,9,-119
2600,부산광역시,해운대구다선거구,6260903,2609,해운대구,합계,,50456,23700,6698,2078,10136,2390,1130,22432,1268,26756
2600,부산광역시,해운대구다선거구,6260903,2609,해운대구,거소투표,,53,47,16,1,20,1,5,43,4,6
2600,부산광역시,해운대구다선거구,6260903,2609,해운대구,관외사전투표,,2424,2422,813,229,927,188,89,2246,176,2
2600,부산광역시,해운대구다선거구,6260903,2609,해운대구,중제2동,계,13036,5592,1455,385,2670,556,285,5351,241,7444
2600,부산광역시,해운대구다선거구,6260903,2609,해운대구,중제2동,관내사전투표,1668,1667,490,128,759,144,74,1595,72,1
2600,부산광역시,해운대구다선거구,6260903,2609,해운대구,중제2동,선거일투표,11368,3925,965,257,1911,412,211,3756,169,7443
2600,부산광역시,해운대구다선거구,6260903,2609,해운대구,좌제2동,계,26281,11876,3361,1177,4814,1330,609,11291,585,14405
2600,부산광역시,해운대구다선거구,6260903,2609,해운대구,좌제2동,관내사전투표,3715,3706,1157,375,1491,359,179,3561,145,9
2600,부산광역시,해운대구다선거구,6260903,2609,해운대구,좌제2동,선거일투표,22566,8170,2204,802,3323,971,430,7730,440,14396
2600,부산광역시,해운대구다선거구,6260903,2609,해운대구,송정동,계,8662,3745,1046,283,1701,314,141,3485,260,4917
2600,부산광역시,해운대구다선거구,6260903,2609,해운대구,송정동,관내사전투표,1182,1177,338,109,512,97,39,1095,82,5
2600,부산광역시,해운대구다선거구,6260903,2609,해운대구,송정동,선거일투표,7480,2568,708,174,1189,217,102,2390,178,4912
2600,부산광역시,해운대구다선거구,6260903,2609,해운대구,잘못 투입·구분된 투표지,,0,18,7,3,4,1,1,16,2,-18
2600,부산광역시,해운대구라선거구,6260904,2609,해운대구,검색된 결과가 없습니다.
2600,부산광역시,해운대구마선거구,6260905,2609,해운대구,검색된 결과가 없습니다.
2600,부산광역시,해운대구바선거구,6260906,2609,해운대구,합계,,41270,18434,6108,7608,3872,17588,846,22836
2600,부산광역시,해운대구바선거구,6260906,2609,해운대구,거소투표,,58,56,15,25,9,49,7,2
2600,부산광역시,해운대구바선거구,6260906,2609,해운대구,관외사전투표,,1761,1760,691,751,251,1693,67,1
2600,부산광역시,해운대구바선거구,6260906,2609,해운대구,반여제2동,계,11349,5016,1522,2132,1150,4804,212,6333
2600,부산광역시,해운대구바선거구,6260906,2609,해운대구,반여제2동,관내사전투표,2021,2015,619,868,450,1937,78,6
2600,부산광역시,해운대구바선거구,6260906,2609,해운대구,반여제2동,선거일투표,9328,3001,903,1264,700,2867,134,6327
2600,부산광역시,해운대구바선거구,6260906,2609,해운대구,반여제3동,계,7664,3390,1058,1180,946,3184,206,4274
2600,부산광역시,해운대구바선거구,6260906,2609,해운대구,반여제3동,관내사전투표,1384,1378,483,470,366,1319,59,6
2600,부산광역시,해운대구바선거구,6260906,2609,해운대구,반여제3동,선거일투표,6280,2012,575,710,580,1865,147,4268
2600,부산광역시,해운대구바선거구,6260906,2609,해운대구,재송제2동,계,20438,8190,2814,3512,1511,7837,353,12248
2600,부산광역시,해운대구바선거구,6260906,2609,해운대구,재송제2동,관내사전투표,2406,2402,889,1007,395,2291,111,4
2600,부산광역시,해운대구바선거구,6260906,2609,해운대구,재송제2동,선거일투표,18032,5788,1925,2505,1116,5546,242,12244
2600,부산광역시,해운대구바선거구,6260906,2609,해운대구,잘못 투입·구분된 투표지,,0,22,8,8,5,21,1,-22
2600,부산광역시,해운대구사선거구,6260907,2609,해운대구,합계,,42137,21595,7719,9916,3251,20886,709,20542
2600,부산광역시,해운대구사선거구,6260907,2609,해운대구,거소투표,,56,51,18,20,7,45,6,5
2600,부산광역시,해운대구사선거구,6260907,2609,해운대구,관외사전투표,,1936,1934,762,871,224,1857,77,2
2600,부산광역시,해운대구사선거구,6260907,2609,해운대구,반여제1동,계,27326,13580,4812,6156,2185,13153,427,13746
2600,부산광역시,해운대구사선거구,6260907,2609,해운대구,반여제1동,관내사전투표,2922,2919,1155,1231,464,2850,69,3
2600,부산광역시,해운대구사선거구,6260907,2609,해운대구,반여제1동,선거일투표,24404,10661,3657,4925,1721,10303,358,13743
2600,부산광역시,해운대구사선거구,6260907,2609,해운대구,반여제4동,계,12819,5999,2115,2856,830,5801,198,6820
2600,부산광역시,해운대구사선거구,6260907,2609,해운대구,반여제4동,관내사전투표,1795,1783,595,845,278,1718,65,12
2600,부산광역시,해운대구사선거구,6260907,2609,해운대구,반여제4동,선거일투표,11024,4216,1520,2011,552,4083,133,6808
2600,부산광역시,해운대구사선거구,6260907,2609,해운대구,잘못 투입·구분된 투표지,,0,31,12,13,5,30,1,-31
2600,부산광역시,해운대구아선거구,6260908,2609,해운대구,합계,,33979,16809,4516,7132,2454,1683,15785,1024,17170
2600,부산광역시,해운대구아선거구,6260908,2609,해운대구,거소투표,,82,72,19,28,13,5,65,7,10
2600,부산광역시,해운대구아선거구,6260908,2609,해운대구,관외사전투표,,939,939,366,393,68,68,895,44,0
2600,부산광역시,해운대구아선거구,6260908,2609,해운대구,반송제1동,계,12561,5782,1483,2043,1549,375,5450,332,6779
2600,부산광역시,해운대구아선거구,6260908,2609,해운대구,반송제1동,관내사전투표,2630,2625,693,919,672,188,2472,153,5
2600,부산광역시,해운대구아선거구,6260908,2609,해운대구,반송제1동,선거일투표,9931,3157,790,1124,877,187,2978,179,6774
2600,부산광역시,해운대구아선거구,6260908,2609,해운대구,반송제2동,계,20397,9972,2632,4649,821,1233,9335,637,10425
2600,부산광역시,해운대구아선거구,6260908,2609,해운대구,반송제2동,관내사전투표,3779,3749,1075,1776,263,476,3590,159,30
2600,부산광역시,해운대구아선거구,6260908,2609,해운대구,반송제2동,선거일투표,16618,6223,1557,2873,558,757,5745,478,10395
2600,부산광역시,해운대구아선거구,6260908,2609,해운대구,잘못 투입·구분된 투표지,,0,44,16,19,3,2,40,4,-44
2600,부산광역시,기장군가선거구,6261001,2610,기장군,합계,,46666,20888,4930,8074,3458,2623,552,266,19903,985,25778
2600,부산광역시,기장군가선거구,6261001,2610,기장군,거소투표,,200,197,21,131,23,9,2,2,188,9,3
2600,부산광역시,기장군가선거구,6261001,2610,기장군,관외사전투표,,2023,2020,677,804,232,187,42,17,1959,61,3
2600,부산광역시,기장군가선거구,6261001,2610,기장군,기장읍,계,44443,18636,4223,7132,3193,2424,507,246,17725,911,25807
2600,부산광역시,기장군가선거구,6261001,2610,기장군,기장읍,관내사전투표,5058,5034,1252,1905,860,702,124,50,4893,141,24
2600,부산광역시,기장군가선거구,6261001,2610,기장군,기장읍,선거일투표,39385,13602,2971,5227,2333,1722,383,196,12832,770,25783
2600,부산광역시,기장군가선거구,6261001,2610,기장군,잘못 투입·구분된 투표지,,0,35,9,7,10,3,1,1,31,4,-35
2600,부산광역시,기장군나선거구,6261002,2610,기장군,합계,,28036,13956,4137,6728,2202,397,13464,492,14080
2600,부산광역시,기장군나선거구,6261002,2610,기장군,거소투표,,77,71,33,15,3,1,52,19,6
2600,부산광역시,기장군나선거구,6261002,2610,기장군,관외사전투표,,1880,1839,603,917,218,59,1797,42,41
2600,부산광역시,기장군나선거구,6261002,2610,기장군,일광읍,계,19612,8753,2680,3938,1584,263,8465,288,10859
2600,부산광역시,기장군나선거구,6261002,2610,기장군,일광읍,관내사전투표,2254,2250,699,1052,383,61,2195,55,4
2600,부산광역시,기장군나선거구,6261002,2610,기장군,일광읍,선거일투표,17358,6503,1981,2886,1201,202,6270,233,10855
2600,부산광역시,기장군나선거구,6261002,2610,기장군,철마면,계,6467,3240,805,1829,392,72,3098,142,3227
2600,부산광역시,기장군나선거구,6261002,2610,기장군,철마면,관내사전투표,515,513,127,291,68,5,491,22,2
2600,부산광역시,기장군나선거구,6261002,2610,기장군,철마면,선거일투표,5952,2727,678,1538,324,67,2607,120,3225
2600,부산광역시,기장군나선거구,6261002,2610,기장군,잘못 투입·구분된 투표지,,0,53,16,29,5,2,52,1,-53
2600,부산광역시,기장군다선거구,6261003,2610,기장군,합계,,69169,29396,6417,2539,2187,7868,4233,3988,526,27758,1638,39773
2600,부산광역시,기장군다선거구,6261003,2610,기장군,거소투표,,126,120,24,6,5,24,38,11,3,111,9,6
2600,부산광역시,기장군다선거구,6261003,2610,기장군,관외사전투표,,2944,2943,737,255,180,903,346,264,71,2756,187,1
2600,부산광역시,기장군다선거구,6261003,2610,기장군,장안읍,계,7401,3583,529,229,121,1489,442,453,85,3348,235,3818
2600,부산광역시,기장군다선거구,6261003,2610,기장군,장안읍,관내사전투표,905,898,138,52,45,347,114,134,15,845,53,7
2600,부산광역시,기장군다선거구,6261003,2610,기장군,장안읍,선거일투표,6496,2685,391,177,76,1142,328,319,70,2503,182,3811
2600,부산광역시,기장군다선거구,6261003,2610,기장군,정관읍,계,58698,22731,5124,2049,1878,5448,3404,3255,367,21525,1206,35967
2600,부산광역시,기장군다선거구,6261003,2610,기장군,정관읍,관내사전투표,5396,5385,1275,476,531,1249,771,714,66,5082,303,11
2600,부산광역시,기장군다선거구,6261003,2610,기장군,정관읍,선거일투표,53302,17346,3849,1573,1347,4199,2633,2541,301,16443,903,35956
2600,부산광역시,기장군다선거구,6261003,2610,기장군,잘못 투입·구분된 투표지,,0,19,3,0,3,4,3,5,0,18,1,-19
2600,부산광역시,사하구가선거구,6261101,2611,사하구,합계,,52408,26227,6929,8966,5890,3256,318,25359,868,26181
2600,부산광역시,사하구가선거구,6261101,2611,사하구,거소투표,,126,118,47,37,9,7,5,105,13,8
2600,부산광역시,사하구가선거구,6261101,2611,사하구,관외사전투표,,2392,2392,861,839,350,238,28,2316,76,0
2600,부산광역시,사하구가선거구,6261101,2611,사하구,괴정제1동,계,16407,8002,1981,2529,2153,1005,74,7742,260,8405
2600,부산광역시,사하구가선거구,6261101,2611,사하구,괴정제1동,관내사전투표,2921,2907,854,821,786,342,20,2823,84,14
2600,부산광역시,사하구가선거구,6261101,2611,사하구,괴정제1동,선거일투표,13486,5095,1127,1708,1367,663,54,4919,176,8391
2600,부산광역시,사하구가선거구,6261101,2611,사하구,괴정제2동,계,12060,5223,1302,1887,1016,738,117,5060,163,6837
2600,부산광역시,사하구가선거구,6261101,2611,사하구,괴정제2동,관내사전투표,1576,1575,423,600,273,209,35,1540,35,1
2600,부산광역시,사하구가선거구,6261101,2611,사하구,괴정제2동,선거일투표,10484,3648,879,1287,743,529,82,3520,128,6836
2600,부산광역시,사하구가선거구,6261101,2611,사하구,괴정제3동,계,11357,5635,1453,1859,1386,704,54,5456,179,5722
2600,부산광역시,사하구가선거구,6261101,2611,사하구,괴정제3동,관내사전투표,2234,2229,628,662,570,293,15,2168,61,5
2600,부산광역시,사하구가선거구,6261101,2611,사하구,괴정제3동,선거일투표,9123,3406,825,1197,816,411,39,3288,118,5717
2600,부산광역시,사하구가선거구,6261101,2611,사하구,괴정제4동,계,10066,4832,1275,1815,968,560,39,4657,175,5234
2600,부산광역시,사하구가선거구,6261101,2611,사하구,괴정제4동,관내사전투표,1753,1753,532,612,365,171,16,1696,57,0
2600,부산광역시,사하구가선거구,6261101,2611,사하구,괴정제4동,선거일투표,8313,3079,743,1203,603,389,23,2961,118,5234
2600,부산광역시,사하구가선거구,6261101,2611,사하구,잘못 투입·구분된 투표지,,0,25,10,0,8,4,1,23,2,-25
2600,부산광역시,사하구나선거구,6261102,2611,사하구,합계,,64646,30366,6797,5090,8285,6765,26937,3429,34280
2600,부산광역시,사하구나선거구,6261102,2611,사하구,거소투표,,95,90,14,19,17,24,74,16,5
2600,부산광역시,사하구나선거구,6261102,2611,사하구,관외사전투표,,3074,3073,907,538,784,523,2752,321,1
2600,부산광역시,사하구나선거구,6261102,2611,사하구,당리동,계,21782,10294,2172,1713,3044,2208,9137,1157,11488
2600,부산광역시,사하구나선거구,6261102,2611,사하구,당리동,관내사전투표,3345,3328,735,603,990,626,2954,374,17
2600,부산광역시,사하구나선거구,6261102,2611,사하구,당리동,선거일투표,18437,6966,1437,1110,2054,1582,6183,783,11471
2600,부산광역시,사하구나선거구,6261102,2611,사하구,하단제1동,계,18362,8256,1865,1390,2226,1779,7260,996,10106
2600,부산광역시,사하구나선거구,6261102,2611,사하구,하단제1동,관내사전투표,2463,2453,600,445,633,492,2170,283,10
2600,부산광역시,사하구나선거구,6261102,2611,사하구,하단제1동,선거일투표,15899,5803,1265,945,1593,1287,5090,713,10096
2600,부산광역시,사하구나선거구,6261102,2611,사하구,하단제2동,계,21333,8609,1823,1421,2201,2227,7672,937,12724
2600,부산광역시,사하구나선거구,6261102,2611,사하구,하단제2동,관내사전투표,2329,2320,502,464,462,640,2068,252,9
2600,부산광역시,사하구나선거구,6261102,2611,사하구,하단제2동,선거일투표,19004,6289,1321,957,1739,1587,5604,685,12715
2600,부산광역시,사하구나선거구,6261102,2611,사하구,잘못 투입·구분된 투표지,,0,44,16,9,13,4,42,2,-44
2600,부산광역시,사하구다선거구,6261103,2611,사하구,합계,,62909,28873,7728,3707,9919,4417,25771,3102,34036
2600,부산광역시,사하구다선거구,6261103,2611,사하구,거소투표,,98,95,27,11,27,15,80,15,3
2600,부산광역시,사하구다선거구,6261103,2611,사하구,관외사전투표,,2563,2563,898,322,761,362,2343,220,0
2600,부산광역시,사하구다선거구,6261103,2611,사하구,신평제1동,계,14322,6064,1663,494,2716,556,5429,635,8258
2600,부산광역시,사하구다선거구,6261103,2611,사하구,신평제1동,관내사전투표,2274,2268,625,185,1008,176,1994,274,6
2600,부산광역시,사하구다선거구,6261103,2611,사하구,신평제1동,선거일투표,12048,3796,1038,309,1708,380,3435,361,8252
2600,부산광역시,사하구다선거구,6261103,2611,사하구,신평제2동,계,14673,6243,1855,632,2260,798,5545,698,8430
2600,부산광역시,사하구다선거구,6261103,2611,사하구,신평제2동,관내사전투표,2198,2197,695,243,758,278,1974,223,1
2600,부산광역시,사하구다선거구,6261103,2611,사하구,신평제2동,선거일투표,12475,4046,1160,389,1502,520,3571,475,8429
2600,부산광역시,사하구다선거구,6261103,2611,사하구,구평동,계,10276,4207,1323,470,1371,614,3778,429,6069
2600,부산광역시,사하구다선거구,6261103,2611,사하구,구평동,관내사전투표,1332,1332,435,178,394,196,1203,129,0
2600,부산광역시,사하구다선거구,6261103,2611,사하구,구평동,선거일투표,8944,2875,888,292,977,418,2575,300,6069
2600,부산광역시,사하구다선거구,6261103,2611,사하구,감천제1동,계,15864,7441,1537,1314,2137,1652,6640,801,8423
2600,부산광역시,사하구다선거구,6261103,2611,사하구,감천제1동,관내사전투표,2203,2196,480,390,581,516,1967,229,7
2600,부산광역시,사하구다선거구,6261103,2611,사하구,감천제1동,선거일투표,13661,5245,1057,924,1556,1136,4673,572,8416
2600,부산광역시,사하구다선거구,6261103,2611,사하구,감천제2동,계,5113,2231,417,459,640,415,1931,300,2882
2600,부산광역시,사하구다선거구,6261103,2611,사하구,감천제2동,관내사전투표,755,749,144,185,191,133,653,96,6
2600,부산광역시,사하구다선거구,6261103,2611,사하구,감천제2동,선거일투표,4358,1482,273,274,449,282,1278,204,2876
2600,부산광역시,사하구다선거구,6261103,2611,사하구,잘못 투입·구분된 투표지,,0,29,8,5,7,5,25,4,-29
2600,부산광역시,사하구라선거구,6261104,2611,사하구,합계,,32566,13736,4132,1678,7467,13277,459,18830
2600,부산광역시,사하구라선거구,6261104,2611,사하구,거소투표,,39,38,11,8,15,34,4,1
2600,부산광역시,사하구라선거구,6261104,2611,사하구,관외사전투표,,1232,1232,426,156,609,1191,41,0
2600,부산광역시,사하구라선거구,6261104,2611,사하구,장림제1동,계,8985,3786,1082,611,1983,3676,110,5199
2600,부산광역시,사하구라선거구,6261104,2611,사하구,장림제1동,관내사전투표,1449,1449,403,224,778,1405,44,0
2600,부산광역시,사하구라선거구,6261104,2611,사하구,장림제1동,선거일투표,7536,2337,679,387,1205,2271,66,5199
2600,부산광역시,사하구라선거구,6261104,2611,사하구,장림제2동,계,22310,8665,2607,901,4853,8361,304,13645
2600,부산광역시,사하구라선거구,6261104,2611,사하구,장림제2동,관내사전투표,2264,2252,680,247,1276,2203,49,12
2600,부산광역시,사하구라선거구,6261104,2611,사하구,장림제2동,선거일투표,20046,6413,1927,654,3577,6158,255,13633
2600,부산광역시,사하구라선거구,6261104,2611,사하구,잘못 투입·구분된 투표지,,0,15,6,2,7,15,0,-15
2600,부산광역시,사하구마선거구,6261105,2611,사하구,합계,,56334,27308,6536,2303,9357,4564,859,1545,25164,2144,29026
2600,부산광역시,사하구마선거구,6261105,2611,사하구,거소투표,,128,121,27,14,43,21,1,3,109,12,7
2600,부산광역시,사하구마선거구,6261105,2611,사하구,관외사전투표,,2138,2138,556,241,688,338,65,83,1971,167,0
2600,부산광역시,사하구마선거구,6261105,2611,사하구,다대제1동,계,31288,14070,3297,1106,4900,2006,673,846,12828,1242,17218
2600,부산광역시,사하구마선거구,6261105,2611,사하구,다대제1동,관내사전투표,3409,3406,831,290,1230,468,109,173,3101,305,3
2600,부산광역시,사하구마선거구,6261105,2611,사하구,다대제1동,선거일투표,27879,10664,2466,816,3670,1538,564,673,9727,937,17215
2600,부산광역시,사하구마선거구,6261105,2611,사하구,다대제2동,계,22780,10973,2653,941,3725,2199,119,613,10250,723,11807
2600,부산광역시,사하구마선거구,6261105,2611,사하구,다대제2동,관내사전투표,3252,3250,809,305,1131,617,30,188,3080,170,2
2600,부산광역시,사하구마선거구,6261105,2611,사하구,다대제2동,선거일투표,19528,7723,1844,636,2594,1582,89,425,7170,553,11805
2600,부산광역시,사하구마선거구,6261105,2611,사하구,잘못 투입·구분된 투표지,,0,6,3,1,1,0,1,0,6,0,-6
2600,부산광역시,금정구가선거구,6261201,2612,금정구,합계,,50266,24792,7207,16013,643,23863,929,25474
2600,부산광역시,금정구가선거구,6261201,2612,금정구,거소투표,,61,57,21,34,1,56,1,4
2600,부산광역시,금정구가선거구,6261201,2612,금정구,관외사전투표,,1848,1848,722,1025,61,1808,40,0
2600,부산광역시,금정구가선거구,6261201,2612,금정구,서제1동,계,4812,2168,561,1431,85,2077,91,2644
2600,부산광역시,금정구가선거구,6261201,2612,금정구,서제1동,관내사전투표,829,829,240,530,29,799,30,0
2600,부산광역시,금정구가선거구,6261201,2612,금정구,서제1동,선거일투표,3983,1339,321,901,56,1278,61,2644
2600,부산광역시,금정구가선거구,6261201,2612,금정구,서제2동,계,8134,3694,1012,2450,85,3547,147,4440
2600,부산광역시,금정구가선거구,6261201,2612,금정구,서제2동,관내사전투표,1312,1312,389,852,29,1270,42,0
2600,부산광역시,금정구가선거구,6261201,2612,금정구,서제2동,선거일투표,6822,2382,623,1598,56,2277,105,4440
2600,부산광역시,금정구가선거구,6261201,2612,금정구,서제3동,계,10003,4605,1347,2982,117,4446,159,5398
2600,부산광역시,금정구가선거구,6261201,2612,금정구,서제3동,관내사전투표,1894,1892,596,1208,41,1845,47,2
2600,부산광역시,금정구가선거구,6261201,2612,금정구,서제3동,선거일투표,8109,2713,751,1774,76,2601,112,5396
2600,부산광역시,금정구가선거구,6261201,2612,금정구,금사회동동,계,7100,3327,886,2194,118,3198,129,3773
2600,부산광역시,금정구가선거구,6261201,2612,금정구,금사회동동,관내사전투표,1370,1369,413,845,56,1314,55,1
2600,부산광역시,금정구가선거구,6261201,2612,금정구,금사회동동,선거일투표,5730,1958,473,1349,62,1884,74,3772
2600,부산광역시,금정구가선거구,6261201,2612,금정구,부곡제1동,계,7356,3654,1000,2391,67,3458,196,3702
2600,부산광역시,금정구가선거구,6261201,2612,금정구,부곡제1동,관내사전투표,1549,1549,449,1032,25,1506,43,0
2600,부산광역시,금정구가선거구,6261201,2612,금정구,부곡제1동,선거일투표,5807,2105,551,1359,42,1952,153,3702
2600,부산광역시,금정구가선거구,6261201,2612,금정구,부곡제4동,계,10952,5430,1657,3500,108,5265,165,5522
2600,부산광역시,금정구가선거구,6261201,2612,금정구,부곡제4동,관내사전투표,2265,2261,747,1452,41,2240,21,4
2600,부산광역시,금정구가선거구,6261201,2612,금정구,부곡제4동,선거일투표,8687,3169,910,2048,67,3025,144,5518
2600,부산광역시,금정구가선거구,6261201,2612,금정구,잘못 투입·구분된 투표지,,0,9,1,6,1,8,1,-9
2600,부산광역시,금정구나선거구,6261202,2612,금정구,합계,,53429,28204,7399,2660,9611,5199,1152,26021,2183,25225
2600,부산광역시,금정구나선거구,6261202,2612,금정구,거소투표,,100,93,22,12,32,12,5,83,10,7
2600,부산광역시,금정구나선거구,6261202,2612,금정구,관외사전투표,,2961,2960,960,311,940,438,104,2753,207,1
2600,부산광역시,금정구나선거구,6261202,2612,금정구,부곡제2동,계,14883,7473,1979,681,2505,1370,341,6876,597,7410
2600,부산광역시,금정구나선거구,6261202,2612,금정구,부곡제2동,관내사전투표,2365,2364,638,209,784,427,94,2152,212,1
2600,부산광역시,금정구나선거구,6261202,2612,금정구,부곡제2동,선거일투표,12518,5109,1341,472,1721,943,247,4724,385,7409
2600,부산광역시,금정구나선거구,6261202,2612,금정구,부곡제3동,계,12974,6636,1767,574,2216,1310,245,6112,524,6338
2600,부산광역시,금정구나선거구,6261202,2612,금정구,부곡제3동,관내사전투표,2377,2374,679,234,735,452,80,2180,194,3
2600,부산광역시,금정구나선거구,6261202,2612,금정구,부곡제3동,선거일투표,10597,4262,1088,340,1481,858,165,3932,330,6335
2600,부산광역시,금정구나선거구,6261202,2612,금정구,장전제2동,계,20453,9918,2503,1017,3340,1887,435,9182,736,10535
2600,부산광역시,금정구나선거구,6261202,2612,금정구,장전제2동,관내사전투표,2888,2887,767,355,895,536,104,2657,230,1
2600,부산광역시,금정구나선거구,6261202,2612,금정구,장전제2동,선거일투표,17565,7031,1736,662,2445,1351,331,6525,506,10534
2600,부산광역시,금정구나선거구,6261202,2612,금정구,선두구동,계,2058,1120,166,65,578,182,22,1013,107,938
2600,부산광역시,금정구나선거구,6261202,2612,금정구,선두구동,관내사전투표,430,430,75,22,216,65,11,389,41,0
2600,부산광역시,금정구나선거구,6261202,2612,금정구,선두구동,선거일투표,1628,690,91,43,362,117,11,624,66,938
2600,부산광역시,금정구나선거구,6261202,2612,금정구,잘못 투입·구분된 투표지,,0,4,2,0,0,0,0,2,2,-4
2600,부산광역시,금정구다선거구,6261203,2612,금정구,합계,,42674,21761,7206,9799,3002,712,20719,1042,20913
2600,부산광역시,금정구다선거구,6261203,2612,금정구,거소투표,,59,55,16,24,5,2,47,8,4
2600,부산광역시,금정구다선거구,6261203,2612,금정구,관외사전투표,,2574,2573,1079,1081,253,86,2499,74,1
2600,부산광역시,금정구다선거구,6261203,2612,금정구,장전제1동,계,15220,6541,2251,2857,824,310,6242,299,8679
2600,부산광역시,금정구다선거구,6261203,2612,금정구,장전제1동,관내사전투표,2293,2286,891,916,262,128,2197,89,7
2600,부산광역시,금정구다선거구,6261203,2612,금정구,장전제1동,선거일투표,12927,4255,1360,1941,562,182,4045,210,8672
2600,부산광역시,금정구다선거구,6261203,2612,금정구,청룡노포동,계,8129,4135,1133,1928,769,60,3890,245,3994
2600,부산광역시,금정구다선거구,6261203,2612,금정구,청룡노포동,관내사전투표,1675,1675,499,749,326,28,1602,73,0
2600,부산광역시,금정구다선거구,6261203,2612,금정구,청룡노포동,선거일투표,6454,2460,634,1179,443,32,2288,172,3994
2600,부산광역시,금정구다선거구,6261203,2612,금정구,구서제1동,계,15875,7953,2579,3675,1069,234,7557,396,7922
2600,부산광역시,금정구다선거구,6261203,2612,금정구,구서제1동,관내사전투표,3266,3264,1174,1500,393,110,3177,87,2
2600,부산광역시,금정구다선거구,6261203,2612,금정구,구서제1동,선거일투표,12609,4689,1405,2175,676,124,4380,309,7920
2600,부산광역시,금정구다선거구,6261203,2612,금정구,금성동,계,817,489,144,224,81,20,469,20,328
2600,부산광역시,금정구다선거구,6261203,2612,금정구,금성동,관내사전투표,165,165,62,75,19,4,160,5,0
2600,부산광역시,금정구다선거구,6261203,2612,금정구,금성동,선거일투표,652,324,82,149,62,16,309,15,328
2600,부산광역시,금정구다선거구,6261203,2612,금정구,잘못 투입·구분된 투표지,,0,15,4,10,1,0,15,0,-15
2600,부산광역시,금정구라선거구,6261204,2612,금정구,합계,,54076,28097,5302,4191,9659,6400,598,26150,1947,25979
2600,부산광역시,금정구라선거구,6261204,2612,금정구,거소투표,,69,66,15,8,22,14,1,60,6,3
2600,부산광역시,금정구라선거구,6261204,2612,금정구,관외사전투표,,3048,3045,820,455,924,564,85,2848,197,3
2600,부산광역시,금정구라선거구,6261204,2612,금정구,남산동,계,24393,11140,2020,1434,4039,2533,265,10291,849,13253
2600,부산광역시,금정구라선거구,6261204,2612,금정구,남산동,관내사전투표,3599,3597,660,492,1300,743,91,3286,311,2
2600,부산광역시,금정구라선거구,6261204,2612,금정구,남산동,선거일투표,20794,7543,1360,942,2739,1790,174,7005,538,13251
2600,부산광역시,금정구라선거구,6261204,2612,금정구,구서제2동,계,26566,13834,2446,2291,4672,3286,245,12940,894,12732
2600,부산광역시,금정구라선거구,6261204,2612,금정구,구서제2동,관내사전투표,4023,4018,713,789,1288,838,78,3706,312,5
2600,부산광역시,금정구라선거구,6261204,2612,금정구,구서제2동,선거일투표,22543,9816,1733,1502,3384,2448,167,9234,582,12727
2600,부산광역시,금정구라선거구,6261204,2612,금정구,잘못 투입·구분된 투표지,,0,12,1,3,2,3,2,11,1,-12
2600,부산광역시,강서구가선거구,6261301,2613,강서구,합계,,58235,27517,7769,10225,2505,781,5550,26830,687,30718
2600,부산광역시,강서구가선거구,6261301,2613,강서구,거소투표,,71,66,17,30,6,0,9,62,4,5
2600,부산광역시,강서구가선거구,6261301,2613,강서구,관외사전투표,,3148,3145,1056,1286,304,47,354,3047,98,3
2600,부산광역시,강서구가선거구,6261301,2613,강서구,대저1동,계,5741,2810,536,1315,255,130,483,2719,91,2931
2600,부산광역시,강서구가선거구,6261301,2613,강서구,대저1동,관내사전투표,902,902,190,403,80,20,177,870,32,0
2600,부산광역시,강서구가선거구,6261301,2613,강서구,대저1동,선거일투표,4839,1908,346,912,175,110,306,1849,59,2931
2600,부산광역시,강서구가선거구,6261301,2613,강서구,대저2동,계,5822,2780,435,941,249,35,1040,2700,80,3042
2600,부산광역시,강서구가선거구,6261301,2613,강서구,대저2동,관내사전투표,905,904,156,298,91,9,322,876,28,1
2600,부산광역시,강서구가선거구,6261301,2613,강서구,대저2동,선거일투표,4917,1876,279,643,158,26,718,1824,52,3041
2600,부산광역시,강서구가선거구,6261301,2613,강서구,강동동,계,3789,1950,281,752,179,383,271,1866,84,1839
2600,부산광역시,강서구가선거구,6261301,2613,강서구,강동동,관내사전투표,639,639,110,255,52,109,97,623,16,0
2600,부산광역시,강서구가선거구,6261301,2613,강서구,강동동,선거일투표,3150,1311,171,497,127,274,174,1243,68,1839
2600,부산광역시,강서구가선거구,6261301,2613,강서구,명지1동,계,37623,15696,5218,5393,1442,158,3198,15409,287,21927
2600,부산광역시,강서구가선거구,6261301,2613,강서구,명지1동,관내사전투표,3557,3548,1188,1162,352,29,769,3500,48,9
2600,부산광역시,강서구가선거구,6261301,2613,강서구,명지1동,선거일투표,34066,12148,4030,4231,1090,129,2429,11909,239,21918
2600,부산광역시,강서구가선거구,6261301,2613,강서구,가락동,계,2041,1056,221,502,69,28,194,1014,42,985
2600,부산광역시,강서구가선거구,6261301,2613,강서구,가락동,관내사전투표,434,434,99,198,23,16,93,429,5,0
2600,부산광역시,강서구가선거구,6261301,2613,강서구,가락동,선거일투표,1607,622,122,304,46,12,101,585,37,985
2600,부산광역시,강서구가선거구,6261301,2613,강서구,잘못 투입·구분된 투표지,,0,14,5,6,1,0,1,13,1,-14
2600,부산광역시,강서구나선거구,6261302,2613,강서구,합계,,54624,23967,6120,3523,5983,6044,21670,2297,30657
2600,부산광역시,강서구나선거구,6261302,2613,강서구,거소투표,,55,50,14,12,12,7,45,5,5
2600,부산광역시,강서구나선거구,6261302,2613,강서구,관외사전투표,,2559,2558,704,365,712,540,2321,237,1
2600,부산광역시,강서구나선거구,6261302,2613,강서구,명지2동,계,21666,10622,3066,1208,2032,3319,9625,997,11044
2600,부산광역시,강서구나선거구,6261302,2613,강서구,명지2동,관내사전투표,3391,3390,1024,466,665,907,3062,328,1
2600,부산광역시,강서구나선거구,6261302,2613,강서구,명지2동,선거일투표,18275,7232,2042,742,1367,2412,6563,669,11043
2600,부산광역시,강서구나선거구,6261302,2613,강서구,녹산동,계,26922,9076,2032,1659,2728,1775,8194,882,17846
2600,부산광역시,강서구나선거구,6261302,2613,강서구,녹산동,관내사전투표,930,929,207,240,210,161,818,111,1
2600,부산광역시,강서구나선거구,6261302,2613,강서구,녹산동,선거일투표,25992,8147,1825,1419,2518,1614,7376,771,17845
2600,부산광역시,강서구나선거구,6261302,2613,강서구,가덕도동,계,3422,1643,298,276,495,399,1468,175,1779
2600,부산광역시,강서구나선거구,6261302,2613,강서구,가덕도동,관내사전투표,605,601,118,106,154,148,526,75,4
2600,부산광역시,강서구나선거구,6261302,2613,강서구,가덕도동,선거일투표,2817,1042,180,170,341,251,942,100,1775
2600,부산광역시,강서구나선거구,6261302,2613,강서구,잘못 투입·구분된 투표지,,0,18,6,3,4,4,17,1,-18
2600,부산광역시,연제구가선거구,6261401,2614,연제구,합계,,51457,28197,7543,2414,9984,3851,2850,26642,1555,23260
2600,부산광역시,연제구가선거구,6261401,2614,연제구,거소투표,,67,65,15,4,25,9,4,57,8,2
2600,부산광역시,연제구가선거구,6261401,2614,연제구,관외사전투표,,3145,3143,966,365,1107,335,186,2959,184,2
2600,부산광역시,연제구가선거구,6261401,2614,연제구,거제제1동,계,21944,11404,3038,950,4021,1336,1468,10813,591,10540
2600,부산광역시,연제구가선거구,6261401,2614,연제구,거제제1동,관내사전투표,2223,2217,716,200,699,250,246,2111,106,6
2600,부산광역시,연제구가선거구,6261401,2614,연제구,거제제1동,선거일투표,19721,9187,2322,750,3322,1086,1222,8702,485,10534
2600,부산광역시,연제구가선거구,6261401,2614,연제구,거제제2동,계,9375,5001,1343,407,1758,727,529,4764,237,4374
2600,부산광역시,연제구가선거구,6261401,2614,연제구,거제제2동,관내사전투표,1682,1679,454,154,524,263,193,1588,91,3
2600,부산광역시,연제구가선거구,6261401,2614,연제구,거제제2동,선거일투표,7693,3322,889,253,1234,464,336,3176,146,4371
2600,부산광역시,연제구가선거구,6261401,2614,연제구,거제제3동,계,8550,4493,1103,342,1597,856,311,4209,284,4057
2600,부산광역시,연제구가선거구,6261401,2614,연제구,거제제3동,관내사전투표,1702,1702,449,127,565,312,119,1572,130,0
2600,부산광역시,연제구가선거구,6261401,2614,연제구,거제제3동,선거일투표,6848,2791,654,215,1032,544,192,2637,154,4057
2600,부산광역시,연제구가선거구,6261401,2614,연제구,거제제4동,계,8376,4078,1072,344,1475,586,350,3827,251,4298
2600,부산광역시,연제구가선거구,6261401,2614,연제구,거제제4동,관내사전투표,1410,1409,421,131,478,194,99,1323,86,1
2600,부산광역시,연제구가선거구,6261401,2614,연제구,거제제4동,선거일투표,6966,2669,651,213,997,392,251,2504,165,4297
2600,부산광역시,연제구가선거구,6261401,2614,연제구,잘못 투입·구분된 투표지,,0,13,6,2,1,2,2,13,0,-13
2600,부산광역시,연제구나선거구,6261402,2614,연제구,합계,,47429,22603,7240,10305,3033,1184,21762,841,24826
2600,부산광역시,연제구나선거구,6261402,2614,연제구,거소투표,,59,54,22,13,9,2,46,8,5
2600,부산광역시,연제구나선거구,6261402,2614,연제구,관외사전투표,,2263,2262,956,890,262,85,2193,69,1
2600,부산광역시,연제구나선거구,6261402,2614,연제구,연산제2동,계,16519,8206,2587,3850,995,489,7921,285,8313
2600,부산광역시,연제구나선거구,6261402,2614,연제구,연산제2동,관내사전투표,2183,2179,750,964,271,98,2083,96,4
2600,부산광역시,연제구나선거구,6261402,2614,연제구,연산제2동,선거일투표,14336,6027,1837,2886,724,391,5838,189,8309
2600,부산광역시,연제구나선거구,6261402,2614,연제구,연산제4동,계,13964,6437,1786,2835,1192,347,6160,277,7527
2600,부산광역시,연제구나선거구,6261402,2614,연제구,연산제4동,관내사전투표,1966,1965,550,807,437,103,1897,68,1
2600,부산광역시,연제구나선거구,6261402,2614,연제구,연산제4동,선거일투표,11998,4472,1236,2028,755,244,4263,209,7526
2600,부산광역시,연제구나선거구,6261402,2614,연제구,연산제5동,계,14624,5631,1884,2714,572,259,5429,202,8993
2600,부산광역시,연제구나선거구,6261402,2614,연제구,연산제5동,관내사전투표,1923,1919,719,915,167,75,1876,43,4
2600,부산광역시,연제구나선거구,6261402,2614,연제구,연산제5동,선거일투표,12701,3712,1165,1799,405,184,3553,159,8989
2600,부산광역시,연제구나선거구,6261402,2614,연제구,잘못 투입·구분된 투표지,,0,13,5,3,3,2,13,0,-13
2600,부산광역시,연제구다선거구,6261403,2614,연제구,검색된 결과가 없습니다.
2600,부산광역시,연제구라선거구,6261404,2614,연제구,합계,,42223,21781,5299,11160,4910,21369,412,20442
2600,부산광역시,연제구라선거구,6261404,2614,연제구,거소투표,,56,53,15,29,6,50,3,3
2600,부산광역시,연제구라선거구,6261404,2614,연제구,관외사전투표,,2537,2535,831,1266,399,2496,39,2
2600,부산광역시,연제구라선거구,6261404,2614,연제구,연산제8동,계,11543,5826,1510,2991,1215,5716,110,5717
2600,부산광역시,연제구라선거구,6261404,2614,연제구,연산제8동,관내사전투표,1697,1697,453,818,400,1671,26,0
2600,부산광역시,연제구라선거구,6261404,2614,연제구,연산제8동,선거일투표,9846,4129,1057,2173,815,4045,84,5717
2600,부산광역시,연제구라선거구,6261404,2614,연제구,연산제9동,계,28087,13354,2942,6868,3285,13095,259,14733
2600,부산광역시,연제구라선거구,6261404,2614,연제구,연산제9동,관내사전투표,2701,2695,719,1312,624,2655,40,6
2600,부산광역시,연제구라선거구,6261404,2614,연제구,연산제9동,선거일투표,25386,10659,2223,5556,2661,10440,219,14727
2600,부산광역시,연제구라선거구,6261404,2614,연제구,잘못 투입·구분된 투표지,,0,13,1,6,5,12,1,-13
2600,부산광역시,수영구가선거구,6261501,2615,수영구,검색된 결과가 없습니다.
2600,부산광역시,수영구나선거구,6261502,2615,수영구,합계,,44707,20161,6684,11355,1252,19291,870,24546
2600,부산광역시,수영구나선거구,6261502,2615,수영구,거소투표,,96,93,27,48,9,84,9,3
2600,부산광역시,수영구나선거구,6261502,2615,수영구,관외사전투표,,2407,2407,1075,1128,143,2346,61,0
2600,부산광역시,수영구나선거구,6261502,2615,수영구,광안제1동,계,22356,9078,2923,5096,594,8613,465,13278
2600,부산광역시,수영구나선거구,6261502,2615,수영구,광안제1동,관내사전투표,3047,3016,1066,1686,189,2941,75,31
2600,부산광역시,수영구나선거구,6261502,2615,수영구,광안제1동,선거일투표,19309,6062,1857,3410,405,5672,390,13247
2600,부산광역시,수영구나선거구,6261502,2615,수영구,광안제3동,계,8636,3515,1002,2164,243,3409,106,5121
2600,부산광역시,수영구나선거구,6261502,2615,수영구,광안제3동,관내사전투표,1375,1370,409,841,92,1342,28,5
2600,부산광역시,수영구나선거구,6261502,2615,수영구,광안제3동,선거일투표,7261,2145,593,1323,151,2067,78,5116
2600,부산광역시,수영구나선거구,6261502,2615,수영구,광안제4동,계,11212,5006,1643,2886,255,4784,222,6206
2600,부산광역시,수영구나선거구,6261502,2615,수영구,광안제4동,관내사전투표,1860,1849,636,1088,92,1816,33,11
2600,부산광역시,수영구나선거구,6261502,2615,수영구,광안제4동,선거일투표,9352,3157,1007,1798,163,2968,189,6195
2600,부산광역시,수영구나선거구,6261502,2615,수영구,잘못 투입·구분된 투표지,,0,62,14,33,8,55,7,-62
2600,부산광역시,수영구다선거구,6261503,2615,수영구,검색된 결과가 없습니다.
2600,부산광역시,수영구라선거구,6261504,2615,수영구,합계,,38484,18760,5424,12233,471,18128,632,19724
2600,부산광역시,수영구라선거구,6261504,2615,수영구,거소투표,,52,48,15,24,1,40,8,4
2600,부산광역시,수영구라선거구,6261504,2615,수영구,관외사전투표,,2056,2055,770,1171,64,2005,50,1
2600,부산광역시,수영구라선거구,6261504,2615,수영구,수영동,계,13200,6763,1781,4529,163,6473,290,6437
2600,부산광역시,수영구라선거구,6261504,2615,수영구,수영동,관내사전투표,2444,2400,640,1647,58,2345,55,44
2600,부산광역시,수영구라선거구,6261504,2615,수영구,수영동,선거일투표,10756,4363,1141,2882,105,4128,235,6393
2600,부산광역시,수영구라선거구,6261504,2615,수영구,민락동,계,23176,9830,2839,6472,240,9551,279,13346
2600,부산광역시,수영구라선거구,6261504,2615,수영구,민락동,관내사전투표,2853,2850,875,1846,63,2784,66,3
2600,부산광역시,수영구라선거구,6261504,2615,수영구,민락동,선거일투표,20323,6980,1964,4626,177,6767,213,13343
2600,부산광역시,수영구라선거구,6261504,2615,수영구,잘못 투입·구분된 투표지,,0,64,19,37,3,59,5,-64
2600,부산광역시,사상구가선거구,6261601,2616,사상구,합계,,57509,26370,6365,3533,9373,4296,711,24278,2092,31139
2600,부산광역시,사상구가선거구,6261601,2616,사상구,거소투표,,99,92,19,17,33,12,2,83,9,7
2600,부산광역시,사상구가선거구,6261601,2616,사상구,관외사전투표,,2223,2221,648,269,742,352,64,2075,146,2
2600,부산광역시,사상구가선거구,6261601,2616,사상구,삼락동,계,5081,2294,541,308,816,362,47,2074,220,2787
2600,부산광역시,사상구가선거구,6261601,2616,사상구,삼락동,관내사전투표,1049,1047,274,149,351,147,23,944,103,2
2600,부산광역시,사상구가선거구,6261601,2616,사상구,삼락동,선거일투표,4032,1247,267,159,465,215,24,1130,117,2785
2600,부산광역시,사상구가선거구,6261601,2616,사상구,덕포제1동,계,8243,4230,1081,534,1355,792,120,3882,348,4013
2600,부산광역시,사상구가선거구,6261601,2616,사상구,덕포제1동,관내사전투표,1974,1972,487,246,632,396,42,1803,169,2
2600,부산광역시,사상구가선거구,6261601,2616,사상구,덕포제1동,선거일투표,6269,2258,594,288,723,396,78,2079,179,4011
2600,부산광역시,사상구가선거구,6261601,2616,사상구,덕포제2동,계,10655,4938,1276,586,1618,919,155,4554,384,5717
2600,부산광역시,사상구가선거구,6261601,2616,사상구,덕포제2동,관내사전투표,1377,1375,345,169,454,265,30,1263,112,2
2600,부산광역시,사상구가선거구,6261601,2616,사상구,덕포제2동,선거일투표,9278,3563,931,417,1164,654,125,3291,272,5715
2600,부산광역시,사상구가선거구,6261601,2616,사상구,괘법동,계,19938,7975,1868,1222,2765,1281,235,7371,604,11963
2600,부산광역시,사상구가선거구,6261601,2616,사상구,괘법동,관내사전투표,2108,2103,475,349,748,285,65,1922,181,5
2600,부산광역시,사상구가선거구,6261601,2616,사상구,괘법동,선거일투표,17830,5872,1393,873,2017,996,170,5449,423,11958
2600,부산광역시,사상구가선거구,6261601,2616,사상구,감전동,계,11270,4606,929,593,2040,578,87,4227,379,6664
2600,부산광역시,사상구가선거구,6261601,2616,사상구,감전동,관내사전투표,1002,1000,200,136,460,97,17,910,90,2
2600,부산광역시,사상구가선거구,6261601,2616,사상구,감전동,선거일투표,10268,3606,729,457,1580,481,70,3317,289,6662
2600,부산광역시,사상구가선거구,6261601,2616,사상구,잘못 투입·구분된 투표지,,0,14,3,4,4,0,1,12,2,-14
2600,부산광역시,사상구나선거구,6261602,2616,사상구,검색된 결과가 없습니다.
2600,부산광역시,사상구다선거구,6261603,2616,사상구,검색된 결과가 없습니다.
2600,부산광역시,사상구라선거구,6261604,2616,사상구,검색된 결과가 없습니다.2700,대구광역시,중구가선거구,6270101,2701,중구,합계,,31499,12818,2975,5041,1434,2012,864,109,12435,383,18681
2700,대구광역시,중구가선거구,6270101,2701,중구,거소투표,,59,55,4,32,5,7,0,3,51,4,4
2700,대구광역시,중구가선거구,6270101,2701,중구,관외사전투표,,1371,1371,371,636,101,168,48,12,1336,35,0
2700,대구광역시,중구가선거구,6270101,2701,중구,동인동,계,6913,2639,505,1054,288,555,116,19,2537,102,4274
2700,대구광역시,중구가선거구,6270101,2701,중구,동인동,관내사전투표,788,787,174,286,83,181,35,7,766,21,1
2700,대구광역시,중구가선거구,6270101,2701,중구,동인동,선거일투표,6125,1852,331,768,205,374,81,12,1771,81,4273
2700,대구광역시,중구가선거구,6270101,2701,중구,삼덕동,계,5682,2021,596,790,162,321,66,37,1972,49,3661
2700,대구광역시,중구가선거구,6270101,2701,중구,삼덕동,관내사전투표,722,722,226,243,54,144,29,13,709,13,0
2700,대구광역시,중구가선거구,6270101,2701,중구,삼덕동,선거일투표,4960,1299,370,547,108,177,37,24,1263,36,3661
2700,대구광역시,중구가선거구,6270101,2701,중구,성내1동,계,4436,1393,359,541,181,181,83,9,1354,39,3043
2700,대구광역시,중구가선거구,6270101,2701,중구,성내1동,관내사전투표,439,439,138,139,66,55,32,4,434,5,0
2700,대구광역시,중구가선거구,6270101,2701,중구,성내1동,선거일투표,3997,954,221,402,115,126,51,5,920,34,3043
2700,대구광역시,중구가선거구,6270101,2701,중구,남산1동,계,3988,1528,342,533,308,170,115,8,1476,52,2460
2700,대구광역시,중구가선거구,6270101,2701,중구,남산1동,관내사전투표,413,413,104,131,75,51,37,2,400,13,0
2700,대구광역시,중구가선거구,6270101,2701,중구,남산1동,선거일투표,3575,1115,238,402,233,119,78,6,1076,39,2460
2700,대구광역시,중구가선거구,6270101,2701,중구,대봉1동,계,5589,2266,434,900,226,407,227,12,2206,60,3323
2700,대구광역시,중구가선거구,6270101,2701,중구,대봉1동,관내사전투표,687,682,159,234,61,136,72,3,665,17,5
2700,대구광역시,중구가선거구,6270101,2701,중구,대봉1동,선거일투표,4902,1584,275,666,165,271,155,9,1541,43,3318
2700,대구광역시,중구가선거구,6270101,2701,중구,대봉2동,계,3461,1538,363,553,163,202,208,8,1497,41,1923
2700,대구광역시,중구가선거구,6270101,2701,중구,대봉2동,관내사전투표,569,568,138,207,55,79,72,2,553,15,1
2700,대구광역시,중구가선거구,6270101,2701,중구,대봉2동,선거일투표,2892,970,225,346,108,123,136,6,944,26,1922
2700,대구광역시,중구가선거구,6270101,2701,중구,잘못 투입·구분된 투표지,,0,7,1,2,0,1,1,1,6,1,-7
2700,대구광역시,중구나선거구,6270102,2701,중구,합계,,37326,16715,3242,7434,4208,63,1002,15949,766,20611
2700,대구광역시,중구나선거구,6270102,2701,중구,거소투표,,50,48,8,21,15,1,2,47,1,2
2700,대구광역시,중구나선거구,6270102,2701,중구,관외사전투표,,1514,1514,427,666,309,12,54,1468,46,0
2700,대구광역시,중구나선거구,6270102,2701,중구,성내2동,계,4152,1496,266,717,285,7,122,1397,99,2656
2700,대구광역시,중구나선거구,6270102,2701,중구,성내2동,관내사전투표,397,397,93,172,80,2,34,381,16,0
2700,대구광역시,중구나선거구,6270102,2701,중구,성내2동,선거일투표,3755,1099,173,545,205,5,88,1016,83,2656
2700,대구광역시,중구나선거구,6270102,2701,중구,성내3동,계,3850,1640,284,787,384,4,123,1582,58,2210
2700,대구광역시,중구나선거구,6270102,2701,중구,성내3동,관내사전투표,567,567,134,223,142,0,54,553,14,0
2700,대구광역시,중구나선거구,6270102,2701,중구,성내3동,선거일투표,3283,1073,150,564,242,4,69,1029,44,2210
2700,대구광역시,중구나선거구,6270102,2701,중구,대신동,계,6382,2888,487,1490,725,11,94,2807,81,3494
2700,대구광역시,중구나선거구,6270102,2701,중구,대신동,관내사전투표,1160,1156,201,592,292,4,45,1134,22,4
2700,대구광역시,중구나선거구,6270102,2701,중구,대신동,선거일투표,5222,1732,286,898,433,7,49,1673,59,3490
2700,대구광역시,중구나선거구,6270102,2701,중구,남산2동,계,5362,2129,435,952,482,8,105,1982,147,3233
2700,대구광역시,중구나선거구,6270102,2701,중구,남산2동,관내사전투표,563,563,127,244,132,1,36,540,23,0
2700,대구광역시,중구나선거구,6270102,2701,중구,남산2동,선거일투표,4799,1566,308,708,350,7,69,1442,124,3233
2700,대구광역시,중구나선거구,6270102,2701,중구,남산3동,계,5393,2310,507,817,734,10,129,2197,113,3083
2700,대구광역시,중구나선거구,6270102,2701,중구,남산3동,관내사전투표,789,789,172,263,271,6,50,762,27,0
2700,대구광역시,중구나선거구,6270102,2701,중구,남산3동,선거일투표,4604,1521,335,554,463,4,79,1435,86,3083
2700,대구광역시,중구나선거구,6270102,2701,중구,남산4동,계,10623,4685,825,1983,1273,10,373,4464,221,5938
2700,대구광역시,중구나선거구,6270102,2701,중구,남산4동,관내사전투표,1272,1272,234,491,373,2,129,1229,43,0
2700,대구광역시,중구나선거구,6270102,2701,중구,남산4동,선거일투표,9351,3413,591,1492,900,8,244,3235,178,5938
2700,대구광역시,중구나선거구,6270102,2701,중구,잘못 투입·구분된 투표지,,0,5,3,1,1,0,0,5,0,-5
2700,대구광역시,동구가선거구,6270201,2702,동구,합계,,37185,16494,3439,7334,5080,15853,641,20691
2700,대구광역시,동구가선거구,6270201,2702,동구,거소투표,,37,36,11,18,4,33,3,1
2700,대구광역시,동구가선거구,6270201,2702,동구,관외사전투표,,1460,1460,433,699,283,1415,45,0
2700,대구광역시,동구가선거구,6270201,2702,동구,신암1동,계,7920,3598,606,1258,1614,3478,120,4322
2700,대구광역시,동구가선거구,6270201,2702,동구,신암1동,관내사전투표,1496,1494,270,484,670,1424,70,2
2700,대구광역시,동구가선거구,6270201,2702,동구,신암1동,선거일투표,6424,2104,336,774,944,2054,50,4320
2700,대구광역시,동구가선거구,6270201,2702,동구,신암2동,계,8465,3975,886,1836,1093,3815,160,4490
2700,대구광역시,동구가선거구,6270201,2702,동구,신암2동,관내사전투표,1498,1498,322,682,414,1418,80,0
2700,대구광역시,동구가선거구,6270201,2702,동구,신암2동,선거일투표,6967,2477,564,1154,679,2397,80,4490
2700,대구광역시,동구가선거구,6270201,2702,동구,신암3동,계,9245,3687,826,1618,1077,3521,166,5558
2700,대구광역시,동구가선거구,6270201,2702,동구,신암3동,관내사전투표,1318,1318,276,578,413,1267,51,0
2700,대구광역시,동구가선거구,6270201,2702,동구,신암3동,선거일투표,7927,2369,550,1040,664,2254,115,5558
2700,대구광역시,동구가선거구,6270201,2702,동구,신암4동,계,10058,3728,674,1900,1007,3581,147,6330
2700,대구광역시,동구가선거구,6270201,2702,동구,신암4동,관내사전투표,1296,1294,252,638,355,1245,49,2
2700,대구광역시,동구가선거구,6270201,2702,동구,신암4동,선거일투표,8762,2434,422,1262,652,2336,98,6328
2700,대구광역시,동구가선거구,6270201,2702,동구,잘못 투입·구분된 투표지,,0,10,3,5,2,10,0,-10
2700,대구광역시,동구나선거구,6270202,2702,동구,합계,,33209,14721,2374,7772,3271,754,14171,550,18488
2700,대구광역시,동구나선거구,6270202,2702,동구,거소투표,,31,30,6,16,4,3,29,1,1
2700,대구광역시,동구나선거구,6270202,2702,동구,관외사전투표,,1262,1262,317,654,187,60,1218,44,0
2700,대구광역시,동구나선거구,6270202,2702,동구,신암5동,계,5674,2610,381,1575,459,120,2535,75,3064
2700,대구광역시,동구나선거구,6270202,2702,동구,신암5동,관내사전투표,862,861,139,487,155,40,821,40,1
2700,대구광역시,동구나선거구,6270202,2702,동구,신암5동,선거일투표,4812,1749,242,1088,304,80,1714,35,3063
2700,대구광역시,동구나선거구,6270202,2702,동구,지저동,계,12669,5450,940,3081,1006,227,5254,196,7219
2700,대구광역시,동구나선거구,6270202,2702,동구,지저동,관내사전투표,1770,1770,341,957,329,64,1691,79,0
2700,대구광역시,동구나선거구,6270202,2702,동구,지저동,선거일투표,10899,3680,599,2124,677,163,3563,117,7219
2700,대구광역시,동구나선거구,6270202,2702,동구,동촌동,계,13573,5364,730,2442,1614,344,5130,234,8209
2700,대구광역시,동구나선거구,6270202,2702,동구,동촌동,관내사전투표,1816,1816,245,855,538,96,1734,82,0
2700,대구광역시,동구나선거구,6270202,2702,동구,동촌동,선거일투표,11757,3548,485,1587,1076,248,3396,152,8209
2700,대구광역시,동구나선거구,6270202,2702,동구,잘못 투입·구분된 투표지,,0,5,0,4,1,0,5,0,-5
2700,대구광역시,동구다선거구,6270203,2702,동구,합계,,53875,24350,2493,2673,7654,4666,4341,644,402,22873,1477,29525
2700,대구광역시,동구다선거구,6270203,2702,동구,거소투표,,68,63,7,6,19,12,13,2,0,59,4,5
2700,대구광역시,동구다선거구,6270203,2702,동구,관외사전투표,,2431,2431,370,265,912,280,310,95,58,2290,141,0
2700,대구광역시,동구다선거구,6270203,2702,동구,신천1·2동,계,11014,5093,560,461,1471,1387,604,103,109,4695,398,5921
2700,대구광역시,동구다선거구,6270203,2702,동구,신천1·2동,관내사전투표,1409,1407,152,134,417,383,180,15,29,1310,97,2
2700,대구광역시,동구다선거구,6270203,2702,동구,신천1·2동,선거일투표,9605,3686,408,327,1054,1004,424,88,80,3385,301,5919
2700,대구광역시,동구다선거구,6270203,2702,동구,신천3동,계,9919,4161,518,403,1443,895,471,142,58,3930,231,5758
2700,대구광역시,동구다선거구,6270203,2702,동구,신천3동,관내사전투표,1259,1259,187,132,401,316,121,37,16,1210,49,0
2700,대구광역시,동구다선거구,6270203,2702,동구,신천3동,선거일투표,8660,2902,331,271,1042,579,350,105,42,2720,182,5758
2700,대구광역시,동구다선거구,6270203,2702,동구,신천4동,계,7367,2769,285,422,979,494,291,81,41,2593,176,4598
2700,대구광역시,동구다선거구,6270203,2702,동구,신천4동,관내사전투표,779,777,88,137,252,158,85,18,6,744,33,2
2700,대구광역시,동구다선거구,6270203,2702,동구,신천4동,선거일투표,6588,1992,197,285,727,336,206,63,35,1849,143,4596
2700,대구광역시,동구다선거구,6270203,2702,동구,효목1동,계,11691,4966,377,427,1268,752,1710,86,57,4677,289,6725
2700,대구광역시,동구다선거구,6270203,2702,동구,효목1동,관내사전투표,883,882,70,85,215,124,331,10,10,845,37,1
2700,대구광역시,동구다선거구,6270203,2702,동구,효목1동,선거일투표,10808,4084,307,342,1053,628,1379,76,47,3832,252,6724
2700,대구광역시,동구다선거구,6270203,2702,동구,효목2동,계,11385,4863,374,689,1562,845,941,135,79,4625,238,6522
2700,대구광역시,동구다선거구,6270203,2702,동구,효목2동,관내사전투표,1445,1445,124,197,461,267,282,39,22,1392,53,0
2700,대구광역시,동구다선거구,6270203,2702,동구,효목2동,선거일투표,9940,3418,250,492,1101,578,659,96,57,3233,185,6522
2700,대구광역시,동구다선거구,6270203,2702,동구,잘못 투입·구분된 투표지,,0,4,2,0,0,1,1,0,0,4,0,-4
2700,대구광역시,동구라선거구,6270204,2702,동구,합계,,70895,32035,6101,12901,8180,2127,773,605,30687,1348,38860
2700,대구광역시,동구라선거구,6270204,2702,동구,거소투표,,151,144,41,44,33,11,5,4,138,6,7
2700,대구광역시,동구라선거구,6270204,2702,동구,관외사전투표,,2678,2678,756,1093,484,148,46,67,2594,84,0
2700,대구광역시,동구라선거구,6270204,2702,동구,도평동,계,3530,1598,243,646,312,268,32,27,1528,70,1932
2700,대구광역시,동구라선거구,6270204,2702,동구,도평동,관내사전투표,564,563,83,240,116,94,6,8,547,16,1
2700,대구광역시,동구라선거구,6270204,2702,동구,도평동,선거일투표,2966,1035,160,406,196,174,26,19,981,54,1931
2700,대구광역시,동구라선거구,6270204,2702,동구,불로·봉무동,계,16541,6914,1536,2568,1646,505,234,165,6654,260,9627
2700,대구광역시,동구라선거구,6270204,2702,동구,불로·봉무동,관내사전투표,1462,1461,294,593,358,104,29,33,1411,50,1
2700,대구광역시,동구라선거구,6270204,2702,동구,불로·봉무동,선거일투표,15079,5453,1242,1975,1288,401,205,132,5243,210,9626
2700,대구광역시,동구라선거구,6270204,2702,동구,방촌동,계,16141,7233,1167,2745,2315,450,168,92,6937,296,8908
2700,대구광역시,동구라선거구,6270204,2702,동구,방촌동,관내사전투표,1764,1764,329,658,574,94,32,20,1707,57,0
2700,대구광역시,동구라선거구,6270204,2702,동구,방촌동,선거일투표,14377,5469,838,2087,1741,356,136,72,5230,239,8908
2700,대구광역시,동구라선거구,6270204,2702,동구,해안동,계,13416,5575,786,2050,1987,331,84,82,5320,255,7841
2700,대구광역시,동구라선거구,6270204,2702,동구,해안동,관내사전투표,1872,1872,303,640,662,121,24,29,1779,93,0
2700,대구광역시,동구라선거구,6270204,2702,동구,해안동,선거일투표,11544,3703,483,1410,1325,210,60,53,3541,162,7841
2700,대구광역시,동구라선거구,6270204,2702,동구,공산동,계,18438,7877,1571,3747,1401,413,204,167,7503,374,10561
2700,대구광역시,동구라선거구,6270204,2702,동구,공산동,관내사전투표,1975,1973,429,904,363,112,43,33,1884,89,2
2700,대구광역시,동구라선거구,6270204,2702,동구,공산동,선거일투표,16463,5904,1142,2843,1038,301,161,134,5619,285,10559
2700,대구광역시,동구라선거구,6270204,2702,동구,잘못 투입·구분된 투표지,,0,16,1,8,2,1,0,1,13,3,-16
2700,대구광역시,동구마선거구,6270205,2702,동구,합계,,45695,19614,3677,7987,4329,2446,383,18822,792,26081
2700,대구광역시,동구마선거구,6270205,2702,동구,거소투표,,55,50,7,20,12,3,2,44,6,5
2700,대구광역시,동구마선거구,6270205,2702,동구,관외사전투표,,1774,1774,467,725,348,122,39,1701,73,0
2700,대구광역시,동구마선거구,6270205,2702,동구,안심1동,계,34386,13843,2598,5398,3092,1976,203,13267,576,20543
2700,대구광역시,동구마선거구,6270205,2702,동구,안심1동,관내사전투표,3255,3254,501,1397,683,511,35,3127,127,1
2700,대구광역시,동구마선거구,6270205,2702,동구,안심1동,선거일투표,31131,10589,2097,4001,2409,1465,168,10140,449,20542
2700,대구광역시,동구마선거구,6270205,2702,동구,안심2동,계,9480,3942,603,1843,876,344,139,3805,137,5538
2700,대구광역시,동구마선거구,6270205,2702,동구,안심2동,관내사전투표,1140,1140,195,534,227,109,44,1109,31,0
2700,대구광역시,동구마선거구,6270205,2702,동구,안심2동,선거일투표,8340,2802,408,1309,649,235,95,2696,106,5538
2700,대구광역시,동구마선거구,6270205,2702,동구,잘못 투입·구분된 투표지,,0,5,2,1,1,1,0,5,0,-5
2700,대구광역시,동구바선거구,6270206,2702,동구,합계,,56214,23766,5519,10478,4160,740,1060,934,22891,875,32448
2700,대구광역시,동구바선거구,6270206,2702,동구,거소투표,,54,48,7,18,16,3,0,2,46,2,6
2700,대구광역시,동구바선거구,6270206,2702,동구,관외사전투표,,2403,2401,725,948,433,78,56,88,2328,73,2
2700,대구광역시,동구바선거구,6270206,2702,동구,안심3동,계,17231,7396,1699,3093,1260,265,552,261,7130,266,9835
2700,대구광역시,동구바선거구,6270206,2702,동구,안심3동,관내사전투표,2559,2557,632,1105,382,103,172,76,2470,87,2
2700,대구광역시,동구바선거구,6270206,2702,동구,안심3동,선거일투표,14672,4839,1067,1988,878,162,380,185,4660,179,9833
2700,대구광역시,동구바선거구,6270206,2702,동구,안심4동,계,22340,8275,1469,4138,1588,184,297,254,7930,345,14065
2700,대구광역시,동구바선거구,6270206,2702,동구,안심4동,관내사전투표,1424,1422,244,779,236,40,34,40,1373,49,2
2700,대구광역시,동구바선거구,6270206,2702,동구,안심4동,선거일투표,20916,6853,1225,3359,1352,144,263,214,6557,296,14063
2700,대구광역시,동구바선거구,6270206,2702,동구,혁신동,계,14186,5632,1618,2274,860,209,155,328,5444,188,8554
2700,대구광역시,동구바선거구,6270206,2702,동구,혁신동,관내사전투표,1667,1664,502,688,244,54,39,81,1608,56,3
2700,대구광역시,동구바선거구,6270206,2702,동구,혁신동,선거일투표,12519,3968,1116,1586,616,155,116,247,3836,132,8551
2700,대구광역시,동구바선거구,6270206,2702,동구,잘못 투입·구분된 투표지,,0,14,1,7,3,1,0,1,13,1,-14
2700,대구광역시,서구가선거구,6270301,2703,서구,합계,,31706,14065,2016,6721,3342,1525,13604,461,17641
2700,대구광역시,서구가선거구,6270301,2703,서구,거소투표,,27,23,8,7,6,1,22,1,4
2700,대구광역시,서구가선거구,6270301,2703,서구,관외사전투표,,1425,1424,340,681,248,103,1372,52,1
2700,대구광역시,서구가선거구,6270301,2703,서구,내당1동,계,7374,2906,396,1390,802,210,2798,108,4468
2700,대구광역시,서구가선거구,6270301,2703,서구,내당1동,관내사전투표,1075,1074,170,481,299,79,1029,45,1
2700,대구광역시,서구가선거구,6270301,2703,서구,내당1동,선거일투표,6299,1832,226,909,503,131,1769,63,4467
2700,대구광역시,서구가선거구,6270301,2703,서구,내당2·3동,계,8529,3608,464,1575,1273,182,3494,114,4921
2700,대구광역시,서구가선거구,6270301,2703,서구,내당2·3동,관내사전투표,1022,1022,126,359,449,57,991,31,0
2700,대구광역시,서구가선거구,6270301,2703,서구,내당2·3동,선거일투표,7507,2586,338,1216,824,125,2503,83,4921
2700,대구광역시,서구가선거구,6270301,2703,서구,내당4동,계,14351,6101,808,3065,1013,1029,5915,186,8250
2700,대구광역시,서구가선거구,6270301,2703,서구,내당4동,관내사전투표,2009,2008,258,988,326,369,1941,67,1
2700,대구광역시,서구가선거구,6270301,2703,서구,내당4동,선거일투표,12342,4093,550,2077,687,660,3974,119,8249
2700,대구광역시,서구가선거구,6270301,2703,서구,잘못 투입·구분된 투표지,,0,3,0,3,0,0,3,0,-3
2700,대구광역시,서구나선거구,6270302,2703,서구,합계,,45081,20140,3120,9434,2437,2713,1738,19442,698,24941
2700,대구광역시,서구나선거구,6270302,2703,서구,거소투표,,44,42,8,21,3,6,4,42,0,2
2700,대구광역시,서구나선거구,6270302,2703,서구,관외사전투표,,1922,1921,441,893,206,176,129,1845,76,1
2700,대구광역시,서구나선거구,6270302,2703,서구,평리2동,계,6771,3073,509,1419,486,273,274,2961,112,3698
2700,대구광역시,서구나선거구,6270302,2703,서구,평리2동,관내사전투표,1208,1208,208,530,206,97,120,1161,47,0
2700,대구광역시,서구나선거구,6270302,2703,서구,평리2동,선거일투표,5563,1865,301,889,280,176,154,1800,65,3698
2700,대구광역시,서구나선거구,6270302,2703,서구,평리4동,계,14959,6110,934,2968,935,658,406,5901,209,8849
2700,대구광역시,서구나선거구,6270302,2703,서구,평리4동,관내사전투표,1720,1718,278,819,268,171,117,1653,65,2
2700,대구광역시,서구나선거구,6270302,2703,서구,평리4동,선거일투표,13239,4392,656,2149,667,487,289,4248,144,8847
2700,대구광역시,서구나선거구,6270302,2703,서구,평리5동,계,1642,730,84,399,56,100,70,709,21,912
2700,대구광역시,서구나선거구,6270302,2703,서구,평리5동,관내사전투표,393,393,39,214,22,63,45,383,10,0
2700,대구광역시,서구나선거구,6270302,2703,서구,평리5동,선거일투표,1249,337,45,185,34,37,25,326,11,912
2700,대구광역시,서구나선거구,6270302,2703,서구,평리6동,계,3218,1275,146,734,160,103,80,1223,52,1943
2700,대구광역시,서구나선거구,6270302,2703,서구,평리6동,관내사전투표,490,490,49,293,72,33,27,474,16,0
2700,대구광역시,서구나선거구,6270302,2703,서구,평리6동,선거일투표,2728,785,97,441,88,70,53,749,36,1943
2700,대구광역시,서구나선거구,6270302,2703,서구,상중이동,계,16525,6984,997,2998,591,1396,774,6756,228,9541
2700,대구광역시,서구나선거구,6270302,2703,서구,상중이동,관내사전투표,2009,2008,303,829,166,413,234,1945,63,1
2700,대구광역시,서구나선거구,6270302,2703,서구,상중이동,선거일투표,14516,4976,694,2169,425,983,540,4811,165,9540
2700,대구광역시,서구나선거구,6270302,2703,서구,잘못 투입·구분된 투표지,,0,5,1,2,0,1,1,5,0,-5
2700,대구광역시,서구다선거구,6270303,2703,서구,합계,,30632,13704,1847,7138,4201,13186,518,16928
2700,대구광역시,서구다선거구,6270303,2703,서구,거소투표,,38,33,10,12,7,29,4,5
2700,대구광역시,서구다선거구,6270303,2703,서구,관외사전투표,,972,972,238,516,183,937,35,0
2700,대구광역시,서구다선거구,6270303,2703,서구,비산1동,계,8521,3646,507,1979,1001,3487,159,4875
2700,대구광역시,서구다선거구,6270303,2703,서구,비산1동,관내사전투표,1468,1467,165,833,383,1381,86,1
2700,대구광역시,서구다선거구,6270303,2703,서구,비산1동,선거일투표,7053,2179,342,1146,618,2106,73,4874
2700,대구광역시,서구다선거구,6270303,2703,서구,비산5동,계,5484,2501,289,1221,882,2392,109,2983
2700,대구광역시,서구다선거구,6270303,2703,서구,비산5동,관내사전투표,1144,1139,132,548,397,1077,62,5
2700,대구광역시,서구다선거구,6270303,2703,서구,비산5동,선거일투표,4340,1362,157,673,485,1315,47,2978
2700,대구광역시,서구다선거구,6270303,2703,서구,비산7동,계,8810,3636,436,2113,970,3519,117,5174
2700,대구광역시,서구다선거구,6270303,2703,서구,비산7동,관내사전투표,1002,1002,134,590,239,963,39,0
2700,대구광역시,서구다선거구,6270303,2703,서구,비산7동,선거일투표,7808,2634,302,1523,731,2556,78,5174
2700,대구광역시,서구다선거구,6270303,2703,서구,원대동,계,6807,2910,367,1295,1154,2816,94,3897
2700,대구광역시,서구다선거구,6270303,2703,서구,원대동,관내사전투표,1013,1012,119,419,438,976,36,1
2700,대구광역시,서구다선거구,6270303,2703,서구,원대동,선거일투표,5794,1898,248,876,716,1840,58,3896
2700,대구광역시,서구다선거구,6270303,2703,서구,잘못 투입·구분된 투표지,,0,6,0,2,4,6,0,-6
2700,대구광역시,서구라선거구,6270304,2703,서구,합계,,40819,18525,3148,10679,3389,653,17869,656,22294
2700,대구광역시,서구라선거구,6270304,2703,서구,거소투표,,44,44,9,23,8,2,42,2,0
2700,대구광역시,서구라선거구,6270304,2703,서구,관외사전투표,,1500,1500,398,775,207,68,1448,52,0
2700,대구광역시,서구라선거구,6270304,2703,서구,비산2·3동,계,8202,3626,513,2197,642,113,3465,161,4576
2700,대구광역시,서구라선거구,6270304,2703,서구,비산2·3동,관내사전투표,1101,1098,173,664,179,21,1037,61,3
2700,대구광역시,서구라선거구,6270304,2703,서구,비산2·3동,선거일투표,7101,2528,340,1533,463,92,2428,100,4573
2700,대구광역시,서구라선거구,6270304,2703,서구,비산4동,계,8598,3682,568,2173,690,143,3574,108,4916
2700,대구광역시,서구라선거구,6270304,2703,서구,비산4동,관내사전투표,991,984,171,571,190,23,955,29,7
2700,대구광역시,서구라선거구,6270304,2703,서구,비산4동,선거일투표,7607,2698,397,1602,500,120,2619,79,4909
2700,대구광역시,서구라선거구,6270304,2703,서구,비산6동,계,6858,3131,479,1996,463,89,3027,104,3727
2700,대구광역시,서구라선거구,6270304,2703,서구,비산6동,관내사전투표,1196,1195,180,756,188,30,1154,41,1
2700,대구광역시,서구라선거구,6270304,2703,서구,비산6동,선거일투표,5662,1936,299,1240,275,59,1873,63,3726
2700,대구광역시,서구라선거구,6270304,2703,서구,평리1동,계,7101,3070,494,1688,661,99,2942,128,4031
2700,대구광역시,서구라선거구,6270304,2703,서구,평리1동,관내사전투표,1292,1291,216,699,277,44,1236,55,1
2700,대구광역시,서구라선거구,6270304,2703,서구,평리1동,선거일투표,5809,1779,278,989,384,55,1706,73,4030
2700,대구광역시,서구라선거구,6270304,2703,서구,평리3동,계,8516,3457,684,1819,715,139,3357,100,5059
2700,대구광역시,서구라선거구,6270304,2703,서구,평리3동,관내사전투표,768,766,188,361,160,35,744,22,2
2700,대구광역시,서구라선거구,6270304,2703,서구,평리3동,선거일투표,7748,2691,496,1458,555,104,2613,78,5057
2700,대구광역시,서구라선거구,6270304,2703,서구,잘못 투입·구분된 투표지,,0,15,3,8,3,0,14,1,-15
2700,대구광역시,남구가선거구,6270401,2704,남구,합계,,59526,25482,5009,12339,3852,3619,24819,663,34044
2700,대구광역시,남구가선거구,6270401,2704,남구,거소투표,,62,55,19,17,7,4,47,8,7
2700,대구광역시,남구가선거구,6270401,2704,남구,관외사전투표,,2407,2407,729,1143,249,210,2331,76,0
2700,대구광역시,남구가선거구,6270401,2704,남구,이천동,계,9933,4257,776,2003,522,850,4151,106,5676
2700,대구광역시,남구가선거구,6270401,2704,남구,이천동,관내사전투표,891,890,202,387,95,185,869,21,1
2700,대구광역시,남구가선거구,6270401,2704,남구,이천동,선거일투표,9042,3367,574,1616,427,665,3282,85,5675
2700,대구광역시,남구가선거구,6270401,2704,남구,봉덕1동,계,8122,3113,545,1522,495,475,3037,76,5009
2700,대구광역시,남구가선거구,6270401,2704,남구,봉덕1동,관내사전투표,980,980,207,472,142,133,954,26,0
2700,대구광역시,남구가선거구,6270401,2704,남구,봉덕1동,선거일투표,7142,2133,338,1050,353,342,2083,50,5009
2700,대구광역시,남구가선거구,6270401,2704,남구,봉덕2동,계,10353,4558,814,2285,709,642,4450,108,5795
2700,대구광역시,남구가선거구,6270401,2704,남구,봉덕2동,관내사전투표,1030,1026,212,489,160,149,1010,16,4
2700,대구광역시,남구가선거구,6270401,2704,남구,봉덕2동,선거일투표,9323,3532,602,1796,549,493,3440,92,5791
2700,대구광역시,남구가선거구,6270401,2704,남구,봉덕3동,계,13941,5246,899,2481,820,899,5099,147,8695
2700,대구광역시,남구가선거구,6270401,2704,남구,봉덕3동,관내사전투표,1465,1464,311,673,221,219,1424,40,1
2700,대구광역시,남구가선거구,6270401,2704,남구,봉덕3동,선거일투표,12476,3782,588,1808,599,680,3675,107,8694
2700,대구광역시,남구가선거구,6270401,2704,남구,대명2동,계,9168,3765,780,1820,736,341,3677,88,5403
2700,대구광역시,남구가선거구,6270401,2704,남구,대명2동,관내사전투표,871,869,227,404,164,60,855,14,2
2700,대구광역시,남구가선거구,6270401,2704,남구,대명2동,선거일투표,8297,2896,553,1416,572,281,2822,74,5401
2700,대구광역시,남구가선거구,6270401,2704,남구,대명5동,계,5540,2072,447,1062,311,198,2018,54,3468
2700,대구광역시,남구가선거구,6270401,2704,남구,대명5동,관내사전투표,519,518,127,248,84,53,512,6,1
2700,대구광역시,남구가선거구,6270401,2704,남구,대명5동,선거일투표,5021,1554,320,814,227,145,1506,48,3467
2700,대구광역시,남구가선거구,6270401,2704,남구,잘못 투입·구분된 투표지,,0,9,0,6,3,0,9,0,-9
2700,대구광역시,남구나선거구,6270402,2704,남구,합계,,38793,16603,2621,9264,2663,1454,16002,601,22190
2700,대구광역시,남구나선거구,6270402,2704,남구,거소투표,,38,37,9,17,4,3,33,4,1
2700,대구광역시,남구나선거구,6270402,2704,남구,관외사전투표,,1544,1544,430,788,183,103,1504,40,0
2700,대구광역시,남구나선거구,6270402,2704,남구,대명1동,계,9902,4104,615,2175,644,534,3968,136,5798
2700,대구광역시,남구나선거구,6270402,2704,남구,대명1동,관내사전투표,1370,1370,226,708,225,164,1323,47,0
2700,대구광역시,남구나선거구,6270402,2704,남구,대명1동,선거일투표,8532,2734,389,1467,419,370,2645,89,5798
2700,대구광역시,남구나선거구,6270402,2704,남구,대명3동,계,9608,3600,573,1931,653,280,3437,163,6008
2700,대구광역시,남구나선거구,6270402,2704,남구,대명3동,관내사전투표,1175,1172,208,606,216,78,1108,64,3
2700,대구광역시,남구나선거구,6270402,2704,남구,대명3동,선거일투표,8433,2428,365,1325,437,202,2329,99,6005
2700,대구광역시,남구나선거구,6270402,2704,남구,대명4동,계,9654,3900,516,2281,652,317,3766,134,5754
2700,대구광역시,남구나선거구,6270402,2704,남구,대명4동,관내사전투표,1167,1163,171,651,192,103,1117,46,4
2700,대구광역시,남구나선거구,6270402,2704,남구,대명4동,선거일투표,8487,2737,345,1630,460,214,2649,88,5750
2700,대구광역시,남구나선거구,6270402,2704,남구,대명10동,계,8047,3400,476,2063,523,214,3276,124,4647
2700,대구광역시,남구나선거구,6270402,2704,남구,대명10동,관내사전투표,1042,1036,157,628,156,66,1007,29,6
2700,대구광역시,남구나선거구,6270402,2704,남구,대명10동,선거일투표,7005,2364,319,1435,367,148,2269,95,4641
2700,대구광역시,남구나선거구,6270402,2704,남구,잘못 투입·구분된 투표지,,0,18,2,9,4,3,18,0,-18
2700,대구광역시,남구다선거구,6270403,2704,남구,합계,,30734,12603,2251,7307,2114,438,12110,493,18131
2700,대구광역시,남구다선거구,6270403,2704,남구,거소투표,,28,25,3,15,5,1,24,1,3
2700,대구광역시,남구다선거구,6270403,2704,남구,관외사전투표,,1271,1271,387,637,165,46,1235,36,0
2700,대구광역시,남구다선거구,6270403,2704,남구,대명6동,계,8257,3210,524,1841,581,129,3075,135,5047
2700,대구광역시,남구다선거구,6270403,2704,남구,대명6동,관내사전투표,1145,1143,214,644,189,44,1091,52,2
2700,대구광역시,남구다선거구,6270403,2704,남구,대명6동,선거일투표,7112,2067,310,1197,392,85,1984,83,5045
2700,대구광역시,남구다선거구,6270403,2704,남구,대명9동,계,13464,4941,941,2815,824,170,4750,191,8523
2700,대구광역시,남구다선거구,6270403,2704,남구,대명9동,관내사전투표,1836,1832,386,1073,286,42,1787,45,4
2700,대구광역시,남구다선거구,6270403,2704,남구,대명9동,선거일투표,11628,3109,555,1742,538,128,2963,146,8519
2700,대구광역시,남구다선거구,6270403,2704,남구,대명11동,계,7714,3144,394,1993,538,92,3017,127,4570
2700,대구광역시,남구다선거구,6270403,2704,남구,대명11동,관내사전투표,1004,1004,127,652,161,18,958,46,0
2700,대구광역시,남구다선거구,6270403,2704,남구,대명11동,선거일투표,6710,2140,267,1341,377,74,2059,81,4570
2700,대구광역시,남구다선거구,6270403,2704,남구,잘못 투입·구분된 투표지,,0,12,2,6,1,0,9,3,-12
2700,대구광역시,북구가선거구,6270501,2705,북구,합계,,34160,15398,3444,6053,3519,1519,14535,863,18762
2700,대구광역시,북구가선거구,6270501,2705,북구,거소투표,,58,53,10,18,19,6,53,0,5
2700,대구광역시,북구가선거구,6270501,2705,북구,관외사전투표,,1465,1465,447,536,326,114,1423,42,0
2700,대구광역시,북구가선거구,6270501,2705,북구,고성동,계,4305,2060,530,762,483,164,1939,121,2245
2700,대구광역시,북구가선거구,6270501,2705,북구,고성동,관내사전투표,975,974,260,365,214,96,935,39,1
2700,대구광역시,북구가선거구,6270501,2705,북구,고성동,선거일투표,3330,1086,270,397,269,68,1004,82,2244
2700,대구광역시,북구가선거구,6270501,2705,북구,칠성동,계,18266,7216,1641,2523,1736,897,6797,419,11050
2700,대구광역시,북구가선거구,6270501,2705,북구,칠성동,관내사전투표,1450,1444,340,565,301,181,1387,57,6
2700,대구광역시,북구가선거구,6270501,2705,북구,칠성동,선거일투표,16816,5772,1301,1958,1435,716,5410,362,11044
2700,대구광역시,북구가선거구,6270501,2705,북구,노원동,계,10066,4576,812,2202,949,336,4299,277,5490
2700,대구광역시,북구가선거구,6270501,2705,북구,노원동,관내사전투표,1271,1261,233,635,247,110,1225,36,10
2700,대구광역시,북구가선거구,6270501,2705,북구,노원동,선거일투표,8795,3315,579,1567,702,226,3074,241,5480
2700,대구광역시,북구가선거구,6270501,2705,북구,잘못 투입·구분된 투표지,,0,28,4,12,6,2,24,4,-28
2700,대구광역시,북구나선거구,6270502,2705,북구,합계,,34868,16396,3816,6823,4355,473,15467,929,18472
2700,대구광역시,북구나선거구,6270502,2705,북구,거소투표,,46,43,12,20,8,0,40,3,3
2700,대구광역시,북구나선거구,6270502,2705,북구,관외사전투표,,1430,1428,422,646,270,45,1383,45,2
2700,대구광역시,북구나선거구,6270502,2705,북구,침산1동,계,3585,1644,305,780,432,37,1554,90,1941
2700,대구광역시,북구나선거구,6270502,2705,북구,침산1동,관내사전투표,564,564,108,257,168,8,541,23,0
2700,대구광역시,북구나선거구,6270502,2705,북구,침산1동,선거일투표,3021,1080,197,523,264,29,1013,67,1941
2700,대구광역시,북구나선거구,6270502,2705,북구,침산2동,계,14050,6192,1433,2445,1715,214,5807,385,7858
2700,대구광역시,북구나선거구,6270502,2705,북구,침산2동,관내사전투표,1759,1756,391,717,518,66,1692,64,3
2700,대구광역시,북구나선거구,6270502,2705,북구,침산2동,선거일투표,12291,4436,1042,1728,1197,148,4115,321,7855
2700,대구광역시,북구나선거구,6270502,2705,북구,침산3동,계,15757,7061,1640,2919,1924,176,6659,402,8696
2700,대구광역시,북구나선거구,6270502,2705,북구,침산3동,관내사전투표,2199,2189,527,921,625,37,2110,79,10
2700,대구광역시,북구나선거구,6270502,2705,북구,침산3동,선거일투표,13558,4872,1113,1998,1299,139,4549,323,8686
2700,대구광역시,북구나선거구,6270502,2705,북구,잘못 투입·구분된 투표지,,0,28,4,13,6,1,24,4,-28
2700,대구광역시,북구다선거구,6270503,2705,북구,합계,,50385,22189,4155,9753,4134,3288,21330,859,28196
2700,대구광역시,북구다선거구,6270503,2705,북구,거소투표,,58,55,13,26,10,4,53,2,3
2700,대구광역시,북구다선거구,6270503,2705,북구,관외사전투표,,1895,1888,573,830,212,191,1806,82,7
2700,대구광역시,북구다선거구,6270503,2705,북구,산격1동,계,8206,3553,437,1906,790,209,3342,211,4653
2700,대구광역시,북구다선거구,6270503,2705,북구,산격1동,관내사전투표,1403,1400,181,728,348,69,1326,74,3
2700,대구광역시,북구다선거구,6270503,2705,북구,산격1동,선거일투표,6803,2153,256,1178,442,140,2016,137,4650
2700,대구광역시,북구다선거구,6270503,2705,북구,산격2동,계,9196,4017,706,1725,1093,377,3901,116,5179
2700,대구광역시,북구다선거구,6270503,2705,북구,산격2동,관내사전투표,1511,1504,264,646,412,137,1459,45,7
2700,대구광역시,북구다선거구,6270503,2705,북구,산격2동,선거일투표,7685,2513,442,1079,681,240,2442,71,5172
2700,대구광역시,북구다선거구,6270503,2705,북구,산격3동,계,8433,2950,605,1354,588,294,2841,109,5483
2700,대구광역시,북구다선거구,6270503,2705,북구,산격3동,관내사전투표,907,904,184,416,197,75,872,32,3
2700,대구광역시,북구다선거구,6270503,2705,북구,산격3동,선거일투표,7526,2046,421,938,391,219,1969,77,5480
2700,대구광역시,북구다선거구,6270503,2705,북구,산격4동,계,7687,3395,582,1468,927,284,3261,134,4292
2700,대구광역시,북구다선거구,6270503,2705,북구,산격4동,관내사전투표,1176,1176,266,478,286,103,1133,43,0
2700,대구광역시,북구다선거구,6270503,2705,북구,산격4동,선거일투표,6511,2219,316,990,641,181,2128,91,4292
2700,대구광역시,북구다선거구,6270503,2705,북구,대현동,계,14910,6304,1233,2430,510,1927,6100,204,8606
2700,대구광역시,북구다선거구,6270503,2705,북구,대현동,관내사전투표,2397,2395,445,897,177,794,2313,82,2
2700,대구광역시,북구다선거구,6270503,2705,북구,대현동,선거일투표,12513,3909,788,1533,333,1133,3787,122,8604
2700,대구광역시,북구다선거구,6270503,2705,북구,잘못 투입·구분된 투표지,,0,27,6,14,4,2,26,1,-27
2700,대구광역시,북구라선거구,6270504,2705,북구,합계,,39590,17112,4760,8073,3685,16518,594,22478
2700,대구광역시,북구라선거구,6270504,2705,북구,거소투표,,140,135,37,35,14,86,49,5
2700,대구광역시,북구라선거구,6270504,2705,북구,관외사전투표,,2073,2073,726,959,303,1988,85,0
2700,대구광역시,북구라선거구,6270504,2705,북구,복현1동,계,7194,2504,709,1267,453,2429,75,4690
2700,대구광역시,북구라선거구,6270504,2705,북구,복현1동,관내사전투표,952,950,314,452,161,927,23,2
2700,대구광역시,북구라선거구,6270504,2705,북구,복현1동,선거일투표,6242,1554,395,815,292,1502,52,4688
2700,대구광역시,북구라선거구,6270504,2705,북구,복현2동,계,24448,9709,2808,4389,2248,9445,264,14739
2700,대구광역시,북구라선거구,6270504,2705,북구,복현2동,관내사전투표,2421,2421,806,1032,510,2348,73,0
2700,대구광역시,북구라선거구,6270504,2705,북구,복현2동,선거일투표,22027,7288,2002,3357,1738,7097,191,14739
2700,대구광역시,북구라선거구,6270504,2705,북구,검단동,계,5735,2679,478,1417,665,2560,119,3056
2700,대구광역시,북구라선거구,6270504,2705,북구,검단동,관내사전투표,778,776,129,405,214,748,28,2
2700,대구광역시,북구라선거구,6270504,2705,북구,검단동,선거일투표,4957,1903,349,1012,451,1812,91,3054
2700,대구광역시,북구라선거구,6270504,2705,북구,잘못 투입·구분된 투표지,,0,12,2,6,2,10,2,-12
2700,대구광역시,북구마선거구,6270505,2705,북구,합계,,79567,32772,6992,17364,5223,2168,31747,1025,46795
2700,대구광역시,북구마선거구,6270505,2705,북구,거소투표,,96,86,28,42,9,4,83,3,10
2700,대구광역시,북구마선거구,6270505,2705,북구,관외사전투표,,3650,3647,1000,1771,527,239,3537,110,3
2700,대구광역시,북구마선거구,6270505,2705,북구,무태조야동,계,28772,11084,2356,6097,1871,391,10715,369,17688
2700,대구광역시,북구마선거구,6270505,2705,북구,무태조야동,관내사전투표,2710,2706,593,1517,429,83,2622,84,4
2700,대구광역시,북구마선거구,6270505,2705,북구,무태조야동,선거일투표,26062,8378,1763,4580,1442,308,8093,285,17684
2700,대구광역시,북구마선거구,6270505,2705,북구,관문동,계,28192,11159,2321,5547,1667,1335,10870,289,17033
2700,대구광역시,북구마선거구,6270505,2705,북구,관문동,관내사전투표,1389,1388,318,735,213,89,1355,33,1
2700,대구광역시,북구마선거구,6270505,2705,북구,관문동,선거일투표,26803,9771,2003,4812,1454,1246,9515,256,17032
2700,대구광역시,북구마선거구,6270505,2705,북구,태전1동,계,18857,6775,1281,3900,1146,196,6523,252,12082
2700,대구광역시,북구마선거구,6270505,2705,북구,태전1동,관내사전투표,1365,1361,292,751,251,35,1329,32,4
2700,대구광역시,북구마선거구,6270505,2705,북구,태전1동,선거일투표,17492,5414,989,3149,895,161,5194,220,12078
2700,대구광역시,북구마선거구,6270505,2705,북구,잘못 투입·구분된 투표지,,0,21,6,7,3,3,19,2,-21
2700,대구광역시,북구바선거구,6270506,2705,북구,합계,,74344,30957,5862,10344,5377,3309,1452,3510,29854,1103,43387
2700,대구광역시,북구바선거구,6270506,2705,북구,거소투표,,84,77,13,26,16,8,3,5,71,6,7
2700,대구광역시,북구바선거구,6270506,2705,북구,관외사전투표,,3357,3355,860,1213,543,229,160,246,3251,104,2
2700,대구광역시,북구바선거구,6270506,2705,북구,태전2동,계,20413,8037,1273,3117,1241,1090,277,716,7714,323,12376
2700,대구광역시,북구바선거구,6270506,2705,북구,태전2동,관내사전투표,2362,2358,374,887,354,340,83,237,2275,83,4
2700,대구광역시,북구바선거구,6270506,2705,북구,태전2동,선거일투표,18051,5679,899,2230,887,750,194,479,5439,240,12372
2700,대구광역시,북구바선거구,6270506,2705,북구,구암동,계,27582,10974,1994,3393,1712,1071,580,1811,10561,413,16608
2700,대구광역시,북구바선거구,6270506,2705,북구,구암동,관내사전투표,2674,2664,585,784,416,214,137,472,2608,56,10
2700,대구광역시,북구바선거구,6270506,2705,북구,구암동,선거일투표,24908,8310,1409,2609,1296,857,443,1339,7953,357,16598
2700,대구광역시,북구바선거구,6270506,2705,북구,국우동,계,22908,8488,1716,2589,1859,909,430,729,8232,256,14420
2700,대구광역시,북구바선거구,6270506,2705,북구,국우동,관내사전투표,1760,1758,374,551,388,184,82,137,1716,42,2
2700,대구광역시,북구바선거구,6270506,2705,북구,국우동,선거일투표,21148,6730,1342,2038,1471,725,348,592,6516,214,14418
2700,대구광역시,북구바선거구,6270506,2705,북구,잘못 투입·구분된 투표지,,0,26,6,6,6,2,2,3,25,1,-26
2700,대구광역시,북구사선거구,6270507,2705,북구,합계,,60509,25570,4467,12281,3626,2591,1733,24698,872,34939
2700,대구광역시,북구사선거구,6270507,2705,북구,거소투표,,90,84,8,43,14,8,7,80,4,6
2700,대구광역시,북구사선거구,6270507,2705,북구,관외사전투표,,2351,2351,566,1073,293,186,161,2279,72,0
2700,대구광역시,북구사선거구,6270507,2705,북구,관음동,계,14053,5631,768,2953,742,673,274,5410,221,8422
2700,대구광역시,북구사선거구,6270507,2705,북구,관음동,관내사전투표,1785,1783,249,944,242,207,93,1735,48,2
2700,대구광역시,북구사선거구,6270507,2705,북구,관음동,선거일투표,12268,3848,519,2009,500,466,181,3675,173,8420
2700,대구광역시,북구사선거구,6270507,2705,북구,읍내동,계,21997,8428,1305,4299,1134,895,498,8131,297,13569
2700,대구광역시,북구사선거구,6270507,2705,북구,읍내동,관내사전투표,2209,2204,349,1195,249,227,121,2141,63,5
2700,대구광역시,북구사선거구,6270507,2705,북구,읍내동,선거일투표,19788,6224,956,3104,885,668,377,5990,234,13564
2700,대구광역시,북구사선거구,6270507,2705,북구,동천동,계,22018,9065,1817,3906,1443,829,793,8788,277,12953
2700,대구광역시,북구사선거구,6270507,2705,북구,동천동,관내사전투표,2596,2594,566,1111,412,223,223,2535,59,2
2700,대구광역시,북구사선거구,6270507,2705,북구,동천동,선거일투표,19422,6471,1251,2795,1031,606,570,6253,218,12951
2700,대구광역시,북구사선거구,6270507,2705,북구,잘못 투입·구분된 투표지,,0,11,3,7,0,0,0,10,1,-11
2700,대구광역시,수성구가선거구,6270601,2706,수성구,합계,,56123,24739,4516,9028,4051,3689,2779,24063,676,31384
2700,대구광역시,수성구가선거구,6270601,2706,수성구,거소투표,,73,73,13,26,18,6,7,70,3,0
2700,대구광역시,수성구가선거구,6270601,2706,수성구,관외사전투표,,3448,3448,812,1275,530,406,332,3355,93,0
2700,대구광역시,수성구가선거구,6270601,2706,수성구,범어1동,계,12459,5180,812,1865,1093,641,623,5034,146,7279
2700,대구광역시,수성구가선거구,6270601,2706,수성구,범어1동,관내사전투표,1128,1125,172,379,232,151,148,1082,43,3
2700,대구광역시,수성구가선거구,6270601,2706,수성구,범어1동,선거일투표,11331,4055,640,1486,861,490,475,3952,103,7276
2700,대구광역시,수성구가선거구,6270601,2706,수성구,범어4동,계,13295,5076,1033,1789,798,747,601,4968,108,8219
2700,대구광역시,수성구가선거구,6270601,2706,수성구,범어4동,관내사전투표,1094,1094,242,392,176,148,115,1073,21,0
2700,대구광역시,수성구가선거구,6270601,2706,수성구,범어4동,선거일투표,12201,3982,791,1397,622,599,486,3895,87,8219
2700,대구광역시,수성구가선거구,6270601,2706,수성구,황금1동,계,17446,7750,1379,2705,1051,1463,927,7525,225,9696
2700,대구광역시,수성구가선거구,6270601,2706,수성구,황금1동,관내사전투표,1995,1993,418,694,265,316,243,1936,57,2
2700,대구광역시,수성구가선거구,6270601,2706,수성구,황금1동,선거일투표,15451,5757,961,2011,786,1147,684,5589,168,9694
2700,대구광역시,수성구가선거구,6270601,2706,수성구,황금2동,계,9402,3200,462,1367,557,426,288,3100,100,6202
2700,대구광역시,수성구가선거구,6270601,2706,수성구,황금2동,관내사전투표,769,768,123,329,118,101,75,746,22,1
2700,대구광역시,수성구가선거구,6270601,2706,수성구,황금2동,선거일투표,8633,2432,339,1038,439,325,213,2354,78,6201
2700,대구광역시,수성구가선거구,6270601,2706,수성구,잘못 투입·구분된 투표지,,0,12,5,1,4,0,1,11,1,-12
2700,대구광역시,수성구나선거구,6270602,2706,수성구,합계,,45080,20031,5465,9246,4756,19467,564,25049
2700,대구광역시,수성구나선거구,6270602,2706,수성구,거소투표,,47,47,9,22,15,46,1,0
2700,대구광역시,수성구나선거구,6270602,2706,수성구,관외사전투표,,2653,2652,908,1156,492,2556,96,1
2700,대구광역시,수성구나선거구,6270602,2706,수성구,범어2동,계,11754,4311,911,2126,1115,4152,159,7443
2700,대구광역시,수성구나선거구,6270602,2706,수성구,범어2동,관내사전투표,813,810,205,355,223,783,27,3
2700,대구광역시,수성구나선거구,6270602,2706,수성구,범어2동,선거일투표,10941,3501,706,1771,892,3369,132,7440
2700,대구광역시,수성구나선거구,6270602,2706,수성구,범어3동,계,12466,5048,1368,2409,1147,4924,124,7418
2700,대구광역시,수성구나선거구,6270602,2706,수성구,범어3동,관내사전투표,1473,1468,424,663,338,1425,43,5
2700,대구광역시,수성구나선거구,6270602,2706,수성구,범어3동,선거일투표,10993,3580,944,1746,809,3499,81,7413
2700,대구광역시,수성구나선거구,6270602,2706,수성구,만촌1동,계,18160,7950,2268,3525,1977,7770,180,10210
2700,대구광역시,수성구나선거구,6270602,2706,수성구,만촌1동,관내사전투표,2311,2306,738,869,624,2231,75,5
2700,대구광역시,수성구나선거구,6270602,2706,수성구,만촌1동,선거일투표,15849,5644,1530,2656,1353,5539,105,10205
2700,대구광역시,수성구나선거구,6270602,2706,수성구,잘못 투입·구분된 투표지,,0,23,1,8,10,19,4,-23
2700,대구광역시,수성구다선거구,6270603,2706,수성구,합계,,24922,11477,2303,4446,3542,881,11172,305,13445
2700,대구광역시,수성구다선거구,6270603,2706,수성구,거소투표,,33,30,7,10,9,2,28,2,3
2700,대구광역시,수성구다선거구,6270603,2706,수성구,관외사전투표,,1611,1610,371,672,405,106,1554,56,1
2700,대구광역시,수성구다선거구,6270603,2706,수성구,만촌2동,계,8974,3652,622,1506,1145,279,3552,100,5322
2700,대구광역시,수성구다선거구,6270603,2706,수성구,만촌2동,관내사전투표,973,969,205,368,292,80,945,24,4
2700,대구광역시,수성구다선거구,6270603,2706,수성구,만촌2동,선거일투표,8001,2683,417,1138,853,199,2607,76,5318
2700,대구광역시,수성구다선거구,6270603,2706,수성구,만촌3동,계,14304,6174,1297,2257,1979,494,6027,147,8130
2700,대구광역시,수성구다선거구,6270603,2706,수성구,만촌3동,관내사전투표,1636,1633,365,533,573,117,1588,45,3
2700,대구광역시,수성구다선거구,6270603,2706,수성구,만촌3동,선거일투표,12668,4541,932,1724,1406,377,4439,102,8127
2700,대구광역시,수성구다선거구,6270603,2706,수성구,잘못 투입·구분된 투표지,,0,11,6,1,4,0,11,0,-11
2700,대구광역시,수성구라선거구,6270604,2706,수성구,합계,,77121,35708,7376,15657,6159,4633,877,34702,1006,41413
2700,대구광역시,수성구라선거구,6270604,2706,수성구,거소투표,,87,84,13,42,13,8,3,79,5,3
2700,대구광역시,수성구라선거구,6270604,2706,수성구,관외사전투표,,3611,3609,949,1679,439,371,88,3526,83,2
2700,대구광역시,수성구라선거구,6270604,2706,수성구,고산1동,계,24589,10716,2261,4409,2118,1344,263,10395,321,13873
2700,대구광역시,수성구라선거구,6270604,2706,수성구,고산1동,관내사전투표,3217,3217,763,1332,581,383,63,3122,95,0
2700,대구광역시,수성구라선거구,6270604,2706,수성구,고산1동,선거일투표,21372,7499,1498,3077,1537,961,200,7273,226,13873
2700,대구광역시,수성구라선거구,6270604,2706,수성구,고산2동,계,22683,9793,1708,4406,1561,1613,199,9487,306,12890
2700,대구광역시,수성구라선거구,6270604,2706,수성구,고산2동,관내사전투표,2689,2684,499,1215,411,457,43,2625,59,5
2700,대구광역시,수성구라선거구,6270604,2706,수성구,고산2동,선거일투표,19994,7109,1209,3191,1150,1156,156,6862,247,12885
2700,대구광역시,수성구라선거구,6270604,2706,수성구,고산3동,계,26151,11493,2440,5117,2026,1296,323,11202,291,14658
2700,대구광역시,수성구라선거구,6270604,2706,수성구,고산3동,관내사전투표,3407,3407,771,1490,556,404,81,3302,105,0
2700,대구광역시,수성구라선거구,6270604,2706,수성구,고산3동,선거일투표,22744,8086,1669,3627,1470,892,242,7900,186,14658
2700,대구광역시,수성구라선거구,6270604,2706,수성구,잘못 투입·구분된 투표지,,0,13,5,4,2,1,1,13,0,-13
2700,대구광역시,수성구마선거구,6270605,2706,수성구,합계,,74434,32378,4145,1957,9788,3708,5953,3918,538,30007,2371,42056
2700,대구광역시,수성구마선거구,6270605,2706,수성구,거소투표,,71,61,7,1,28,9,5,2,0,52,9,10
2700,대구광역시,수성구마선거구,6270605,2706,수성구,관외사전투표,,3071,3067,593,220,1102,330,346,232,49,2872,195,4
2700,대구광역시,수성구마선거구,6270605,2706,수성구,수성1가동,계,14293,6495,915,370,1777,712,1732,388,134,6028,467,7798
2700,대구광역시,수성구마선거구,6270605,2706,수성구,수성1가동,관내사전투표,2213,2212,345,127,566,235,621,137,52,2083,129,1
2700,대구광역시,수성구마선거구,6270605,2706,수성구,수성1가동,선거일투표,12080,4283,570,243,1211,477,1111,251,82,3945,338,7797
2700,대구광역시,수성구마선거구,6270605,2706,수성구,수성2·3가동,계,9045,3807,461,199,1170,459,949,243,76,3557,250,5238
2700,대구광역시,수성구마선거구,6270605,2706,수성구,수성2·3가동,관내사전투표,1213,1213,159,61,354,150,308,75,17,1124,89,0
2700,대구광역시,수성구마선거구,6270605,2706,수성구,수성2·3가동,선거일투표,7832,2594,302,138,816,309,641,168,59,2433,161,5238
2700,대구광역시,수성구마선거구,6270605,2706,수성구,수성4가동,계,11952,5299,759,309,1445,510,1538,303,79,4943,356,6653
2700,대구광역시,수성구마선거구,6270605,2706,수성구,수성4가동,관내사전투표,1931,1930,291,122,476,179,583,101,30,1782,148,1
2700,대구광역시,수성구마선거구,6270605,2706,수성구,수성4가동,선거일투표,10021,3369,468,187,969,331,955,202,49,3161,208,6652
2700,대구광역시,수성구마선거구,6270605,2706,수성구,중동,계,10372,3955,426,248,1123,515,486,772,67,3637,318,6417
2700,대구광역시,수성구마선거구,6270605,2706,수성구,중동,관내사전투표,1091,1091,138,75,289,144,164,183,23,1016,75,0
2700,대구광역시,수성구마선거구,6270605,2706,수성구,중동,선거일투표,9281,2864,288,173,834,371,322,589,44,2621,243,6417
2700,대구광역시,수성구마선거구,6270605,2706,수성구,상동,계,13656,5483,509,381,1619,684,480,1269,83,5025,458,8173
2700,대구광역시,수성구마선거구,6270605,2706,수성구,상동,관내사전투표,1248,1248,142,95,336,153,110,286,23,1145,103,0
2700,대구광역시,수성구마선거구,6270605,2706,수성구,상동,선거일투표,12408,4235,367,286,1283,531,370,983,60,3880,355,8173
2700,대구광역시,수성구마선거구,6270605,2706,수성구,두산동,계,11974,4210,475,229,1524,489,417,709,50,3893,317,7764
2700,대구광역시,수성구마선거구,6270605,2706,수성구,두산동,관내사전투표,1034,1034,140,55,354,123,83,192,18,965,69,0
2700,대구광역시,수성구마선거구,6270605,2706,수성구,두산동,선거일투표,10940,3176,335,174,1170,366,334,517,32,2928,248,7764
2700,대구광역시,수성구마선거구,6270605,2706,수성구,잘못 투입·구분된 투표지,,0,1,0,0,0,0,0,0,0,0,1,-1
2700,대구광역시,수성구바선거구,6270606,2706,수성구,합계,,71368,33148,4632,10563,3809,6462,2935,2999,530,31930,1218,38220
2700,대구광역시,수성구바선거구,6270606,2706,수성구,거소투표,,94,86,13,37,10,18,3,2,0,83,3,8
2700,대구광역시,수성구바선거구,6270606,2706,수성구,관외사전투표,,3047,3046,692,1008,402,500,147,184,41,2974,72,1
2700,대구광역시,수성구바선거구,6270606,2706,수성구,파동,계,10215,4624,577,1700,477,862,221,531,50,4418,206,5591
2700,대구광역시,수성구바선거구,6270606,2706,수성구,파동,관내사전투표,1380,1380,168,500,149,233,64,184,11,1309,71,0
2700,대구광역시,수성구바선거구,6270606,2706,수성구,파동,선거일투표,8835,3244,409,1200,328,629,157,347,39,3109,135,5591
2700,대구광역시,수성구바선거구,6270606,2706,수성구,지산1동,계,18991,8050,1144,2772,1043,1508,762,422,101,7752,298,10941
2700,대구광역시,수성구바선거구,6270606,2706,수성구,지산1동,관내사전투표,2675,2675,405,923,335,443,310,144,29,2589,86,0
2700,대구광역시,수성구바선거구,6270606,2706,수성구,지산1동,선거일투표,16316,5375,739,1849,708,1065,452,278,72,5163,212,10941
2700,대구광역시,수성구바선거구,6270606,2706,수성구,지산2동,계,15054,6201,803,1950,705,1037,1038,389,79,6001,200,8853
2700,대구광역시,수성구바선거구,6270606,2706,수성구,지산2동,관내사전투표,1829,1828,269,600,204,297,272,112,15,1769,59,1
2700,대구광역시,수성구바선거구,6270606,2706,수성구,지산2동,선거일투표,13225,4373,534,1350,501,740,766,277,64,4232,141,8852
2700,대구광역시,수성구바선거구,6270606,2706,수성구,범물1동,계,10177,4965,522,1608,544,1067,331,564,101,4737,228,5212
2700,대구광역시,수성구바선거구,6270606,2706,수성구,범물1동,관내사전투표,1887,1887,198,624,188,414,106,221,40,1791,96,0
2700,대구광역시,수성구바선거구,6270606,2706,수성구,범물1동,선거일투표,8290,3078,324,984,356,653,225,343,61,2946,132,5212
2700,대구광역시,수성구바선거구,6270606,2706,수성구,범물2동,계,13790,6170,881,1484,627,1469,433,907,158,5959,211,7620
2700,대구광역시,수성구바선거구,6270606,2706,수성구,범물2동,관내사전투표,1986,1986,326,443,192,493,126,275,57,1912,74,0
2700,대구광역시,수성구바선거구,6270606,2706,수성구,범물2동,선거일투표,11804,4184,555,1041,435,976,307,632,101,4047,137,7620
2700,대구광역시,수성구바선거구,6270606,2706,수성구,잘못 투입·구분된 투표지,,0,6,0,4,1,1,0,0,0,6,0,-6
2700,대구광역시,달서구가선거구,6270701,2707,달서구,합계,,78177,32349,6386,11824,6907,4223,1989,31329,1020,45828
2700,대구광역시,달서구가선거구,6270701,2707,달서구,거소투표,,72,66,9,28,12,6,7,62,4,6
2700,대구광역시,달서구가선거구,6270701,2707,달서구,관외사전투표,,3263,3255,845,1185,644,317,167,3158,97,8
2700,대구광역시,달서구가선거구,6270701,2707,달서구,죽전동,계,11634,3998,685,1971,609,439,131,3835,163,7636
2700,대구광역시,달서구가선거구,6270701,2707,달서구,죽전동,관내사전투표,947,942,186,439,137,119,30,911,31,5
2700,대구광역시,달서구가선거구,6270701,2707,달서구,죽전동,선거일투표,10687,3056,499,1532,472,320,101,2924,132,7631
2700,대구광역시,달서구가선거구,6270701,2707,달서구,장기동,계,13994,5453,1066,1897,1268,713,348,5292,161,8541
2700,대구광역시,달서구가선거구,6270701,2707,달서구,장기동,관내사전투표,1554,1539,322,542,373,197,73,1507,32,15
2700,대구광역시,달서구가선거구,6270701,2707,달서구,장기동,선거일투표,12440,3914,744,1355,895,516,275,3785,129,8526
2700,대구광역시,달서구가선거구,6270701,2707,달서구,용산1동,계,25398,9979,1825,4133,1664,1218,864,9704,275,15419
2700,대구광역시,달서구가선거구,6270701,2707,달서구,용산1동,관내사전투표,2611,2609,548,1120,408,299,177,2552,57,2
2700,대구광역시,달서구가선거구,6270701,2707,달서구,용산1동,선거일투표,22787,7370,1277,3013,1256,919,687,7152,218,15417
2700,대구광역시,달서구가선거구,6270701,2707,달서구,용산2동,계,23816,9555,1948,2594,2700,1527,469,9238,317,14261
2700,대구광역시,달서구가선거구,6270701,2707,달서구,용산2동,관내사전투표,2032,2028,411,492,629,332,110,1974,54,4
2700,대구광역시,달서구가선거구,6270701,2707,달서구,용산2동,선거일투표,21784,7527,1537,2102,2071,1195,359,7264,263,14257
2700,대구광역시,달서구가선거구,6270701,2707,달서구,잘못 투입·구분된 투표지,,0,43,8,16,10,3,3,40,3,-43
2700,대구광역시,달서구나선거구,6270702,2707,달서구,합계,,63824,25768,5452,7794,7865,3763,24874,894,38056
2700,대구광역시,달서구나선거구,6270702,2707,달서구,거소투표,,55,52,9,10,19,5,43,9,3
2700,대구광역시,달서구나선거구,6270702,2707,달서구,관외사전투표,,2527,2523,723,789,700,220,2432,91,4
2700,대구광역시,달서구나선거구,6270702,2707,달서구,이곡1동,계,19019,7028,1470,2114,2139,1091,6814,214,11991
2700,대구광역시,달서구나선거구,6270702,2707,달서구,이곡1동,관내사전투표,1529,1527,336,466,414,267,1483,44,2
2700,대구광역시,달서구나선거구,6270702,2707,달서구,이곡1동,선거일투표,17490,5501,1134,1648,1725,824,5331,170,11989
2700,대구광역시,달서구나선거구,6270702,2707,달서구,이곡2동,계,14723,6483,1228,1880,2133,1039,6280,203,8240
2700,대구광역시,달서구나선거구,6270702,2707,달서구,이곡2동,관내사전투표,2494,2486,492,695,792,431,2410,76,8
2700,대구광역시,달서구나선거구,6270702,2707,달서구,이곡2동,선거일투표,12229,3997,736,1185,1341,608,3870,127,8232
2700,대구광역시,달서구나선거구,6270702,2707,달서구,신당동,계,27500,9659,2017,2991,2871,1405,9284,375,17841
2700,대구광역시,달서구나선거구,6270702,2707,달서구,신당동,관내사전투표,1070,1069,250,321,325,117,1013,56,1
2700,대구광역시,달서구나선거구,6270702,2707,달서구,신당동,선거일투표,26430,8590,1767,2670,2546,1288,8271,319,17840
2700,대구광역시,달서구나선거구,6270702,2707,달서구,잘못 투입·구분된 투표지,,0,23,5,10,3,3,21,2,-23
2700,대구광역시,달서구다선거구,6270703,2707,달서구,합계,,42090,17881,3036,6521,3151,4063,603,17374,507,24209
2700,대구광역시,달서구다선거구,6270703,2707,달서구,거소투표,,65,58,15,23,8,8,2,56,2,7
2700,대구광역시,달서구다선거구,6270703,2707,달서구,관외사전투표,,2078,2074,478,837,275,366,52,2008,66,4
2700,대구광역시,달서구다선거구,6270703,2707,달서구,월성1동,계,25569,9344,1710,3131,1477,2503,320,9141,203,16225
2700,대구광역시,달서구다선거구,6270703,2707,달서구,월성1동,관내사전투표,1321,1320,226,469,230,322,47,1294,26,1
2700,대구광역시,달서구다선거구,6270703,2707,달서구,월성1동,선거일투표,24248,8024,1484,2662,1247,2181,273,7847,177,16224
2700,대구광역시,달서구다선거구,6270703,2707,달서구,월성2동,계,14378,6396,830,2528,1391,1182,229,6160,236,7982
2700,대구광역시,달서구다선거구,6270703,2707,달서구,월성2동,관내사전투표,2222,2219,317,799,504,448,73,2141,78,3
2700,대구광역시,달서구다선거구,6270703,2707,달서구,월성2동,선거일투표,12156,4177,513,1729,887,734,156,4019,158,7979
2700,대구광역시,달서구다선거구,6270703,2707,달서구,잘못 투입·구분된 투표지,,0,9,3,2,0,4,0,9,0,-9
2700,대구광역시,달서구라선거구,6270704,2707,달서구,합계,,47564,20300,4149,10710,4801,19660,640,27264
2700,대구광역시,달서구라선거구,6270704,2707,달서구,거소투표,,55,52,9,31,6,46,6,3
2700,대구광역시,달서구라선거구,6270704,2707,달서구,관외사전투표,,2255,2250,623,1221,343,2187,63,5
2700,대구광역시,달서구라선거구,6270704,2707,달서구,상인1동,계,28344,12091,2434,6318,2981,11733,358,16253
2700,대구광역시,달서구라선거구,6270704,2707,달서구,상인1동,관내사전투표,2052,2038,398,1038,540,1976,62,14
2700,대구광역시,달서구라선거구,6270704,2707,달서구,상인1동,선거일투표,26292,10053,2036,5280,2441,9757,296,16239
2700,대구광역시,달서구라선거구,6270704,2707,달서구,상인2동,계,16910,5888,1077,3133,1465,5675,213,11022
2700,대구광역시,달서구라선거구,6270704,2707,달서구,상인2동,관내사전투표,1713,1713,317,871,440,1628,85,0
2700,대구광역시,달서구라선거구,6270704,2707,달서구,상인2동,선거일투표,15197,4175,760,2262,1025,4047,128,11022
2700,대구광역시,달서구라선거구,6270704,2707,달서구,잘못 투입·구분된 투표지,,0,19,6,7,6,19,0,-19
2700,대구광역시,달서구마선거구,6270705,2707,달서구,합계,,66993,27790,6346,13668,5106,594,1241,26955,835,39203
2700,대구광역시,달서구마선거구,6270705,2707,달서구,거소투표,,94,91,22,51,10,2,4,89,2,3
2700,대구광역시,달서구마선거구,6270705,2707,달서구,관외사전투표,,2974,2972,813,1409,504,61,99,2886,86,2
2700,대구광역시,달서구마선거구,6270705,2707,달서구,진천동,계,41489,15835,3077,8097,2979,318,827,15298,537,25654
2700,대구광역시,달서구마선거구,6270705,2707,달서구,진천동,관내사전투표,3394,3389,669,1666,667,71,207,3280,109,5
2700,대구광역시,달서구마선거구,6270705,2707,달서구,진천동,선거일투표,38095,12446,2408,6431,2312,247,620,12018,428,25649
2700,대구광역시,달서구마선거구,6270705,2707,달서구,유천동,계,22436,8830,2421,4082,1602,211,308,8624,206,13606
2700,대구광역시,달서구마선거구,6270705,2707,달서구,유천동,관내사전투표,1970,1968,562,876,378,40,67,1923,45,2
2700,대구광역시,달서구마선거구,6270705,2707,달서구,유천동,선거일투표,20466,6862,1859,3206,1224,171,241,6701,161,13604
2700,대구광역시,달서구마선거구,6270705,2707,달서구,잘못 투입·구분된 투표지,,0,62,13,29,11,2,3,58,4,-62
2700,대구광역시,달서구바선거구,6270706,2707,달서구,합계,,40996,18780,3416,7975,5531,1049,17971,809,22216
2700,대구광역시,달서구바선거구,6270706,2707,달서구,거소투표,,55,52,18,15,14,2,49,3,3
2700,대구광역시,달서구바선거구,6270706,2707,달서구,관외사전투표,,1443,1443,380,561,371,91,1403,40,0
2700,대구광역시,달서구바선거구,6270706,2707,달서구,상인3동,계,10086,4358,634,2281,917,240,4072,286,5728
2700,대구광역시,달서구바선거구,6270706,2707,달서구,상인3동,관내사전투표,1632,1629,253,859,348,93,1553,76,3
2700,대구광역시,달서구바선거구,6270706,2707,달서구,상인3동,선거일투표,8454,2729,381,1422,569,147,2519,210,5725
2700,대구광역시,달서구바선거구,6270706,2707,달서구,도원동,계,29412,12917,2381,5114,4226,716,12437,480,16495
2700,대구광역시,달서구바선거구,6270706,2707,달서구,도원동,관내사전투표,3265,3262,627,1298,1109,147,3181,81,3
2700,대구광역시,달서구바선거구,6270706,2707,달서구,도원동,선거일투표,26147,9655,1754,3816,3117,569,9256,399,16492
2700,대구광역시,달서구바선거구,6270706,2707,달서구,잘못 투입·구분된 투표지,,0,10,3,4,3,0,10,0,-10
2700,대구광역시,달서구사선거구,6270707,2707,달서구,합계,,62939,25214,3907,12818,5423,2100,24248,966,37725
2700,대구광역시,달서구사선거구,6270707,2707,달서구,거소투표,,63,56,10,27,8,6,51,5,7
2700,대구광역시,달서구사선거구,6270707,2707,달서구,관외사전투표,,3266,3264,731,1559,541,308,3139,125,2
2700,대구광역시,달서구사선거구,6270707,2707,달서구,성당동,계,18699,6761,912,3523,1528,567,6530,231,11938
2700,대구광역시,달서구사선거구,6270707,2707,달서구,성당동,관내사전투표,1675,1673,229,894,396,99,1618,55,2
2700,대구광역시,달서구사선거구,6270707,2707,달서구,성당동,선거일투표,17024,5088,683,2629,1132,468,4912,176,11936
2700,대구광역시,달서구사선거구,6270707,2707,달서구,두류1·2동,계,12711,4404,579,2423,938,258,4198,206,8307
2700,대구광역시,달서구사선거구,6270707,2707,달서구,두류1·2동,관내사전투표,1345,1343,167,696,332,85,1280,63,2
2700,대구광역시,달서구사선거구,6270707,2707,달서구,두류1·2동,선거일투표,11366,3061,412,1727,606,173,2918,143,8305
2700,대구광역시,달서구사선거구,6270707,2707,달서구,두류3동,계,7331,3111,475,1542,749,208,2974,137,4220
2700,대구광역시,달서구사선거구,6270707,2707,달서구,두류3동,관내사전투표,1266,1262,195,601,291,107,1194,68,4
2700,대구광역시,달서구사선거구,6270707,2707,달서구,두류3동,선거일투표,6065,1849,280,941,458,101,1780,69,4216
2700,대구광역시,달서구사선거구,6270707,2707,달서구,감삼동,계,20869,7589,1196,3727,1656,752,7331,258,13280
2700,대구광역시,달서구사선거구,6270707,2707,달서구,감삼동,관내사전투표,1010,999,164,494,227,82,967,32,11
2700,대구광역시,달서구사선거구,6270707,2707,달서구,감삼동,선거일투표,19859,6590,1032,3233,1429,670,6364,226,13269
2700,대구광역시,달서구사선거구,6270707,2707,달서구,잘못 투입·구분된 투표지,,0,29,4,17,3,1,25,4,-29
2700,대구광역시,달서구아선거구,6270708,2707,달서구,검색된 결과가 없습니다.
2700,대구광역시,달성군가선거구,6270801,2708,달성군,합계,,47393,21964,3255,12663,3888,1622,21428,536,25429
2700,대구광역시,달성군가선거구,6270801,2708,달성군,거소투표,,146,138,37,57,18,8,120,18,8
2700,대구광역시,달성군가선거구,6270801,2708,달성군,관외사전투표,,2093,2081,477,1082,328,143,2030,51,12
2700,대구광역시,달성군가선거구,6270801,2708,달성군,화원읍,계,38508,16590,2339,9559,3189,1124,16211,379,21918
2700,대구광역시,달성군가선거구,6270801,2708,달성군,화원읍,관내사전투표,3226,3221,468,1784,647,249,3148,73,5
2700,대구광역시,달성군가선거구,6270801,2708,달성군,화원읍,선거일투표,35282,13369,1871,7775,2542,875,13063,306,21913
2700,대구광역시,달성군가선거구,6270801,2708,달성군,가창면,계,6646,3132,400,1954,347,345,3046,86,3514
2700,대구광역시,달성군가선거구,6270801,2708,달성군,가창면,관내사전투표,947,945,140,578,94,110,922,23,2
2700,대구광역시,달성군가선거구,6270801,2708,달성군,가창면,선거일투표,5699,2187,260,1376,253,235,2124,63,3512
2700,대구광역시,달성군가선거구,6270801,2708,달성군,잘못 투입·구분된 투표지,,0,23,2,11,6,2,21,2,-23
2700,대구광역시,달성군나선거구,6270802,2708,달성군,합계,,36780,16459,2981,8841,4095,15917,542,20321
2700,대구광역시,달성군나선거구,6270802,2708,달성군,거소투표,,56,50,7,32,9,48,2,6
2700,대구광역시,달성군나선거구,6270802,2708,달성군,관외사전투표,,1658,1658,384,889,345,1618,40,0
2700,대구광역시,달성군나선거구,6270802,2708,달성군,논공읍,계,15137,6110,1305,2461,2115,5881,229,9027
2700,대구광역시,달성군나선거구,6270802,2708,달성군,논공읍,관내사전투표,1212,1210,190,530,461,1181,29,2
2700,대구광역시,달성군나선거구,6270802,2708,달성군,논공읍,선거일투표,13925,4900,1115,1931,1654,4700,200,9025
2700,대구광역시,달성군나선거구,6270802,2708,달성군,옥포읍,계,19929,8627,1282,5453,1622,8357,270,11302
2700,대구광역시,달성군나선거구,6270802,2708,달성군,옥포읍,관내사전투표,2066,2058,308,1342,375,2025,33,8
2700,대구광역시,달성군나선거구,6270802,2708,달성군,옥포읍,선거일투표,17863,6569,974,4111,1247,6332,237,11294
2700,대구광역시,달성군나선거구,6270802,2708,달성군,잘못 투입·구분된 투표지,,0,14,3,6,4,13,1,-14
2700,대구광역시,달성군다선거구,6270803,2708,달성군,합계,,56373,22209,3975,9770,4016,2328,1447,21536,673,34164
2700,대구광역시,달성군다선거구,6270803,2708,달성군,거소투표,,64,53,7,24,14,7,1,53,0,11
2700,대구광역시,달성군다선거구,6270803,2708,달성군,관외사전투표,,2004,2004,450,946,297,152,97,1942,62,0
2700,대구광역시,달성군다선거구,6270803,2708,달성군,유가읍,계,21096,8501,1748,3801,1456,509,786,8300,201,12595
2700,대구광역시,달성군다선거구,6270803,2708,달성군,유가읍,관내사전투표,3147,3143,741,1374,486,202,273,3076,67,4
2700,대구광역시,달성군다선거구,6270803,2708,달성군,유가읍,선거일투표,17949,5358,1007,2427,970,307,513,5224,134,12591
2700,대구광역시,달성군다선거구,6270803,2708,달성군,현풍읍,계,18081,6398,965,3027,1440,391,344,6167,231,11683
2700,대구광역시,달성군다선거구,6270803,2708,달성군,현풍읍,관내사전투표,1486,1483,206,739,320,104,71,1440,43,3
2700,대구광역시,달성군다선거구,6270803,2708,달성군,현풍읍,선거일투표,16595,4915,759,2288,1120,287,273,4727,188,11680
2700,대구광역시,달성군다선거구,6270803,2708,달성군,구지면,계,15128,5244,805,1965,809,1269,217,5065,179,9884
2700,대구광역시,달성군다선거구,6270803,2708,달성군,구지면,관내사전투표,1684,1684,284,615,262,403,70,1634,50,0
2700,대구광역시,달성군다선거구,6270803,2708,달성군,구지면,선거일투표,13444,3560,521,1350,547,866,147,3431,129,9884
2700,대구광역시,달성군다선거구,6270803,2708,달성군,잘못 투입·구분된 투표지,,0,9,0,7,0,0,2,9,0,-9
2700,대구광역시,달성군라선거구,6270804,2708,달성군,합계,,74034,30686,6676,14350,4890,2947,1027,29890,796,43348
2700,대구광역시,달성군라선거구,6270804,2708,달성군,거소투표,,103,96,31,46,9,5,2,93,3,7
2700,대구광역시,달성군라선거구,6270804,2708,달성군,관외사전투표,,3055,3054,896,1332,404,226,112,2970,84,1
2700,대구광역시,달성군라선거구,6270804,2708,달성군,다사읍,계,67504,25887,5581,12238,3937,2617,874,25247,640,41617
2700,대구광역시,달성군라선거구,6270804,2708,달성군,다사읍,관내사전투표,3855,3851,912,1875,572,284,121,3764,87,4
2700,대구광역시,달성군라선거구,6270804,2708,달성군,다사읍,선거일투표,63649,22036,4669,10363,3365,2333,753,21483,553,41613
2700,대구광역시,달성군라선거구,6270804,2708,달성군,하빈면,계,3372,1640,165,730,540,97,39,1571,69,1732
2700,대구광역시,달성군라선거구,6270804,2708,달성군,하빈면,관내사전투표,621,621,82,251,199,39,22,593,28,0
2700,대구광역시,달성군라선거구,6270804,2708,달성군,하빈면,선거일투표,2751,1019,83,479,341,58,17,978,41,1732
2700,대구광역시,달성군라선거구,6270804,2708,달성군,잘못 투입·구분된 투표지,,0,9,3,4,0,2,0,9,0,-92800,인천광역시,중구가선거구,6280101,2801,중구,합계,,41055,19740,4296,3170,6956,1603,2460,18485,1255,21315
2800,인천광역시,중구가선거구,6280101,2801,중구,거소투표,,81,67,9,13,28,4,7,61,6,14
2800,인천광역시,중구가선거구,6280101,2801,중구,관외사전투표,,1662,1660,465,305,601,118,87,1576,84,2
2800,인천광역시,중구가선거구,6280101,2801,중구,신포동,계,4727,2321,525,406,635,236,395,2197,124,2406
2800,인천광역시,중구가선거구,6280101,2801,중구,신포동,관내사전투표,996,996,233,177,256,81,195,942,54,0
2800,인천광역시,중구가선거구,6280101,2801,중구,신포동,선거일투표,3731,1325,292,229,379,155,200,1255,70,2406
2800,인천광역시,중구가선거구,6280101,2801,중구,연안동,계,5393,2352,468,363,837,207,334,2209,143,3041
2800,인천광역시,중구가선거구,6280101,2801,중구,연안동,관내사전투표,1101,1101,235,175,376,99,166,1051,50,0
2800,인천광역시,중구가선거구,6280101,2801,중구,연안동,선거일투표,4292,1251,233,188,461,108,168,1158,93,3041
2800,인천광역시,중구가선거구,6280101,2801,중구,신흥동,계,11203,4973,1074,901,1811,411,460,4657,316,6230
2800,인천광역시,중구가선거구,6280101,2801,중구,신흥동,관내사전투표,1719,1717,369,351,580,133,182,1615,102,2
2800,인천광역시,중구가선거구,6280101,2801,중구,신흥동,선거일투표,9484,3256,705,550,1231,278,278,3042,214,6228
2800,인천광역시,중구가선거구,6280101,2801,중구,도원동,계,3783,2041,411,273,952,158,130,1924,117,1742
2800,인천광역시,중구가선거구,6280101,2801,중구,도원동,관내사전투표,1032,1029,186,144,499,82,59,970,59,3
2800,인천광역시,중구가선거구,6280101,2801,중구,도원동,선거일투표,2751,1012,225,129,453,76,71,954,58,1739
2800,인천광역시,중구가선거구,6280101,2801,중구,율목동,계,2833,1259,249,206,479,116,111,1161,98,1574
2800,인천광역시,중구가선거구,6280101,2801,중구,율목동,관내사전투표,516,515,98,94,191,48,47,478,37,1
2800,인천광역시,중구가선거구,6280101,2801,중구,율목동,선거일투표,2317,744,151,112,288,68,64,683,61,1573
2800,인천광역시,중구가선거구,6280101,2801,중구,동인천동,계,5293,2298,488,354,803,182,302,2129,169,2995
2800,인천광역시,중구가선거구,6280101,2801,중구,동인천동,관내사전투표,1043,1040,246,167,349,80,123,965,75,3
2800,인천광역시,중구가선거구,6280101,2801,중구,동인천동,선거일투표,4250,1258,242,187,454,102,179,1164,94,2992
2800,인천광역시,중구가선거구,6280101,2801,중구,개항동,계,6080,2748,603,344,803,169,633,2552,196,3332
2800,인천광역시,중구가선거구,6280101,2801,중구,개항동,관내사전투표,999,998,240,154,306,65,171,936,62,1
2800,인천광역시,중구가선거구,6280101,2801,중구,개항동,선거일투표,5081,1750,363,190,497,104,462,1616,134,3331
2800,인천광역시,중구가선거구,6280101,2801,중구,잘못 투입·구분된 투표지,,0,21,4,5,7,2,1,19,2,-21
2800,인천광역시,중구나선거구,6280102,2801,중구,합계,,83919,37611,11026,3987,3631,10800,5397,911,35752,1859,46308
2800,인천광역시,중구나선거구,6280102,2801,중구,거소투표,,83,78,18,7,5,31,8,2,71,7,5
2800,인천광역시,중구나선거구,6280102,2801,중구,관외사전투표,,3371,3370,1004,338,232,1169,337,88,3168,202,1
2800,인천광역시,중구나선거구,6280102,2801,중구,영종동,계,15928,6372,1755,572,462,1953,1143,94,5979,393,9556
2800,인천광역시,중구나선거구,6280102,2801,중구,영종동,관내사전투표,2088,2088,527,198,145,638,415,26,1949,139,0
2800,인천광역시,중구나선거구,6280102,2801,중구,영종동,선거일투표,13840,4284,1228,374,317,1315,728,68,4030,254,9556
2800,인천광역시,중구나선거구,6280102,2801,중구,영종1동,계,31428,13900,4317,1720,985,3857,1991,424,13294,606,17528
2800,인천광역시,중구나선거구,6280102,2801,중구,영종1동,관내사전투표,3361,3359,1072,442,230,924,488,70,3226,133,2
2800,인천광역시,중구나선거구,6280102,2801,중구,영종1동,선거일투표,28067,10541,3245,1278,755,2933,1503,354,10068,473,17526
2800,인천광역시,중구나선거구,6280102,2801,중구,운서동,계,29750,12197,3595,1229,1808,3220,1554,283,11689,508,17553
2800,인천광역시,중구나선거구,6280102,2801,중구,운서동,관내사전투표,5382,5382,1701,597,850,1327,605,127,5207,175,0
2800,인천광역시,중구나선거구,6280102,2801,중구,운서동,선거일투표,24368,6815,1894,632,958,1893,949,156,6482,333,17553
2800,인천광역시,중구나선거구,6280102,2801,중구,용유동,계,3359,1691,337,120,138,570,363,20,1548,143,1668
2800,인천광역시,중구나선거구,6280102,2801,중구,용유동,관내사전투표,674,673,141,48,47,243,129,7,615,58,1
2800,인천광역시,중구나선거구,6280102,2801,중구,용유동,선거일투표,2685,1018,196,72,91,327,234,13,933,85,1667
2800,인천광역시,중구나선거구,6280102,2801,중구,잘못 투입·구분된 투표지,,0,3,0,1,1,0,1,0,3,0,-3
2800,인천광역시,동구가선거구,6280201,2802,동구,합계,,27182,15185,3629,1675,4697,1964,2329,14294,891,11997
2800,인천광역시,동구가선거구,6280201,2802,동구,거소투표,,25,22,8,0,7,0,5,20,2,3
2800,인천광역시,동구가선거구,6280201,2802,동구,관외사전투표,,1247,1247,355,133,391,101,213,1193,54,0
2800,인천광역시,동구가선거구,6280201,2802,동구,만석동,계,5835,2984,745,431,925,398,327,2826,158,2851
2800,인천광역시,동구가선거구,6280201,2802,동구,만석동,관내사전투표,1128,1122,281,154,358,167,110,1070,52,6
2800,인천광역시,동구가선거구,6280201,2802,동구,만석동,선거일투표,4707,1862,464,277,567,231,217,1756,106,2845
2800,인천광역시,동구가선거구,6280201,2802,동구,화수1·화평동,계,5097,2687,592,320,834,431,310,2487,200,2410
2800,인천광역시,동구가선거구,6280201,2802,동구,화수1·화평동,관내사전투표,1215,1212,289,132,356,196,152,1125,87,3
2800,인천광역시,동구가선거구,6280201,2802,동구,화수1·화평동,선거일투표,3882,1475,303,188,478,235,158,1362,113,2407
2800,인천광역시,동구가선거구,6280201,2802,동구,화수2동,계,6305,3288,751,355,1136,387,436,3065,223,3017
2800,인천광역시,동구가선거구,6280201,2802,동구,화수2동,관내사전투표,1000,993,233,117,326,139,134,949,44,7
2800,인천광역시,동구가선거구,6280201,2802,동구,화수2동,선거일투표,5305,2295,518,238,810,248,302,2116,179,3010
2800,인천광역시,동구가선거구,6280201,2802,동구,송현1·2동,계,8673,4936,1171,433,1401,643,1035,4683,253,3737
2800,인천광역시,동구가선거구,6280201,2802,동구,송현1·2동,관내사전투표,2315,2313,589,216,611,293,493,2202,111,2
2800,인천광역시,동구가선거구,6280201,2802,동구,송현1·2동,선거일투표,6358,2623,582,217,790,350,542,2481,142,3735
2800,인천광역시,동구가선거구,6280201,2802,동구,잘못 투입·구분된 투표지,,0,21,7,3,3,4,3,20,1,-21
2800,인천광역시,동구나선거구,6280202,2802,동구,합계,,25546,13755,4157,1764,3538,2300,1066,12825,930,11791
2800,인천광역시,동구나선거구,6280202,2802,동구,거소투표,,22,18,4,4,2,4,1,15,3,4
2800,인천광역시,동구나선거구,6280202,2802,동구,관외사전투표,,1074,1074,344,167,298,141,56,1006,68,0
2800,인천광역시,동구나선거구,6280202,2802,동구,송현3동,계,3038,1585,380,140,324,216,408,1468,117,1453
2800,인천광역시,동구나선거구,6280202,2802,동구,송현3동,관내사전투표,620,618,157,55,130,91,153,586,32,2
2800,인천광역시,동구나선거구,6280202,2802,동구,송현3동,선거일투표,2418,967,223,85,194,125,255,882,85,1451
2800,인천광역시,동구나선거구,6280202,2802,동구,송림1동,계,1291,705,182,71,175,179,43,650,55,586
2800,인천광역시,동구나선거구,6280202,2802,동구,송림1동,관내사전투표,269,269,82,27,53,63,22,247,22,0
2800,인천광역시,동구나선거구,6280202,2802,동구,송림1동,선거일투표,1022,436,100,44,122,116,21,403,33,586
2800,인천광역시,동구나선거구,6280202,2802,동구,송림2동,계,2490,1393,358,158,353,289,122,1280,113,1097
2800,인천광역시,동구나선거구,6280202,2802,동구,송림2동,관내사전투표,689,686,196,77,168,141,60,642,44,3
2800,인천광역시,동구나선거구,6280202,2802,동구,송림2동,선거일투표,1801,707,162,81,185,148,62,638,69,1094
2800,인천광역시,동구나선거구,6280202,2802,동구,송림3·5동,계,5423,2808,800,506,720,515,108,2649,159,2615
2800,인천광역시,동구나선거구,6280202,2802,동구,송림3·5동,관내사전투표,1293,1292,406,248,317,212,51,1234,58,1
2800,인천광역시,동구나선거구,6280202,2802,동구,송림3·5동,선거일투표,4130,1516,394,258,403,303,57,1415,101,2614
2800,인천광역시,동구나선거구,6280202,2802,동구,송림4동,계,4824,2356,854,277,651,323,103,2208,148,2468
2800,인천광역시,동구나선거구,6280202,2802,동구,송림4동,관내사전투표,818,817,258,101,238,116,44,757,60,1
2800,인천광역시,동구나선거구,6280202,2802,동구,송림4동,선거일투표,4006,1539,596,176,413,207,59,1451,88,2467
2800,인천광역시,동구나선거구,6280202,2802,동구,송림6동,계,4982,2512,867,293,652,384,160,2356,156,2470
2800,인천광역시,동구나선거구,6280202,2802,동구,송림6동,관내사전투표,1167,1166,422,142,280,175,82,1101,65,1
2800,인천광역시,동구나선거구,6280202,2802,동구,송림6동,선거일투표,3815,1346,445,151,372,209,78,1255,91,2469
2800,인천광역시,동구나선거구,6280202,2802,동구,금창동,계,2402,1295,366,147,360,247,64,1184,111,1107
2800,인천광역시,동구나선거구,6280202,2802,동구,금창동,관내사전투표,670,670,204,76,178,145,28,631,39,0
2800,인천광역시,동구나선거구,6280202,2802,동구,금창동,선거일투표,1732,625,162,71,182,102,36,553,72,1107
2800,인천광역시,동구나선거구,6280202,2802,동구,잘못 투입·구분된 투표지,,0,9,2,1,3,2,1,9,0,-9
2800,인천광역시,미추홀구가선거구,6280301,2803,미추홀구,합계,,86346,38979,13030,4442,17459,2629,37560,1419,47367
2800,인천광역시,미추홀구가선거구,6280301,2803,미추홀구,거소투표,,117,106,30,14,47,2,93,13,11
2800,인천광역시,미추홀구가선거구,6280301,2803,미추홀구,관외사전투표,,4397,4396,1597,527,1903,262,4289,107,1
2800,인천광역시,미추홀구가선거구,6280301,2803,미추홀구,도화1동,계,19179,6868,2196,853,3258,296,6603,265,12311
2800,인천광역시,미추홀구가선거구,6280301,2803,미추홀구,도화1동,관내사전투표,2449,2446,758,300,1194,89,2341,105,3
2800,인천광역시,미추홀구가선거구,6280301,2803,미추홀구,도화1동,선거일투표,16730,4422,1438,553,2064,207,4262,160,12308
2800,인천광역시,미추홀구가선거구,6280301,2803,미추홀구,도화2·3동,계,26550,11958,3784,1431,4968,1321,11504,454,14592
2800,인천광역시,미추홀구가선거구,6280301,2803,미추홀구,도화2·3동,관내사전투표,4242,4228,1385,526,1715,454,4080,148,14
2800,인천광역시,미추홀구가선거구,6280301,2803,미추홀구,도화2·3동,선거일투표,22308,7730,2399,905,3253,867,7424,306,14578
2800,인천광역시,미추홀구가선거구,6280301,2803,미추홀구,주안5동,계,18108,7908,2864,861,3569,336,7630,278,10200
2800,인천광역시,미추홀구가선거구,6280301,2803,미추홀구,주안5동,관내사전투표,2698,2694,1014,347,1163,107,2631,63,4
2800,인천광역시,미추홀구가선거구,6280301,2803,미추홀구,주안5동,선거일투표,15410,5214,1850,514,2406,229,4999,215,10196
2800,인천광역시,미추홀구가선거구,6280301,2803,미추홀구,주안6동,계,17995,7708,2548,751,3701,408,7408,300,10287
2800,인천광역시,미추홀구가선거구,6280301,2803,미추홀구,주안6동,관내사전투표,2811,2807,967,276,1362,142,2747,60,4
2800,인천광역시,미추홀구가선거구,6280301,2803,미추홀구,주안6동,선거일투표,15184,4901,1581,475,2339,266,4661,240,10283
2800,인천광역시,미추홀구가선거구,6280301,2803,미추홀구,잘못 투입·구분된 투표지,,0,35,11,5,13,4,33,2,-35
2800,인천광역시,미추홀구나선거구,6280302,2803,미추홀구,합계,,83961,35919,10538,5796,11958,4551,32843,3076,48042
2800,인천광역시,미추홀구나선거구,6280302,2803,미추홀구,거소투표,,101,94,22,15,34,12,83,11,7
2800,인천광역시,미추홀구나선거구,6280302,2803,미추홀구,관외사전투표,,3964,3964,1296,688,1284,403,3671,293,0
2800,인천광역시,미추홀구나선거구,6280302,2803,미추홀구,주안1동,계,18219,5205,1713,826,1663,624,4826,379,13014
2800,인천광역시,미추홀구나선거구,6280302,2803,미추홀구,주안1동,관내사전투표,1647,1646,563,234,508,192,1497,149,1
2800,인천광역시,미추홀구나선거구,6280302,2803,미추홀구,주안1동,선거일투표,16572,3559,1150,592,1155,432,3329,230,13013
2800,인천광역시,미추홀구나선거구,6280302,2803,미추홀구,주안2동,계,14163,5574,1564,786,1955,742,5047,527,8589
2800,인천광역시,미추홀구나선거구,6280302,2803,미추홀구,주안2동,관내사전투표,2042,1992,579,291,648,289,1807,185,50
2800,인천광역시,미추홀구나선거구,6280302,2803,미추홀구,주안2동,선거일투표,12121,3582,985,495,1307,453,3240,342,8539
2800,인천광역시,미추홀구나선거구,6280302,2803,미추홀구,주안3동,계,7305,2997,885,529,969,371,2754,243,4308
2800,인천광역시,미추홀구나선거구,6280302,2803,미추홀구,주안3동,관내사전투표,796,789,229,147,250,71,697,92,7
2800,인천광역시,미추홀구나선거구,6280302,2803,미추홀구,주안3동,선거일투표,6509,2208,656,382,719,300,2057,151,4301
2800,인천광역시,미추홀구나선거구,6280302,2803,미추홀구,주안4동,계,11371,4750,1203,667,1717,697,4284,466,6621
2800,인천광역시,미추홀구나선거구,6280302,2803,미추홀구,주안4동,관내사전투표,1785,1776,430,238,624,270,1562,214,9
2800,인천광역시,미추홀구나선거구,6280302,2803,미추홀구,주안4동,선거일투표,9586,2974,773,429,1093,427,2722,252,6612
2800,인천광역시,미추홀구나선거구,6280302,2803,미추홀구,주안7동,계,11714,5723,1596,1000,1852,787,5235,488,5991
2800,인천광역시,미추홀구나선거구,6280302,2803,미추홀구,주안7동,관내사전투표,2886,2886,803,501,937,382,2623,263,0
2800,인천광역시,미추홀구나선거구,6280302,2803,미추홀구,주안7동,선거일투표,8828,2837,793,499,915,405,2612,225,5991
2800,인천광역시,미추홀구나선거구,6280302,2803,미추홀구,주안8동,계,17124,7529,2233,1270,2461,905,6869,660,9595
2800,인천광역시,미추홀구나선거구,6280302,2803,미추홀구,주안8동,관내사전투표,2005,1999,637,329,637,227,1830,169,6
2800,인천광역시,미추홀구나선거구,6280302,2803,미추홀구,주안8동,선거일투표,15119,5530,1596,941,1824,678,5039,491,9589
2800,인천광역시,미추홀구나선거구,6280302,2803,미추홀구,잘못 투입·구분된 투표지,,0,83,26,15,23,10,74,9,-83
2800,인천광역시,미추홀구다선거구,6280303,2803,미추홀구,합계,,95341,41749,13748,4263,11790,7690,37491,4258,53592
2800,인천광역시,미추홀구다선거구,6280303,2803,미추홀구,거소투표,,119,113,36,6,35,19,96,17,6
2800,인천광역시,미추홀구다선거구,6280303,2803,미추홀구,관외사전투표,,4560,4560,1634,516,1326,685,4161,399,0
2800,인천광역시,미추홀구다선거구,6280303,2803,미추홀구,숭의1·3동,계,12156,4308,1524,491,1207,754,3976,332,7848
2800,인천광역시,미추홀구다선거구,6280303,2803,미추홀구,숭의1·3동,관내사전투표,1502,1493,527,160,430,254,1371,122,9
2800,인천광역시,미추홀구다선거구,6280303,2803,미추홀구,숭의1·3동,선거일투표,10654,2815,997,331,777,500,2605,210,7839
2800,인천광역시,미추홀구다선거구,6280303,2803,미추홀구,숭의2동,계,12697,4625,1610,457,1251,866,4184,441,8072
2800,인천광역시,미추홀구다선거구,6280303,2803,미추홀구,숭의2동,관내사전투표,2022,2014,682,211,539,406,1838,176,8
2800,인천광역시,미추홀구다선거구,6280303,2803,미추홀구,숭의2동,선거일투표,10675,2611,928,246,712,460,2346,265,8064
2800,인천광역시,미추홀구다선거구,6280303,2803,미추홀구,숭의4동,계,13372,5171,1667,546,1407,981,4601,570,8201
2800,인천광역시,미추홀구다선거구,6280303,2803,미추홀구,숭의4동,관내사전투표,2154,2145,688,223,609,385,1905,240,9
2800,인천광역시,미추홀구다선거구,6280303,2803,미추홀구,숭의4동,선거일투표,11218,3026,979,323,798,596,2696,330,8192
2800,인천광역시,미추홀구다선거구,6280303,2803,미추홀구,용현1·4동,계,15331,6045,1724,597,1645,1401,5367,678,9286
2800,인천광역시,미추홀구다선거구,6280303,2803,미추홀구,용현1·4동,관내사전투표,1869,1813,523,190,463,438,1614,199,56
2800,인천광역시,미추홀구다선거구,6280303,2803,미추홀구,용현1·4동,선거일투표,13462,4232,1201,407,1182,963,3753,479,9230
2800,인천광역시,미추홀구다선거구,6280303,2803,미추홀구,용현2동,계,14933,6720,2307,675,1825,1192,5999,721,8213
2800,인천광역시,미추홀구다선거구,6280303,2803,미추홀구,용현2동,관내사전투표,2424,2421,794,222,658,466,2140,281,3
2800,인천광역시,미추홀구다선거구,6280303,2803,미추홀구,용현2동,선거일투표,12509,4299,1513,453,1167,726,3859,440,8210
2800,인천광역시,미추홀구다선거구,6280303,2803,미추홀구,용현3동,계,7061,3069,831,318,932,657,2738,331,3992
2800,인천광역시,미추홀구다선거구,6280303,2803,미추홀구,용현3동,관내사전투표,1491,1489,402,152,456,319,1329,160,2
2800,인천광역시,미추홀구다선거구,6280303,2803,미추홀구,용현3동,선거일투표,5570,1580,429,166,476,338,1409,171,3990
2800,인천광역시,미추홀구다선거구,6280303,2803,미추홀구,학익2동,계,15112,7022,2379,647,2130,1112,6268,754,8090
2800,인천광역시,미추홀구다선거구,6280303,2803,미추홀구,학익2동,관내사전투표,2183,2177,713,207,685,329,1934,243,6
2800,인천광역시,미추홀구다선거구,6280303,2803,미추홀구,학익2동,선거일투표,12929,4845,1666,440,1445,783,4334,511,8084
2800,인천광역시,미추홀구다선거구,6280303,2803,미추홀구,잘못 투입·구분된 투표지,,0,116,36,10,32,23,101,15,-116
2800,인천광역시,미추홀구라선거구,6280304,2803,미추홀구,합계,,92964,43627,12412,4603,10320,5959,4479,2636,142,218,40769,2858,49337
2800,인천광역시,미추홀구라선거구,6280304,2803,미추홀구,거소투표,,119,108,19,10,22,23,9,9,2,0,94,14,11
2800,인천광역시,미추홀구라선거구,6280304,2803,미추홀구,관외사전투표,,4608,4606,1469,491,1126,587,273,278,28,28,4280,326,2
2800,인천광역시,미추홀구라선거구,6280304,2803,미추홀구,용현5동,계,37724,16091,4346,1916,3882,2470,1400,968,54,88,15124,967,21633
2800,인천광역시,미추홀구라선거구,6280304,2803,미추홀구,용현5동,관내사전투표,5607,5604,1487,701,1404,804,482,313,20,21,5232,372,3
2800,인천광역시,미추홀구라선거구,6280304,2803,미추홀구,용현5동,선거일투표,32117,10487,2859,1215,2478,1666,918,655,34,67,9892,595,21630
2800,인천광역시,미추홀구라선거구,6280304,2803,미추홀구,학익1동,계,25587,12183,3414,1269,2655,1701,1373,897,30,63,11402,781,13404
2800,인천광역시,미추홀구라선거구,6280304,2803,미추홀구,학익1동,관내사전투표,3748,3747,1027,427,803,513,477,237,4,27,3515,232,1
2800,인천광역시,미추홀구라선거구,6280304,2803,미추홀구,학익1동,선거일투표,21839,8436,2387,842,1852,1188,896,660,26,36,7887,549,13403
2800,인천광역시,미추홀구라선거구,6280304,2803,미추홀구,관교동,계,12433,6560,1861,558,1697,714,936,275,16,21,6078,482,5873
2800,인천광역시,미추홀구라선거구,6280304,2803,미추홀구,관교동,관내사전투표,2438,2437,693,238,613,246,343,104,4,5,2246,191,1
2800,인천광역시,미추홀구라선거구,6280304,2803,미추홀구,관교동,선거일투표,9995,4123,1168,320,1084,468,593,171,12,16,3832,291,5872
2800,인천광역시,미추홀구라선거구,6280304,2803,미추홀구,문학동,계,12493,4078,1303,359,938,463,488,209,12,18,3790,288,8415
2800,인천광역시,미추홀구라선거구,6280304,2803,미추홀구,문학동,관내사전투표,1735,1735,551,172,397,182,193,83,3,8,1589,146,0
2800,인천광역시,미추홀구라선거구,6280304,2803,미추홀구,문학동,선거일투표,10758,2343,752,187,541,281,295,126,9,10,2201,142,8415
2800,인천광역시,미추홀구라선거구,6280304,2803,미추홀구,잘못 투입·구분된 투표지,,0,1,0,0,0,1,0,0,0,0,1,0,-1
2800,인천광역시,연수구가선거구,6280401,2804,연수구,합계,,56910,26555,10728,10988,3876,25592,963,30355
2800,인천광역시,연수구가선거구,6280401,2804,연수구,거소투표,,66,60,26,17,11,54,6,6
2800,인천광역시,연수구가선거구,6280401,2804,연수구,관외사전투표,,2696,2691,1268,1041,304,2613,78,5
2800,인천광역시,연수구가선거구,6280401,2804,연수구,옥련2동,계,16423,7771,3127,3126,1265,7518,253,8652
2800,인천광역시,연수구가선거구,6280401,2804,연수구,옥련2동,관내사전투표,3012,3008,1247,1228,475,2950,58,4
2800,인천광역시,연수구가선거구,6280401,2804,연수구,옥련2동,선거일투표,13411,4763,1880,1898,790,4568,195,8648
2800,인천광역시,연수구가선거구,6280401,2804,연수구,연수1동,계,16543,6694,2691,2829,930,6450,244,9849
2800,인천광역시,연수구가선거구,6280401,2804,연수구,연수1동,관내사전투표,2489,2474,1054,1000,342,2396,78,15
2800,인천광역시,연수구가선거구,6280401,2804,연수구,연수1동,선거일투표,14054,4220,1637,1829,588,4054,166,9834
2800,인천광역시,연수구가선거구,6280401,2804,연수구,청학동,계,21182,9303,3604,3955,1363,8922,381,11879
2800,인천광역시,연수구가선거구,6280401,2804,연수구,청학동,관내사전투표,2986,2978,1184,1248,450,2882,96,8
2800,인천광역시,연수구가선거구,6280401,2804,연수구,청학동,선거일투표,18196,6325,2420,2707,913,6040,285,11871
2800,인천광역시,연수구가선거구,6280401,2804,연수구,잘못 투입·구분된 투표지,,0,36,12,20,3,35,1,-36
2800,인천광역시,연수구나선거구,6280402,2804,연수구,합계,,63113,33179,9506,5596,9871,5387,30360,2819,29934
2800,인천광역시,연수구나선거구,6280402,2804,연수구,거소투표,,119,112,25,18,36,17,96,16,7
2800,인천광역시,연수구나선거구,6280402,2804,연수구,관외사전투표,,3137,3131,978,567,981,337,2863,268,6
2800,인천광역시,연수구나선거구,6280402,2804,연수구,선학동,계,14798,6726,1799,1021,2078,1166,6064,662,8072
2800,인천광역시,연수구나선거구,6280402,2804,연수구,선학동,관내사전투표,2435,2434,637,392,730,423,2182,252,1
2800,인천광역시,연수구나선거구,6280402,2804,연수구,선학동,선거일투표,12363,4292,1162,629,1348,743,3882,410,8071
2800,인천광역시,연수구나선거구,6280402,2804,연수구,연수2동,계,17711,8773,2478,1413,2506,1673,8070,703,8938
2800,인천광역시,연수구나선거구,6280402,2804,연수구,연수2동,관내사전투표,2759,2753,772,455,751,542,2520,233,6
2800,인천광역시,연수구나선거구,6280402,2804,연수구,연수2동,선거일투표,14952,6020,1706,958,1755,1131,5550,470,8932
2800,인천광역시,연수구나선거구,6280402,2804,연수구,연수3동,계,13544,6740,2046,1108,1980,1086,6220,520,6804
2800,인천광역시,연수구나선거구,6280402,2804,연수구,연수3동,관내사전투표,2397,2391,742,380,701,384,2207,184,6
2800,인천광역시,연수구나선거구,6280402,2804,연수구,연수3동,선거일투표,11147,4349,1304,728,1279,702,4013,336,6798
2800,인천광역시,연수구나선거구,6280402,2804,연수구,동춘3동,계,13804,7659,2165,1465,2282,1100,7012,647,6145
2800,인천광역시,연수구나선거구,6280402,2804,연수구,동춘3동,관내사전투표,2935,2927,871,560,809,427,2667,260,8
2800,인천광역시,연수구나선거구,6280402,2804,연수구,동춘3동,선거일투표,10869,4732,1294,905,1473,673,4345,387,6137
2800,인천광역시,연수구나선거구,6280402,2804,연수구,잘못 투입·구분된 투표지,,0,38,15,4,8,8,35,3,-38
2800,인천광역시,연수구다선거구,6280403,2804,연수구,검색된 결과가 없습니다.
2800,인천광역시,연수구라선거구,6280404,2804,연수구,검색된 결과가 없습니다.
2800,인천광역시,연수구마선거구,6280405,2804,연수구,합계,,76308,40105,9901,4792,13519,5599,3621,497,37929,2176,36203
2800,인천광역시,연수구마선거구,6280405,2804,연수구,거소투표,,75,70,11,13,28,9,3,0,64,6,5
2800,인천광역시,연수구마선거구,6280405,2804,연수구,관외사전투표,,4287,4287,1126,570,1426,547,293,59,4021,266,0
2800,인천광역시,연수구마선거구,6280405,2804,연수구,송도2동,계,25312,12886,3331,1322,4715,1908,789,118,12183,703,12426
2800,인천광역시,연수구마선거구,6280405,2804,연수구,송도2동,관내사전투표,3984,3982,1056,455,1419,540,242,33,3745,237,2
2800,인천광역시,연수구마선거구,6280405,2804,연수구,송도2동,선거일투표,21328,8904,2275,867,3296,1368,547,85,8438,466,12424
2800,인천광역시,연수구마선거구,6280405,2804,연수구,송도4동,계,18071,9121,2224,1140,3077,1350,693,156,8640,481,8950
2800,인천광역시,연수구마선거구,6280405,2804,연수구,송도4동,관내사전투표,2716,2716,726,331,893,373,193,35,2551,165,0
2800,인천광역시,연수구마선거구,6280405,2804,연수구,송도4동,선거일투표,15355,6405,1498,809,2184,977,500,121,6089,316,8950
2800,인천광역시,연수구마선거구,6280405,2804,연수구,송도5동,계,28563,13734,3208,1746,4271,1783,1843,164,13015,719,14829
2800,인천광역시,연수구마선거구,6280405,2804,연수구,송도5동,관내사전투표,3702,3700,906,497,1129,422,520,40,3514,186,2
2800,인천광역시,연수구마선거구,6280405,2804,연수구,송도5동,선거일투표,24861,10034,2302,1249,3142,1361,1323,124,9501,533,14827
2800,인천광역시,연수구마선거구,6280405,2804,연수구,잘못 투입·구분된 투표지,,0,7,1,1,2,2,0,0,6,1,-7
2800,인천광역시,남동구가선거구,6280501,2805,남동구,검색된 결과가 없습니다.
2800,인천광역시,남동구나선거구,6280502,2805,남동구,합계,,71568,30682,9790,4493,9618,3731,27632,3050,40886
2800,인천광역시,남동구나선거구,6280502,2805,남동구,거소투표,,67,59,17,13,14,7,51,8,8
2800,인천광역시,남동구나선거구,6280502,2805,남동구,관외사전투표,,4736,4734,1696,775,1480,383,4334,400,2
2800,인천광역시,남동구나선거구,6280502,2805,남동구,구월3동,계,25870,8369,2650,1229,2527,1198,7604,765,17501
2800,인천광역시,남동구나선거구,6280502,2805,남동구,구월3동,관내사전투표,2344,2343,767,375,600,401,2143,200,1
2800,인천광역시,남동구나선거구,6280502,2805,남동구,구월3동,선거일투표,23526,6026,1883,854,1927,797,5461,565,17500
2800,인천광역시,남동구나선거구,6280502,2805,남동구,간석1동,계,16815,7549,2286,1035,2390,1053,6764,785,9266
2800,인천광역시,남동구나선거구,6280502,2805,남동구,간석1동,관내사전투표,2164,2155,698,306,602,325,1931,224,9
2800,인천광역시,남동구나선거구,6280502,2805,남동구,간석1동,선거일투표,14651,5394,1588,729,1788,728,4833,561,9257
2800,인천광역시,남동구나선거구,6280502,2805,남동구,간석4동,계,24080,9944,3132,1441,3200,1086,8859,1085,14136
2800,인천광역시,남동구나선거구,6280502,2805,남동구,간석4동,관내사전투표,2743,2730,838,435,858,329,2460,270,13
2800,인천광역시,남동구나선거구,6280502,2805,남동구,간석4동,선거일투표,21337,7214,2294,1006,2342,757,6399,815,14123
2800,인천광역시,남동구나선거구,6280502,2805,남동구,잘못 투입·구분된 투표지,,0,27,9,0,7,4,20,7,-27
2800,인천광역시,남동구다선거구,6280503,2805,남동구,합계,,87410,42763,13589,5963,12238,5264,3254,40308,2455,44647
2800,인천광역시,남동구다선거구,6280503,2805,남동구,거소투표,,112,102,39,10,31,8,4,92,10,10
2800,인천광역시,남동구다선거구,6280503,2805,남동구,관외사전투표,,3813,3808,1351,514,1126,406,175,3572,236,5
2800,인천광역시,남동구다선거구,6280503,2805,남동구,논현1동,계,25232,11579,3649,1756,3208,1410,928,10951,628,13653
2800,인천광역시,남동구다선거구,6280503,2805,남동구,논현1동,관내사전투표,3864,3861,1239,597,1053,478,304,3671,190,3
2800,인천광역시,남동구다선거구,6280503,2805,남동구,논현1동,선거일투표,21368,7718,2410,1159,2155,932,624,7280,438,13650
2800,인천광역시,남동구다선거구,6280503,2805,남동구,논현2동,계,27075,12109,3893,1409,3346,1644,1076,11368,741,14966
2800,인천광역시,남동구다선거구,6280503,2805,남동구,논현2동,관내사전투표,3539,3537,1185,409,937,478,289,3298,239,2
2800,인천광역시,남동구다선거구,6280503,2805,남동구,논현2동,선거일투표,23536,8572,2708,1000,2409,1166,787,8070,502,14964
2800,인천광역시,남동구다선거구,6280503,2805,남동구,논현고잔동,계,31178,15123,4648,2272,4509,1789,1066,14284,839,16055
2800,인천광역시,남동구다선거구,6280503,2805,남동구,논현고잔동,관내사전투표,5256,5244,1671,819,1535,570,364,4959,285,12
2800,인천광역시,남동구다선거구,6280503,2805,남동구,논현고잔동,선거일투표,25922,9879,2977,1453,2974,1219,702,9325,554,16043
2800,인천광역시,남동구다선거구,6280503,2805,남동구,잘못 투입·구분된 투표지,,0,42,9,2,18,7,5,41,1,-42
2800,인천광역시,남동구라선거구,6280504,2805,남동구,합계,,72131,35875,10227,4829,12795,3281,2440,33572,2303,36256
2800,인천광역시,남동구라선거구,6280504,2805,남동구,거소투표,,107,99,30,11,37,7,5,90,9,8
2800,인천광역시,남동구라선거구,6280504,2805,남동구,관외사전투표,,4541,4539,1425,610,1604,317,312,4268,271,2
2800,인천광역시,남동구라선거구,6280504,2805,남동구,구월2동,계,27127,14205,3626,2227,4930,1569,1034,13386,819,12922
2800,인천광역시,남동구라선거구,6280504,2805,남동구,구월2동,관내사전투표,4976,4970,1363,875,1600,574,336,4748,222,6
2800,인천광역시,남동구라선거구,6280504,2805,남동구,구월2동,선거일투표,22151,9235,2263,1352,3330,995,698,8638,597,12916
2800,인천광역시,남동구라선거구,6280504,2805,남동구,간석2동,계,17159,7779,2055,893,3076,678,523,7225,554,9380
2800,인천광역시,남동구라선거구,6280504,2805,남동구,간석2동,관내사전투표,1787,1777,463,209,730,157,82,1641,136,10
2800,인천광역시,남동구라선거구,6280504,2805,남동구,간석2동,선거일투표,15372,6002,1592,684,2346,521,441,5584,418,9370
2800,인천광역시,남동구라선거구,6280504,2805,남동구,간석3동,계,23197,9210,3079,1076,3137,709,565,8566,644,13987
2800,인천광역시,남동구라선거구,6280504,2805,남동구,간석3동,관내사전투표,2735,2727,933,340,928,183,153,2537,190,8
2800,인천광역시,남동구라선거구,6280504,2805,남동구,간석3동,선거일투표,20462,6483,2146,736,2209,526,412,6029,454,13979
2800,인천광역시,남동구라선거구,6280504,2805,남동구,잘못 투입·구분된 투표지,,0,43,12,12,11,1,1,37,6,-43
2800,인천광역시,남동구마선거구,6280505,2805,남동구,합계,,83849,42341,12179,5196,11886,6630,3702,95,39688,2653,41508
2800,인천광역시,남동구마선거구,6280505,2805,남동구,거소투표,,131,119,42,21,30,10,1,1,105,14,12
2800,인천광역시,남동구마선거구,6280505,2805,남동구,관외사전투표,,3483,3482,1130,435,983,449,270,15,3282,200,1
2800,인천광역시,남동구마선거구,6280505,2805,남동구,만수1동,계,14896,6599,1884,772,2022,946,436,27,6087,512,8297
2800,인천광역시,남동구마선거구,6280505,2805,남동구,만수1동,관내사전투표,2180,2180,650,283,600,305,153,8,1999,181,0
2800,인천광역시,남동구마선거구,6280505,2805,남동구,만수1동,선거일투표,12716,4419,1234,489,1422,641,283,19,4088,331,8297
2800,인천광역시,남동구마선거구,6280505,2805,남동구,만수6동,계,20403,9962,2741,1240,2707,1701,905,17,9311,651,10441
2800,인천광역시,남동구마선거구,6280505,2805,남동구,만수6동,관내사전투표,3066,3066,881,416,764,524,279,2,2866,200,0
2800,인천광역시,남동구마선거구,6280505,2805,남동구,만수6동,선거일투표,17337,6896,1860,824,1943,1177,626,15,6445,451,10441
2800,인천광역시,남동구마선거구,6280505,2805,남동구,장수서창동,계,15812,7740,2131,867,2378,1255,594,13,7238,502,8072
2800,인천광역시,남동구마선거구,6280505,2805,남동구,장수서창동,관내사전투표,2782,2782,812,330,823,423,211,1,2600,182,0
2800,인천광역시,남동구마선거구,6280505,2805,남동구,장수서창동,선거일투표,13030,4958,1319,537,1555,832,383,12,4638,320,8072
2800,인천광역시,남동구마선거구,6280505,2805,남동구,서창2동,계,29124,14437,4251,1861,3766,2269,1496,22,13665,772,14687
2800,인천광역시,남동구마선거구,6280505,2805,남동구,서창2동,관내사전투표,4549,4548,1357,675,1089,689,480,6,4296,252,1
2800,인천광역시,남동구마선거구,6280505,2805,남동구,서창2동,선거일투표,24575,9889,2894,1186,2677,1580,1016,16,9369,520,14686
2800,인천광역시,남동구마선거구,6280505,2805,남동구,잘못 투입·구분된 투표지,,0,2,0,0,0,0,0,0,0,2,-2
2800,인천광역시,남동구바선거구,6280506,2805,남동구,검색된 결과가 없습니다.
2800,인천광역시,부평구가선거구,6280601,2806,부평구,검색된 결과가 없습니다.
2800,인천광역시,부평구나선거구,6280602,2806,부평구,합계,,80774,33560,12171,4074,7986,5967,30198,3362,47214
2800,인천광역시,부평구나선거구,6280602,2806,부평구,거소투표,,87,79,23,5,22,22,72,7,8
2800,인천광역시,부평구나선거구,6280602,2806,부평구,관외사전투표,,3420,3414,1447,387,747,562,3143,271,6
2800,인천광역시,부평구나선거구,6280602,2806,부평구,부평2동,계,13003,5228,1777,554,1117,1223,4671,557,7775
2800,인천광역시,부평구나선거구,6280602,2806,부평구,부평2동,관내사전투표,1943,1942,666,200,414,464,1744,198,1
2800,인천광역시,부평구나선거구,6280602,2806,부평구,부평2동,선거일투표,11060,3286,1111,354,703,759,2927,359,7774
2800,인천광역시,부평구나선거구,6280602,2806,부평구,부평5동,계,26849,8029,3295,939,2016,1000,7250,779,18820
2800,인천광역시,부평구나선거구,6280602,2806,부평구,부평5동,관내사전투표,2188,2172,930,277,528,240,1975,197,16
2800,인천광역시,부평구나선거구,6280602,2806,부평구,부평5동,선거일투표,24661,5857,2365,662,1488,760,5275,582,18804
2800,인천광역시,부평구나선거구,6280602,2806,부평구,부평6동,계,13104,5565,1884,753,1251,1116,5004,561,7539
2800,인천광역시,부평구나선거구,6280602,2806,부평구,부평6동,관내사전투표,2216,2213,733,332,500,423,1988,225,3
2800,인천광역시,부평구나선거구,6280602,2806,부평구,부평6동,선거일투표,10888,3352,1151,421,751,693,3016,336,7536
2800,인천광역시,부평구나선거구,6280602,2806,부평구,부개1동,계,13904,6073,1985,803,1553,1092,5433,640,7831
2800,인천광역시,부평구나선거구,6280602,2806,부평구,부개1동,관내사전투표,2340,2339,779,321,566,430,2096,243,1
2800,인천광역시,부평구나선거구,6280602,2806,부평구,부개1동,선거일투표,11564,3734,1206,482,987,662,3337,397,7830
2800,인천광역시,부평구나선거구,6280602,2806,부평구,일신동,계,10407,5131,1750,622,1275,942,4589,542,5276
2800,인천광역시,부평구나선거구,6280602,2806,부평구,일신동,관내사전투표,2010,2006,676,277,475,362,1790,216,4
2800,인천광역시,부평구나선거구,6280602,2806,부평구,일신동,선거일투표,8397,3125,1074,345,800,580,2799,326,5272
2800,인천광역시,부평구나선거구,6280602,2806,부평구,잘못 투입·구분된 투표지,,0,41,10,11,5,10,36,5,-41
2800,인천광역시,부평구다선거구,6280603,2806,부평구,합계,,79545,39300,12336,5503,13203,4522,35564,3736,40245
2800,인천광역시,부평구다선거구,6280603,2806,부평구,거소투표,,116,109,23,20,24,11,78,31,7
2800,인천광역시,부평구다선거구,6280603,2806,부평구,관외사전투표,,3548,3546,1231,555,1055,394,3235,311,2
2800,인천광역시,부평구다선거구,6280603,2806,부평구,부평3동,계,11286,4781,1580,679,1527,540,4326,455,6505
2800,인천광역시,부평구다선거구,6280603,2806,부평구,부평3동,관내사전투표,1996,1994,645,295,648,219,1807,187,2
2800,인천광역시,부평구다선거구,6280603,2806,부평구,부평3동,선거일투표,9290,2787,935,384,879,321,2519,268,6503
2800,인천광역시,부평구다선거구,6280603,2806,부평구,산곡3동,계,18524,9812,2905,1198,3503,1308,8914,898,8712
2800,인천광역시,부평구다선거구,6280603,2806,부평구,산곡3동,관내사전투표,3772,3764,1225,460,1314,427,3426,338,8
2800,인천광역시,부평구다선거구,6280603,2806,부평구,산곡3동,선거일투표,14752,6048,1680,738,2189,881,5488,560,8704
2800,인천광역시,부평구다선거구,6280603,2806,부평구,산곡4동,계,14329,7397,2383,985,2501,846,6715,682,6932
2800,인천광역시,부평구다선거구,6280603,2806,부평구,산곡4동,관내사전투표,2234,2233,775,309,728,197,2009,224,1
2800,인천광역시,부평구다선거구,6280603,2806,부평구,산곡4동,선거일투표,12095,5164,1608,676,1773,649,4706,458,6931
2800,인천광역시,부평구다선거구,6280603,2806,부평구,십정1동,계,12459,5890,1858,916,1884,631,5289,601,6569
2800,인천광역시,부평구다선거구,6280603,2806,부평구,십정1동,관내사전투표,2302,2298,708,376,721,252,2057,241,4
2800,인천광역시,부평구다선거구,6280603,2806,부평구,십정1동,선거일투표,10157,3592,1150,540,1163,379,3232,360,6565
2800,인천광역시,부평구다선거구,6280603,2806,부평구,십정2동,계,19283,7713,2340,1141,2693,788,6962,751,11570
2800,인천광역시,부평구다선거구,6280603,2806,부평구,십정2동,관내사전투표,2245,2219,687,338,753,203,1981,238,26
2800,인천광역시,부평구다선거구,6280603,2806,부평구,십정2동,선거일투표,17038,5494,1653,803,1940,585,4981,513,11544
2800,인천광역시,부평구다선거구,6280603,2806,부평구,잘못 투입·구분된 투표지,,0,52,16,9,16,4,45,7,-52
2800,인천광역시,부평구라선거구,6280604,2806,부평구,합계,,73120,36437,11658,4362,11386,3285,3331,34022,2415,36683
2800,인천광역시,부평구라선거구,6280604,2806,부평구,거소투표,,79,75,21,8,24,7,4,64,11,4
2800,인천광역시,부평구라선거구,6280604,2806,부평구,관외사전투표,,5284,5280,1957,657,1495,453,432,4994,286,4
2800,인천광역시,부평구라선거구,6280604,2806,부평구,산곡1동,계,10286,5012,1461,543,1520,533,541,4598,414,5274
2800,인천광역시,부평구라선거구,6280604,2806,부평구,산곡1동,관내사전투표,1770,1765,525,191,504,185,212,1617,148,5
2800,인천광역시,부평구라선거구,6280604,2806,부평구,산곡1동,선거일투표,8516,3247,936,352,1016,348,329,2981,266,5269
2800,인천광역시,부평구라선거구,6280604,2806,부평구,산곡2동,계,23413,11796,3707,1328,3584,1163,1321,11103,693,11617
2800,인천광역시,부평구라선거구,6280604,2806,부평구,산곡2동,관내사전투표,3375,3374,1077,396,1018,304,411,3206,168,1
2800,인천광역시,부평구라선거구,6280604,2806,부평구,산곡2동,선거일투표,20038,8422,2630,932,2566,859,910,7897,525,11616
2800,인천광역시,부평구라선거구,6280604,2806,부평구,청천1동,계,6246,2490,778,293,862,198,159,2290,200,3756
2800,인천광역시,부평구라선거구,6280604,2806,부평구,청천1동,관내사전투표,1218,1209,405,133,400,90,86,1114,95,9
2800,인천광역시,부평구라선거구,6280604,2806,부평구,청천1동,선거일투표,5028,1281,373,160,462,108,73,1176,105,3747
2800,인천광역시,부평구라선거구,6280604,2806,부평구,청천2동,계,27812,11761,3727,1531,3896,927,871,10952,809,16051
2800,인천광역시,부평구라선거구,6280604,2806,부평구,청천2동,관내사전투표,2897,2894,855,398,974,234,216,2677,217,3
2800,인천광역시,부평구라선거구,6280604,2806,부평구,청천2동,선거일투표,24915,8867,2872,1133,2922,693,655,8275,592,16048
2800,인천광역시,부평구라선거구,6280604,2806,부평구,잘못 투입·구분된 투표지,,0,23,7,2,5,4,3,21,2,-23
2800,인천광역시,부평구마선거구,6280605,2806,부평구,검색된 결과가 없습니다.
2800,인천광역시,부평구바선거구,6280606,2806,부평구,합계,,67119,35965,10369,5139,10246,3645,4192,33591,2374,31154
2800,인천광역시,부평구바선거구,6280606,2806,부평구,거소투표,,75,67,20,7,24,9,3,63,4,8
2800,인천광역시,부평구바선거구,6280606,2806,부평구,관외사전투표,,3328,3328,981,525,942,306,358,3112,216,0
2800,인천광역시,부평구바선거구,6280606,2806,부평구,삼산2동,계,21970,11615,3189,1684,3470,912,1657,10912,703,10355
2800,인천광역시,부평구바선거구,6280606,2806,부평구,삼산2동,관내사전투표,3843,3838,1099,613,1081,267,531,3591,247,5
2800,인천광역시,부평구바선거구,6280606,2806,부평구,삼산2동,선거일투표,18127,7777,2090,1071,2389,645,1126,7321,456,10350
2800,인천광역시,부평구바선거구,6280606,2806,부평구,부개2동,계,16392,7996,2477,1029,2347,828,754,7435,561,8396
2800,인천광역시,부평구바선거구,6280606,2806,부평구,부개2동,관내사전투표,2732,2730,899,352,785,264,245,2545,185,2
2800,인천광역시,부평구바선거구,6280606,2806,부평구,부개2동,선거일투표,13660,5266,1578,677,1562,564,509,4890,376,8394
2800,인천광역시,부평구바선거구,6280606,2806,부평구,부개3동,계,25354,12943,3696,1894,3458,1589,1416,12053,890,12411
2800,인천광역시,부평구바선거구,6280606,2806,부평구,부개3동,관내사전투표,4094,4088,1218,630,1004,536,436,3824,264,6
2800,인천광역시,부평구바선거구,6280606,2806,부평구,부개3동,선거일투표,21260,8855,2478,1264,2454,1053,980,8229,626,12405
2800,인천광역시,부평구바선거구,6280606,2806,부평구,잘못 투입·구분된 투표지,,0,16,6,0,5,1,4,16,0,-16
2800,인천광역시,계양구가선거구,6280701,2807,계양구,검색된 결과가 없습니다.
2800,인천광역시,계양구나선거구,6280702,2807,계양구,검색된 결과가 없습니다.
2800,인천광역시,계양구다선거구,6280703,2807,계양구,검색된 결과가 없습니다.
2800,인천광역시,계양구라선거구,6280704,2807,계양구,합계,,88034,53978,18945,7108,13969,6749,4294,51065,2913,34056
2800,인천광역시,계양구라선거구,6280704,2807,계양구,거소투표,,121,116,29,22,37,9,5,102,14,5
2800,인천광역시,계양구라선거구,6280704,2807,계양구,관외사전투표,,5050,5050,1818,720,1455,410,349,4752,298,0
2800,인천광역시,계양구라선거구,6280704,2807,계양구,계산4동,계,18593,11849,4122,1514,3072,1640,916,11264,585,6744
2800,인천광역시,계양구라선거구,6280704,2807,계양구,계산4동,관내사전투표,4044,4030,1521,517,1000,515,284,3837,193,14
2800,인천광역시,계양구라선거구,6280704,2807,계양구,계산4동,선거일투표,14549,7819,2601,997,2072,1125,632,7427,392,6730
2800,인천광역시,계양구라선거구,6280704,2807,계양구,계양1동,계,15703,9000,2936,1128,2546,1112,738,8460,540,6703
2800,인천광역시,계양구라선거구,6280704,2807,계양구,계양1동,관내사전투표,2311,2310,792,311,633,273,166,2175,135,1
2800,인천광역시,계양구라선거구,6280704,2807,계양구,계양1동,선거일투표,13392,6690,2144,817,1913,839,572,6285,405,6702
2800,인천광역시,계양구라선거구,6280704,2807,계양구,계양2동,계,28762,16265,5649,2098,4138,2039,1390,15314,951,12497
2800,인천광역시,계양구라선거구,6280704,2807,계양구,계양2동,관내사전투표,5799,5795,2128,734,1355,765,457,5439,356,4
2800,인천광역시,계양구라선거구,6280704,2807,계양구,계양2동,선거일투표,22963,10470,3521,1364,2783,1274,933,9875,595,12493
2800,인천광역시,계양구라선거구,6280704,2807,계양구,계양3동,계,19805,11593,4350,1617,2696,1527,884,11074,519,8212
2800,인천광역시,계양구라선거구,6280704,2807,계양구,계양3동,관내사전투표,4373,4340,1762,694,911,470,310,4147,193,33
2800,인천광역시,계양구라선거구,6280704,2807,계양구,계양3동,선거일투표,15432,7253,2588,923,1785,1057,574,6927,326,8179
2800,인천광역시,계양구라선거구,6280704,2807,계양구,잘못 투입·구분된 투표지,,0,105,41,9,25,12,12,99,6,-105
2800,인천광역시,서구가선거구,6280801,2808,서구,합계,,60929,29775,10590,3656,9983,2580,1281,28090,1685,31154
2800,인천광역시,서구가선거구,6280801,2808,서구,거소투표,,51,47,19,5,12,0,2,38,9,4
2800,인천광역시,서구가선거구,6280801,2808,서구,관외사전투표,,3133,3130,1068,400,1106,257,134,2965,165,3
2800,인천광역시,서구가선거구,6280801,2808,서구,청라1동,계,22903,10386,3741,1298,3374,863,541,9817,569,12517
2800,인천광역시,서구가선거구,6280801,2808,서구,청라1동,관내사전투표,3369,3367,1160,481,1066,285,170,3162,205,2
2800,인천광역시,서구가선거구,6280801,2808,서구,청라1동,선거일투표,19534,7019,2581,817,2308,578,371,6655,364,12515
2800,인천광역시,서구가선거구,6280801,2808,서구,청라2동,계,34842,16185,5750,1950,5483,1457,604,15244,941,18657
2800,인천광역시,서구가선거구,6280801,2808,서구,청라2동,관내사전투표,5317,5311,1854,692,1770,442,178,4936,375,6
2800,인천광역시,서구가선거구,6280801,2808,서구,청라2동,선거일투표,29525,10874,3896,1258,3713,1015,426,10308,566,18651
2800,인천광역시,서구가선거구,6280801,2808,서구,잘못 투입·구분된 투표지,,0,27,12,3,8,3,0,26,1,-27
2800,인천광역시,서구나선거구,6280802,2808,서구,합계,,96959,44972,13699,7570,14650,4720,40639,4333,51987
2800,인천광역시,서구나선거구,6280802,2808,서구,거소투표,,99,89,22,19,28,9,78,11,10
2800,인천광역시,서구나선거구,6280802,2808,서구,관외사전투표,,3584,3582,1260,628,1088,318,3294,288,2
2800,인천광역시,서구나선거구,6280802,2808,서구,석남1동,계,19240,7756,2338,1167,2657,760,6922,834,11484
2800,인천광역시,서구나선거구,6280802,2808,서구,석남1동,관내사전투표,2594,2584,763,380,904,256,2303,281,10
2800,인천광역시,서구나선거구,6280802,2808,서구,석남1동,선거일투표,16646,5172,1575,787,1753,504,4619,553,11474
2800,인천광역시,서구나선거구,6280802,2808,서구,석남2동,계,11646,5478,1592,875,1930,526,4923,555,6168
2800,인천광역시,서구나선거구,6280802,2808,서구,석남2동,관내사전투표,2133,2127,633,358,789,180,1960,167,6
2800,인천광역시,서구나선거구,6280802,2808,서구,석남2동,선거일투표,9513,3351,959,517,1141,346,2963,388,6162
2800,인천광역시,서구나선거구,6280802,2808,서구,석남3동,계,11492,4496,1424,663,1502,433,4022,474,6996
2800,인천광역시,서구나선거구,6280802,2808,서구,석남3동,관내사전투표,1765,1763,584,262,584,162,1592,171,2
2800,인천광역시,서구나선거구,6280802,2808,서구,석남3동,선거일투표,9727,2733,840,401,918,271,2430,303,6994
2800,인천광역시,서구나선거구,6280802,2808,서구,가좌1동,계,11254,4323,1331,733,1416,432,3912,411,6931
2800,인천광역시,서구나선거구,6280802,2808,서구,가좌1동,관내사전투표,1828,1827,547,311,592,190,1640,187,1
2800,인천광역시,서구나선거구,6280802,2808,서구,가좌1동,선거일투표,9426,2496,784,422,824,242,2272,224,6930
2800,인천광역시,서구나선거구,6280802,2808,서구,가좌2동,계,16570,8687,2555,1712,2728,969,7964,723,7883
2800,인천광역시,서구나선거구,6280802,2808,서구,가좌2동,관내사전투표,3242,3237,960,659,1006,323,2948,289,5
2800,인천광역시,서구나선거구,6280802,2808,서구,가좌2동,선거일투표,13328,5450,1595,1053,1722,646,5016,434,7878
2800,인천광역시,서구나선거구,6280802,2808,서구,가좌3동,계,14553,6680,1957,1085,2049,905,5996,684,7873
2800,인천광역시,서구나선거구,6280802,2808,서구,가좌3동,관내사전투표,2903,2901,853,503,902,390,2648,253,2
2800,인천광역시,서구나선거구,6280802,2808,서구,가좌3동,선거일투표,11650,3779,1104,582,1147,515,3348,431,7871
2800,인천광역시,서구나선거구,6280802,2808,서구,가좌4동,계,8521,3834,1204,680,1237,364,3485,349,4687
2800,인천광역시,서구나선거구,6280802,2808,서구,가좌4동,관내사전투표,1503,1502,478,260,466,147,1351,151,1
2800,인천광역시,서구나선거구,6280802,2808,서구,가좌4동,선거일투표,7018,2332,726,420,771,217,2134,198,4686
2800,인천광역시,서구나선거구,6280802,2808,서구,잘못 투입·구분된 투표지,,0,47,16,8,15,4,43,4,-47
2800,인천광역시,서구다선거구,6280803,2808,서구,합계,,68516,32713,11571,3869,9832,4149,1397,30818,1895,35803
2800,인천광역시,서구다선거구,6280803,2808,서구,거소투표,,76,70,19,15,17,8,4,63,7,6
2800,인천광역시,서구다선거구,6280803,2808,서구,관외사전투표,,3466,3466,1281,455,870,513,143,3262,204,0
2800,인천광역시,서구다선거구,6280803,2808,서구,가정1동,계,25831,11306,4294,1269,3283,1345,455,10646,660,14525
2800,인천광역시,서구다선거구,6280803,2808,서구,가정1동,관내사전투표,3008,2984,1210,385,789,308,102,2794,190,24
2800,인천광역시,서구다선거구,6280803,2808,서구,가정1동,선거일투표,22823,8322,3084,884,2494,1037,353,7852,470,14501
2800,인천광역시,서구다선거구,6280803,2808,서구,가정2동,계,5567,2366,777,305,696,341,107,2226,140,3201
2800,인천광역시,서구다선거구,6280803,2808,서구,가정2동,관내사전투표,988,981,335,136,280,121,44,916,65,7
2800,인천광역시,서구다선거구,6280803,2808,서구,가정2동,선거일투표,4579,1385,442,169,416,220,63,1310,75,3194
2800,인천광역시,서구다선거구,6280803,2808,서구,가정3동,계,8342,3987,1330,521,1242,452,201,3746,241,4355
2800,인천광역시,서구다선거구,6280803,2808,서구,가정3동,관내사전투표,1433,1433,496,178,462,139,65,1340,93,0
2800,인천광역시,서구다선거구,6280803,2808,서구,가정3동,선거일투표,6909,2554,834,343,780,313,136,2406,148,4355
2800,인천광역시,서구다선거구,6280803,2808,서구,신현원창동,계,25234,11471,3851,1297,3714,1486,487,10835,636,13763
2800,인천광역시,서구다선거구,6280803,2808,서구,신현원창동,관내사전투표,3254,3246,1069,422,1088,350,104,3033,213,8
2800,인천광역시,서구다선거구,6280803,2808,서구,신현원창동,선거일투표,21980,8225,2782,875,2626,1136,383,7802,423,13755
2800,인천광역시,서구다선거구,6280803,2808,서구,잘못 투입·구분된 투표지,,0,47,19,7,10,4,0,40,7,-47
2800,인천광역시,서구라선거구,6280804,2808,서구,합계,,74001,32188,10481,5435,9320,4257,29493,2695,41813
2800,인천광역시,서구라선거구,6280804,2808,서구,거소투표,,193,185,41,19,75,18,153,32,8
2800,인천광역시,서구라선거구,6280804,2808,서구,관외사전투표,,3196,3196,1103,572,966,278,2919,277,0
2800,인천광역시,서구라선거구,6280804,2808,서구,검암경서동,계,36268,14946,4942,2628,4411,1745,13726,1220,21322
2800,인천광역시,서구라선거구,6280804,2808,서구,검암경서동,관내사전투표,4062,4052,1322,753,1189,472,3736,316,10
2800,인천광역시,서구라선거구,6280804,2808,서구,검암경서동,선거일투표,32206,10894,3620,1875,3222,1273,9990,904,21312
2800,인천광역시,서구라선거구,6280804,2808,서구,연희동,계,34344,13791,4373,2204,3846,2204,12627,1164,20553
2800,인천광역시,서구라선거구,6280804,2808,서구,연희동,관내사전투표,4826,4775,1529,811,1208,800,4348,427,51
2800,인천광역시,서구라선거구,6280804,2808,서구,연희동,선거일투표,29518,9016,2844,1393,2638,1404,8279,737,20502
2800,인천광역시,서구라선거구,6280804,2808,서구,잘못 투입·구분된 투표지,,0,70,22,12,22,12,68,2,-70
2800,인천광역시,서구마선거구,6280805,2808,서구,합계,,86631,40635,13352,6944,14383,3068,581,38328,2307,45996
2800,인천광역시,서구마선거구,6280805,2808,서구,거소투표,,97,91,26,14,29,7,3,79,12,6
2800,인천광역시,서구마선거구,6280805,2808,서구,관외사전투표,,4533,4532,1490,765,1534,374,91,4254,278,1
2800,인천광역시,서구마선거구,6280805,2808,서구,청라3동,계,23231,10642,3416,1854,3872,739,159,10040,602,12589
2800,인천광역시,서구마선거구,6280805,2808,서구,청라3동,관내사전투표,3309,3305,1110,582,1196,188,33,3109,196,4
2800,인천광역시,서구마선거구,6280805,2808,서구,청라3동,선거일투표,19922,7337,2306,1272,2676,551,126,6931,406,12585
2800,인천광역시,서구마선거구,6280805,2808,서구,당하동,계,21721,9561,3256,1583,3450,609,139,9037,524,12160
2800,인천광역시,서구마선거구,6280805,2808,서구,당하동,관내사전투표,3754,3751,1254,642,1349,235,47,3527,224,3
2800,인천광역시,서구마선거구,6280805,2808,서구,당하동,선거일투표,17967,5810,2002,941,2101,374,92,5510,300,12157
2800,인천광역시,서구마선거구,6280805,2808,서구,오류왕길동,계,19715,8128,2546,1407,2865,768,106,7692,436,11587
2800,인천광역시,서구마선거구,6280805,2808,서구,오류왕길동,관내사전투표,2766,2763,851,481,1022,244,24,2622,141,3
2800,인천광역시,서구마선거구,6280805,2808,서구,오류왕길동,선거일투표,16949,5365,1695,926,1843,524,82,5070,295,11584
2800,인천광역시,서구마선거구,6280805,2808,서구,마전동,계,17334,7645,2603,1317,2617,571,83,7191,454,9689
2800,인천광역시,서구마선거구,6280805,2808,서구,마전동,관내사전투표,2942,2940,1017,480,983,221,25,2726,214,2
2800,인천광역시,서구마선거구,6280805,2808,서구,마전동,선거일투표,14392,4705,1586,837,1634,350,58,4465,240,9687
2800,인천광역시,서구마선거구,6280805,2808,서구,잘못 투입·구분된 투표지,,0,36,15,4,16,0,0,35,1,-36
2800,인천광역시,서구바선거구,6280806,2808,서구,합계,,85218,38025,10244,7272,8692,6464,1536,1976,36184,1841,47193
2800,인천광역시,서구바선거구,6280806,2808,서구,거소투표,,102,100,21,12,33,14,3,4,87,13,2
2800,인천광역시,서구바선거구,6280806,2808,서구,관외사전투표,,3926,3926,1235,703,962,475,166,187,3728,198,0
2800,인천광역시,서구바선거구,6280806,2808,서구,검단동,계,27084,10414,2720,1946,2758,1662,402,331,9819,595,16670
2800,인천광역시,서구바선거구,6280806,2808,서구,검단동,관내사전투표,3425,3425,882,691,900,555,110,98,3236,189,0
2800,인천광역시,서구바선거구,6280806,2808,서구,검단동,선거일투표,23659,6989,1838,1255,1858,1107,292,233,6583,406,16670
2800,인천광역시,서구바선거구,6280806,2808,서구,불로대곡동,계,18656,8208,2077,1516,1562,2015,318,319,7807,401,10448
2800,인천광역시,서구바선거구,6280806,2808,서구,불로대곡동,관내사전투표,3482,3480,938,672,620,854,124,108,3316,164,2
2800,인천광역시,서구바선거구,6280806,2808,서구,불로대곡동,선거일투표,15174,4728,1139,844,942,1161,194,211,4491,237,10446
2800,인천광역시,서구바선거구,6280806,2808,서구,원당동,계,18426,7663,2016,1726,1566,1245,276,506,7335,328,10763
2800,인천광역시,서구바선거구,6280806,2808,서구,원당동,관내사전투표,2638,2638,688,652,510,436,87,158,2531,107,0
2800,인천광역시,서구바선거구,6280806,2808,서구,원당동,선거일투표,15788,5025,1328,1074,1056,809,189,348,4804,221,10763
2800,인천광역시,서구바선거구,6280806,2808,서구,아라동,계,17024,7710,2173,1369,1810,1052,371,629,7404,306,9314
2800,인천광역시,서구바선거구,6280806,2808,서구,아라동,관내사전투표,2060,2060,584,381,449,303,86,152,1955,105,0
2800,인천광역시,서구바선거구,6280806,2808,서구,아라동,선거일투표,14964,5650,1589,988,1361,749,285,477,5449,201,9314
2800,인천광역시,서구바선거구,6280806,2808,서구,잘못 투입·구분된 투표지,,0,4,2,0,1,1,0,0,4,0,-4
2800,인천광역시,강화군가선거구,6280901,2809,강화군,합계,,31025,19018,6005,2081,5972,3817,17875,1143,12007
2800,인천광역시,강화군가선거구,6280901,2809,강화군,거소투표,,81,75,16,14,12,10,52,23,6
2800,인천광역시,강화군가선거구,6280901,2809,강화군,관외사전투표,,1978,1978,683,197,614,337,1831,147,0
2800,인천광역시,강화군가선거구,6280901,2809,강화군,강화읍,계,18298,10428,3534,1321,2943,2117,9915,513,7870
2800,인천광역시,강화군가선거구,6280901,2809,강화군,강화읍,관내사전투표,4317,4312,1487,518,1152,923,4080,232,5
2800,인천광역시,강화군가선거구,6280901,2809,강화군,강화읍,선거일투표,13981,6116,2047,803,1791,1194,5835,281,7865
2800,인천광역시,강화군가선거구,6280901,2809,강화군,하점면,계,3599,2106,531,182,829,414,1956,150,1493
2800,인천광역시,강화군가선거구,6280901,2809,강화군,하점면,관내사전투표,943,939,242,81,334,198,855,84,4
2800,인천광역시,강화군가선거구,6280901,2809,강화군,하점면,선거일투표,2656,1167,289,101,495,216,1101,66,1489
2800,인천광역시,강화군가선거구,6280901,2809,강화군,양사면,계,1627,1021,288,113,363,180,944,77,606
2800,인천광역시,강화군가선거구,6280901,2809,강화군,양사면,관내사전투표,453,453,112,44,169,89,414,39,0
2800,인천광역시,강화군가선거구,6280901,2809,강화군,양사면,선거일투표,1174,568,176,69,194,91,530,38,606
2800,인천광역시,강화군가선거구,6280901,2809,강화군,송해면,계,2965,1793,484,172,646,379,1681,112,1172
2800,인천광역시,강화군가선거구,6280901,2809,강화군,송해면,관내사전투표,1047,1044,283,108,360,214,965,79,3
2800,인천광역시,강화군가선거구,6280901,2809,강화군,송해면,선거일투표,1918,749,201,64,286,165,716,33,1169
2800,인천광역시,강화군가선거구,6280901,2809,강화군,교동면,계,2477,1598,464,81,559,376,1480,118,879
2800,인천광역시,강화군가선거구,6280901,2809,강화군,교동면,관내사전투표,721,721,201,31,238,175,645,76,0
2800,인천광역시,강화군가선거구,6280901,2809,강화군,교동면,선거일투표,1756,877,263,50,321,201,835,42,879
2800,인천광역시,강화군가선거구,6280901,2809,강화군,잘못 투입·구분된 투표지,,0,19,5,1,6,4,16,3,-19
2800,인천광역시,강화군나선거구,6280902,2809,강화군,합계,,32122,20068,5231,7964,2781,2702,370,19048,1020,12054
2800,인천광역시,강화군나선거구,6280902,2809,강화군,거소투표,,168,162,47,43,26,19,13,148,14,6
2800,인천광역시,강화군나선거구,6280902,2809,강화군,관외사전투표,,2463,2459,832,1049,229,232,37,2379,80,4
2800,인천광역시,강화군나선거구,6280902,2809,강화군,선원면,계,6270,3656,1126,1222,442,618,80,3488,168,2614
2800,인천광역시,강화군나선거구,6280902,2809,강화군,선원면,관내사전투표,1681,1678,494,610,205,277,30,1616,62,3
2800,인천광역시,강화군나선거구,6280902,2809,강화군,선원면,선거일투표,4589,1978,632,612,237,341,50,1872,106,2611
2800,인천광역시,강화군나선거구,6280902,2809,강화군,불은면,계,4227,2395,653,887,323,324,54,2241,154,1832
2800,인천광역시,강화군나선거구,6280902,2809,강화군,불은면,관내사전투표,1097,1095,317,413,148,144,24,1046,49,2
2800,인천광역시,강화군나선거구,6280902,2809,강화군,불은면,선거일투표,3130,1300,336,474,175,180,30,1195,105,1830
2800,인천광역시,강화군나선거구,6280902,2809,강화군,길상면,계,6383,3731,927,1618,430,511,59,3545,186,2652
2800,인천광역시,강화군나선거구,6280902,2809,강화군,길상면,관내사전투표,1714,1709,461,699,195,216,26,1597,112,5
2800,인천광역시,강화군나선거구,6280902,2809,강화군,길상면,선거일투표,4669,2022,466,919,235,295,33,1948,74,2647
2800,인천광역시,강화군나선거구,6280902,2809,강화군,화도면,계,3827,2181,510,845,281,394,34,2064,117,1646
2800,인천광역시,강화군나선거구,6280902,2809,강화군,화도면,관내사전투표,736,736,181,299,99,119,10,708,28,0
2800,인천광역시,강화군나선거구,6280902,2809,강화군,화도면,선거일투표,3091,1445,329,546,182,275,24,1356,89,1646
2800,인천광역시,강화군나선거구,6280902,2809,강화군,양도면,계,3625,2103,581,758,331,272,28,1970,133,1522
2800,인천광역시,강화군나선거구,6280902,2809,강화군,양도면,관내사전투표,901,900,259,335,148,104,10,856,44,1
2800,인천광역시,강화군나선거구,6280902,2809,강화군,양도면,선거일투표,2724,1203,322,423,183,168,18,1114,89,1521
2800,인천광역시,강화군나선거구,6280902,2809,강화군,내가면,계,2689,1804,330,559,575,225,36,1725,79,885
2800,인천광역시,강화군나선거구,6280902,2809,강화군,내가면,관내사전투표,702,699,142,206,214,85,13,660,39,3
2800,인천광역시,강화군나선거구,6280902,2809,강화군,내가면,선거일투표,1987,1105,188,353,361,140,23,1065,40,882
2800,인천광역시,강화군나선거구,6280902,2809,강화군,삼산면,계,1920,1178,162,769,113,52,18,1114,64,742
2800,인천광역시,강화군나선거구,6280902,2809,강화군,삼산면,관내사전투표,497,497,72,341,45,19,8,485,12,0
2800,인천광역시,강화군나선거구,6280902,2809,강화군,삼산면,선거일투표,1423,681,90,428,68,33,10,629,52,742
2800,인천광역시,강화군나선거구,6280902,2809,강화군,서도면,계,550,376,56,206,28,54,11,355,21,174
2800,인천광역시,강화군나선거구,6280902,2809,강화군,서도면,관내사전투표,110,110,21,60,9,13,4,107,3,0
2800,인천광역시,강화군나선거구,6280902,2809,강화군,서도면,선거일투표,440,266,35,146,19,41,7,248,18,174
2800,인천광역시,강화군나선거구,6280902,2809,강화군,잘못 투입·구분된 투표지,,0,23,7,8,3,1,0,19,4,-23
2800,인천광역시,옹진군가선거구,6281001,2810,옹진군,합계,,5749,4013,1053,1116,678,895,3742,271,1736
2800,인천광역시,옹진군가선거구,6281001,2810,옹진군,거소투표,,72,67,15,16,9,23,63,4,5
2800,인천광역시,옹진군가선거구,6281001,2810,옹진군,관외사전투표,,862,862,250,316,97,160,823,39,0
2800,인천광역시,옹진군가선거구,6281001,2810,옹진군,북도면,계,1669,1135,423,431,128,51,1033,102,534
2800,인천광역시,옹진군가선거구,6281001,2810,옹진군,북도면,관내사전투표,387,386,190,111,49,17,367,19,1
2800,인천광역시,옹진군가선거구,6281001,2810,옹진군,북도면,선거일투표,1282,749,233,320,79,34,666,83,533
2800,인천광역시,옹진군가선거구,6281001,2810,옹진군,연평면,계,1683,928,226,188,351,105,870,58,755
2800,인천광역시,옹진군가선거구,6281001,2810,옹진군,연평면,관내사전투표,587,587,145,119,206,76,546,41,0
2800,인천광역시,옹진군가선거구,6281001,2810,옹진군,연평면,선거일투표,1096,341,81,69,145,29,324,17,755
2800,인천광역시,옹진군가선거구,6281001,2810,옹진군,덕적면,계,1463,1018,139,164,93,555,951,67,445
2800,인천광역시,옹진군가선거구,6281001,2810,옹진군,덕적면,관내사전투표,549,547,75,81,53,306,515,32,2
2800,인천광역시,옹진군가선거구,6281001,2810,옹진군,덕적면,선거일투표,914,471,64,83,40,249,436,35,443
2800,인천광역시,옹진군가선거구,6281001,2810,옹진군,잘못 투입·구분된 투표지,,0,3,0,1,0,1,2,1,-3
2800,인천광역시,옹진군나선거구,6281002,2810,옹진군,검색된 결과가 없습니다.
2800,인천광역시,옹진군다선거구,6281003,2810,옹진군,합계,,5835,3949,1089,1003,502,1141,3735,214,1886
2800,인천광역시,옹진군다선거구,6281003,2810,옹진군,거소투표,,13,12,5,3,2,1,11,1,1
2800,인천광역시,옹진군다선거구,6281003,2810,옹진군,관외사전투표,,519,518,157,182,76,86,501,17,1
2800,인천광역시,옹진군다선거구,6281003,2810,옹진군,백령면,계,4088,2536,455,615,343,976,2389,147,1552
2800,인천광역시,옹진군다선거구,6281003,2810,옹진군,백령면,관내사전투표,1082,1082,254,292,150,337,1033,49,0
2800,인천광역시,옹진군다선거구,6281003,2810,옹진군,백령면,선거일투표,3006,1454,201,323,193,639,1356,98,1552
2800,인천광역시,옹진군다선거구,6281003,2810,옹진군,대청면,계,1215,882,471,203,81,78,833,49,333
2800,인천광역시,옹진군다선거구,6281003,2810,옹진군,대청면,관내사전투표,492,492,286,105,45,35,471,21,0
2800,인천광역시,옹진군다선거구,6281003,2810,옹진군,대청면,선거일투표,723,390,185,98,36,43,362,28,333
2800,인천광역시,옹진군다선거구,6281003,2810,옹진군,잘못 투입·구분된 투표지,,0,1,1,0,0,0,1,0,-12900,광주광역시,동구가선거구,6290101,2901,동구,합계,,42662,17677,6030,3039,2451,2419,3192,17131,546,24985
2900,광주광역시,동구가선거구,6290101,2901,동구,거소투표,,73,68,21,10,14,12,7,64,4,5
2900,광주광역시,동구가선거구,6290101,2901,동구,관외사전투표,,2490,2485,908,357,360,361,412,2398,87,5
2900,광주광역시,동구가선거구,6290101,2901,동구,충장동,계,4444,1215,453,202,196,166,158,1175,40,3229
2900,광주광역시,동구가선거구,6290101,2901,동구,충장동,관내사전투표,462,462,193,78,72,55,50,448,14,0
2900,광주광역시,동구가선거구,6290101,2901,동구,충장동,선거일투표,3982,753,260,124,124,111,108,727,26,3229
2900,광주광역시,동구가선거구,6290101,2901,동구,동명동,계,3376,1211,379,230,188,160,220,1177,34,2165
2900,광주광역시,동구가선거구,6290101,2901,동구,동명동,관내사전투표,513,507,153,91,89,57,102,492,15,6
2900,광주광역시,동구가선거구,6290101,2901,동구,동명동,선거일투표,2863,704,226,139,99,103,118,685,19,2159
2900,광주광역시,동구가선거구,6290101,2901,동구,계림1동,계,9003,3178,1134,461,438,544,506,3083,95,5825
2900,광주광역시,동구가선거구,6290101,2901,동구,계림1동,관내사전투표,1096,1094,408,174,141,146,184,1053,41,2
2900,광주광역시,동구가선거구,6290101,2901,동구,계림1동,선거일투표,7907,2084,726,287,297,398,322,2030,54,5823
2900,광주광역시,동구가선거구,6290101,2901,동구,계림2동,계,7855,3605,1180,607,461,528,716,3492,113,4250
2900,광주광역시,동구가선거구,6290101,2901,동구,계림2동,관내사전투표,1760,1758,575,321,246,203,357,1702,56,2
2900,광주광역시,동구가선거구,6290101,2901,동구,계림2동,선거일투표,6095,1847,605,286,215,325,359,1790,57,4248
2900,광주광역시,동구가선거구,6290101,2901,동구,산수1동,계,6807,2466,780,585,328,280,430,2403,63,4341
2900,광주광역시,동구가선거구,6290101,2901,동구,산수1동,관내사전투표,894,894,255,229,120,106,168,878,16,0
2900,광주광역시,동구가선거구,6290101,2901,동구,산수1동,선거일투표,5913,1572,525,356,208,174,262,1525,47,4341
2900,광주광역시,동구가선거구,6290101,2901,동구,산수2동,계,8614,3430,1163,585,466,364,742,3320,110,5184
2900,광주광역시,동구가선거구,6290101,2901,동구,산수2동,관내사전투표,1138,1133,414,201,145,97,234,1091,42,5
2900,광주광역시,동구가선거구,6290101,2901,동구,산수2동,선거일투표,7476,2297,749,384,321,267,508,2229,68,5179
2900,광주광역시,동구가선거구,6290101,2901,동구,잘못 투입·구분된 투표지,,0,19,12,2,0,4,1,19,0,-19
2900,광주광역시,동구나선거구,6290102,2901,동구,합계,,47593,20696,7069,3371,2829,3104,3574,19947,749,26897
2900,광주광역시,동구나선거구,6290102,2901,동구,거소투표,,92,82,27,12,11,8,17,75,7,10
2900,광주광역시,동구나선거구,6290102,2901,동구,관외사전투표,,2773,2773,1006,506,340,383,433,2668,105,0
2900,광주광역시,동구나선거구,6290102,2901,동구,지산1동,계,3496,1216,518,243,132,119,151,1163,53,2280
2900,광주광역시,동구나선거구,6290102,2901,동구,지산1동,관내사전투표,534,534,207,118,62,49,73,509,25,0
2900,광주광역시,동구나선거구,6290102,2901,동구,지산1동,선거일투표,2962,682,311,125,70,70,78,654,28,2280
2900,광주광역시,동구나선거구,6290102,2901,동구,지산2동,계,3843,1423,547,304,170,176,174,1371,52,2420
2900,광주광역시,동구나선거구,6290102,2901,동구,지산2동,관내사전투표,614,612,234,128,77,70,83,592,20,2
2900,광주광역시,동구나선거구,6290102,2901,동구,지산2동,선거일투표,3229,811,313,176,93,106,91,779,32,2418
2900,광주광역시,동구나선거구,6290102,2901,동구,서남동,계,2781,903,293,191,126,134,120,864,39,1878
2900,광주광역시,동구나선거구,6290102,2901,동구,서남동,관내사전투표,556,554,175,114,78,85,72,524,30,2
2900,광주광역시,동구나선거구,6290102,2901,동구,서남동,선거일투표,2225,349,118,77,48,49,48,340,9,1876
2900,광주광역시,동구나선거구,6290102,2901,동구,학동,계,6136,2756,906,406,462,430,441,2645,111,3380
2900,광주광역시,동구나선거구,6290102,2901,동구,학동,관내사전투표,1065,1065,341,175,160,155,191,1022,43,0
2900,광주광역시,동구나선거구,6290102,2901,동구,학동,선거일투표,5071,1691,565,231,302,275,250,1623,68,3380
2900,광주광역시,동구나선거구,6290102,2901,동구,학운동,계,9917,4570,1500,696,742,648,832,4418,152,5347
2900,광주광역시,동구나선거구,6290102,2901,동구,학운동,관내사전투표,2048,2046,644,333,356,296,352,1981,65,2
2900,광주광역시,동구나선거구,6290102,2901,동구,학운동,선거일투표,7869,2524,856,363,386,352,480,2437,87,5345
2900,광주광역시,동구나선거구,6290102,2901,동구,지원1동,계,6336,2541,772,414,347,428,496,2457,84,3795
2900,광주광역시,동구나선거구,6290102,2901,동구,지원1동,관내사전투표,1245,1245,368,229,178,199,231,1205,40,0
2900,광주광역시,동구나선거구,6290102,2901,동구,지원1동,선거일투표,5091,1296,404,185,169,229,265,1252,44,3795
2900,광주광역시,동구나선거구,6290102,2901,동구,지원2동,계,12219,4423,1498,599,497,777,907,4278,145,7796
2900,광주광역시,동구나선거구,6290102,2901,동구,지원2동,관내사전투표,1497,1495,512,189,194,213,332,1440,55,2
2900,광주광역시,동구나선거구,6290102,2901,동구,지원2동,선거일투표,10722,2928,986,410,303,564,575,2838,90,7794
2900,광주광역시,동구나선거구,6290102,2901,동구,잘못 투입·구분된 투표지,,0,9,2,0,2,1,3,8,1,-9
2900,광주광역시,서구가선거구,6290201,2902,서구,합계,,52076,20534,5943,4243,4213,2594,2743,19736,798,31542
2900,광주광역시,서구가선거구,6290201,2902,서구,거소투표,,65,63,22,13,3,12,10,60,3,2
2900,광주광역시,서구가선거구,6290201,2902,서구,관외사전투표,,2673,2671,894,607,395,349,324,2569,102,2
2900,광주광역시,서구가선거구,6290201,2902,서구,양동,계,3489,1519,600,299,232,132,193,1456,63,1970
2900,광주광역시,서구가선거구,6290201,2902,서구,양동,관내사전투표,747,747,281,150,132,65,94,722,25,0
2900,광주광역시,서구가선거구,6290201,2902,서구,양동,선거일투표,2742,772,319,149,100,67,99,734,38,1970
2900,광주광역시,서구가선거구,6290201,2902,서구,양3동,계,3780,1656,477,286,262,112,454,1591,65,2124
2900,광주광역시,서구가선거구,6290201,2902,서구,양3동,관내사전투표,777,776,203,141,119,50,232,745,31,1
2900,광주광역시,서구가선거구,6290201,2902,서구,양3동,선거일투표,3003,880,274,145,143,62,222,846,34,2123
2900,광주광역시,서구가선거구,6290201,2902,서구,농성1동,계,9286,2885,853,747,541,290,343,2774,111,6401
2900,광주광역시,서구가선거구,6290201,2902,서구,농성1동,관내사전투표,1310,1310,391,371,250,107,145,1264,46,0
2900,광주광역시,서구가선거구,6290201,2902,서구,농성1동,선거일투표,7976,1575,462,376,291,183,198,1510,65,6401
2900,광주광역시,서구가선거구,6290201,2902,서구,농성2동,계,4362,1501,470,297,327,178,167,1439,62,2861
2900,광주광역시,서구가선거구,6290201,2902,서구,농성2동,관내사전투표,721,719,234,148,169,65,79,695,24,2
2900,광주광역시,서구가선거구,6290201,2902,서구,농성2동,선거일투표,3641,782,236,149,158,113,88,744,38,2859
2900,광주광역시,서구가선거구,6290201,2902,서구,화정1동,계,13199,4270,1228,942,894,526,495,4085,185,8929
2900,광주광역시,서구가선거구,6290201,2902,서구,화정1동,관내사전투표,1545,1542,465,315,337,188,186,1491,51,3
2900,광주광역시,서구가선거구,6290201,2902,서구,화정1동,선거일투표,11654,2728,763,627,557,338,309,2594,134,8926
2900,광주광역시,서구가선거구,6290201,2902,서구,화정2동,계,15222,5945,1393,1047,1552,992,755,5739,206,9277
2900,광주광역시,서구가선거구,6290201,2902,서구,화정2동,관내사전투표,2280,2267,548,380,663,347,254,2192,75,13
2900,광주광역시,서구가선거구,6290201,2902,서구,화정2동,선거일투표,12942,3678,845,667,889,645,501,3547,131,9264
2900,광주광역시,서구가선거구,6290201,2902,서구,잘못 투입·구분된 투표지,,0,24,6,5,7,3,2,23,1,-24
2900,광주광역시,서구나선거구,6290202,2902,서구,합계,,76127,29252,9485,5388,5848,6652,27373,1879,46875
2900,광주광역시,서구나선거구,6290202,2902,서구,거소투표,,93,88,38,14,14,13,79,9,5
2900,광주광역시,서구나선거구,6290202,2902,서구,관외사전투표,,3856,3849,1375,836,615,837,3663,186,7
2900,광주광역시,서구나선거구,6290202,2902,서구,광천동,계,6564,2347,733,436,524,477,2170,177,4217
2900,광주광역시,서구나선거구,6290202,2902,서구,광천동,관내사전투표,1132,1130,348,201,302,224,1075,55,2
2900,광주광역시,서구나선거구,6290202,2902,서구,광천동,선거일투표,5432,1217,385,235,222,253,1095,122,4215
2900,광주광역시,서구나선거구,6290202,2902,서구,유덕동,계,8735,3318,814,762,826,734,3136,182,5417
2900,광주광역시,서구나선거구,6290202,2902,서구,유덕동,관내사전투표,1372,1371,317,331,386,291,1325,46,1
2900,광주광역시,서구나선거구,6290202,2902,서구,유덕동,선거일투표,7363,1947,497,431,440,443,1811,136,5416
2900,광주광역시,서구나선거구,6290202,2902,서구,치평동,계,24380,8430,2880,1346,1720,1858,7804,626,15950
2900,광주광역시,서구나선거구,6290202,2902,서구,치평동,관내사전투표,2931,2928,979,478,717,639,2813,115,3
2900,광주광역시,서구나선거구,6290202,2902,서구,치평동,선거일투표,21449,5502,1901,868,1003,1219,4991,511,15947
2900,광주광역시,서구나선거구,6290202,2902,서구,상무1동,계,20280,6442,2166,1266,1238,1351,6021,421,13838
2900,광주광역시,서구나선거구,6290202,2902,서구,상무1동,관내사전투표,2295,2291,760,432,520,482,2194,97,4
2900,광주광역시,서구나선거구,6290202,2902,서구,상무1동,선거일투표,17985,4151,1406,834,718,869,3827,324,13834
2900,광주광역시,서구나선거구,6290202,2902,서구,동천동,계,12219,4747,1471,721,905,1376,4473,274,7472
2900,광주광역시,서구나선거구,6290202,2902,서구,동천동,관내사전투표,1960,1955,615,298,408,568,1889,66,5
2900,광주광역시,서구나선거구,6290202,2902,서구,동천동,선거일투표,10259,2792,856,423,497,808,2584,208,7467
2900,광주광역시,서구나선거구,6290202,2902,서구,잘못 투입·구분된 투표지,,0,31,8,7,6,6,27,4,-31
2900,광주광역시,서구다선거구,6290203,2902,서구,합계,,52016,21376,7937,6423,3403,2314,20077,1299,30640
2900,광주광역시,서구다선거구,6290203,2902,서구,거소투표,,81,77,31,30,8,7,76,1,4
2900,광주광역시,서구다선거구,6290203,2902,서구,관외사전투표,,3009,3009,1261,897,417,275,2850,159,0
2900,광주광역시,서구다선거구,6290203,2902,서구,화정3동,계,7939,2706,1135,675,424,240,2474,232,5233
2900,광주광역시,서구다선거구,6290203,2902,서구,화정3동,관내사전투표,606,605,270,151,103,57,581,24,1
2900,광주광역시,서구다선거구,6290203,2902,서구,화정3동,선거일투표,7333,2101,865,524,321,183,1893,208,5232
2900,광주광역시,서구다선거구,6290203,2902,서구,화정4동,계,12470,5144,2315,1145,933,440,4833,311,7326
2900,광주광역시,서구다선거구,6290203,2902,서구,화정4동,관내사전투표,2117,2115,1031,483,353,168,2035,80,2
2900,광주광역시,서구다선거구,6290203,2902,서구,화정4동,선거일투표,10353,3029,1284,662,580,272,2798,231,7324
2900,광주광역시,서구다선거구,6290203,2902,서구,풍암동,계,28517,10423,3191,3670,1620,1351,9832,591,18094
2900,광주광역시,서구다선거구,6290203,2902,서구,풍암동,관내사전투표,3907,3900,1193,1488,562,495,3738,162,7
2900,광주광역시,서구다선거구,6290203,2902,서구,풍암동,선거일투표,24610,6523,1998,2182,1058,856,6094,429,18087
2900,광주광역시,서구다선거구,6290203,2902,서구,잘못 투입·구분된 투표지,,0,17,4,6,1,1,12,5,-17
2900,광주광역시,서구라선거구,6290204,2902,서구,합계,,66622,26768,7402,3512,2718,1985,1965,57,3224,875,111,3998,25847,921,39854
2900,광주광역시,서구라선거구,6290204,2902,서구,거소투표,,116,106,50,15,8,12,4,0,5,1,0,7,102,4,10
2900,광주광역시,서구라선거구,6290204,2902,서구,관외사전투표,,3792,3790,1166,502,447,395,247,5,309,106,13,462,3652,138,2
2900,광주광역시,서구라선거구,6290204,2902,서구,상무2동,계,20012,6313,2125,831,725,516,341,24,584,194,23,674,6037,276,13699
2900,광주광역시,서구라선거구,6290204,2902,서구,상무2동,관내사전투표,2248,2248,807,310,267,122,120,10,184,91,7,228,2146,102,0
2900,광주광역시,서구라선거구,6290204,2902,서구,상무2동,선거일투표,17764,4065,1318,521,458,394,221,14,400,103,16,446,3891,174,13699
2900,광주광역시,서구라선거구,6290204,2902,서구,서창동,계,4534,1593,387,123,153,111,111,8,167,44,3,419,1526,67,2941
2900,광주광역시,서구라선거구,6290204,2902,서구,서창동,관내사전투표,429,429,81,27,45,14,29,2,63,5,1,142,409,20,0
2900,광주광역시,서구라선거구,6290204,2902,서구,서창동,선거일투표,4105,1164,306,96,108,97,82,6,104,39,2,277,1117,47,2941
2900,광주광역시,서구라선거구,6290204,2902,서구,금호1동,계,16406,6447,1481,944,550,416,540,9,844,293,22,1131,6230,217,9959
2900,광주광역시,서구라선거구,6290204,2902,서구,금호1동,관내사전투표,2408,2408,531,379,221,122,173,4,339,117,10,424,2320,88,0
2900,광주광역시,서구라선거구,6290204,2902,서구,금호1동,선거일투표,13998,4039,950,565,329,294,367,5,505,176,12,707,3910,129,9959
2900,광주광역시,서구라선거구,6290204,2902,서구,금호2동,계,21762,8516,2192,1097,835,535,722,11,1313,237,50,1305,8297,219,13246
2900,광주광역시,서구라선거구,6290204,2902,서구,금호2동,관내사전투표,3332,3332,862,456,332,175,269,2,501,121,17,503,3238,94,0
2900,광주광역시,서구라선거구,6290204,2902,서구,금호2동,선거일투표,18430,5184,1330,641,503,360,453,9,812,116,33,802,5059,125,13246
2900,광주광역시,서구라선거구,6290204,2902,서구,잘못 투입·구분된 투표지,,0,3,1,0,0,0,0,0,2,0,0,0,3,0,-3
2900,광주광역시,남구가선거구,6290301,2903,남구,합계,,58966,22065,8790,3527,5587,1098,2198,21200,865,36901
2900,광주광역시,남구가선거구,6290301,2903,남구,거소투표,,94,83,33,12,20,3,7,75,8,11
2900,광주광역시,남구가선거구,6290301,2903,남구,관외사전투표,,3361,3361,1487,496,642,210,372,3207,154,0
2900,광주광역시,남구가선거구,6290301,2903,남구,봉선1동,계,11190,3977,1567,517,1040,172,556,3852,125,7213
2900,광주광역시,남구가선거구,6290301,2903,남구,봉선1동,관내사전투표,1797,1795,695,212,539,74,217,1737,58,2
2900,광주광역시,남구가선거구,6290301,2903,남구,봉선1동,선거일투표,9393,2182,872,305,501,98,339,2115,67,7211
2900,광주광역시,남구가선거구,6290301,2903,남구,월산동,계,7360,2296,1057,318,457,115,238,2185,111,5064
2900,광주광역시,남구가선거구,6290301,2903,남구,월산동,관내사전투표,791,789,356,117,173,24,82,752,37,2
2900,광주광역시,남구가선거구,6290301,2903,남구,월산동,선거일투표,6569,1507,701,201,284,91,156,1433,74,5062
2900,광주광역시,남구가선거구,6290301,2903,남구,월산4동,계,7301,2204,993,323,470,79,220,2085,119,5097
2900,광주광역시,남구가선거구,6290301,2903,남구,월산4동,관내사전투표,948,946,419,132,235,31,86,903,43,2
2900,광주광역시,남구가선거구,6290301,2903,남구,월산4동,선거일투표,6353,1258,574,191,235,48,134,1182,76,5095
2900,광주광역시,남구가선거구,6290301,2903,남구,월산5동,계,5777,2056,745,523,514,62,122,1966,90,3721
2900,광주광역시,남구가선거구,6290301,2903,남구,월산5동,관내사전투표,1054,1051,369,298,263,26,53,1009,42,3
2900,광주광역시,남구가선거구,6290301,2903,남구,월산5동,선거일투표,4723,1005,376,225,251,36,69,957,48,3718
2900,광주광역시,남구가선거구,6290301,2903,남구,주월1동,계,17108,5642,2031,794,1768,384,502,5479,163,11466
2900,광주광역시,남구가선거구,6290301,2903,남구,주월1동,관내사전투표,2319,2310,767,296,879,139,164,2245,65,9
2900,광주광역시,남구가선거구,6290301,2903,남구,주월1동,선거일투표,14789,3332,1264,498,889,245,338,3234,98,11457
2900,광주광역시,남구가선거구,6290301,2903,남구,주월2동,계,6775,2427,870,542,669,73,179,2333,94,4348
2900,광주광역시,남구가선거구,6290301,2903,남구,주월2동,관내사전투표,1134,1133,417,232,341,34,76,1100,33,1
2900,광주광역시,남구가선거구,6290301,2903,남구,주월2동,선거일투표,5641,1294,453,310,328,39,103,1233,61,4347
2900,광주광역시,남구가선거구,6290301,2903,남구,잘못 투입·구분된 투표지,,0,19,7,2,7,0,2,18,1,-19
2900,광주광역시,남구나선거구,6290302,2903,남구,합계,,81231,32695,9409,8902,4288,3806,3182,2211,31798,897,48536
2900,광주광역시,남구나선거구,6290302,2903,남구,거소투표,,258,245,77,33,31,27,15,25,208,37,13
2900,광주광역시,남구나선거구,6290302,2903,남구,관외사전투표,,5013,5012,1593,1322,577,659,432,287,4870,142,1
2900,광주광역시,남구나선거구,6290302,2903,남구,봉선2동,계,20243,7490,2103,2001,922,1296,499,458,7279,211,12753
2900,광주광역시,남구나선거구,6290302,2903,남구,봉선2동,관내사전투표,2597,2597,767,735,339,345,152,172,2510,87,0
2900,광주광역시,남구나선거구,6290302,2903,남구,봉선2동,선거일투표,17646,4893,1336,1266,583,951,347,286,4769,124,12753
2900,광주광역시,남구나선거구,6290302,2903,남구,진월동,계,22478,8450,2391,2155,1382,700,858,760,8246,204,14028
2900,광주광역시,남구나선거구,6290302,2903,남구,진월동,관내사전투표,2896,2896,799,754,516,219,308,227,2823,73,0
2900,광주광역시,남구나선거구,6290302,2903,남구,진월동,선거일투표,19582,5554,1592,1401,866,481,550,533,5423,131,14028
2900,광주광역시,남구나선거구,6290302,2903,남구,효덕동,계,12639,4829,1301,1269,597,495,699,332,4693,136,7810
2900,광주광역시,남구나선거구,6290302,2903,남구,효덕동,관내사전투표,1738,1738,467,508,219,159,206,130,1689,49,0
2900,광주광역시,남구나선거구,6290302,2903,남구,효덕동,선거일투표,10901,3091,834,761,378,336,493,202,3004,87,7810
2900,광주광역시,남구나선거구,6290302,2903,남구,송암동,계,14931,4546,1224,1457,571,488,453,261,4454,92,10385
2900,광주광역시,남구나선거구,6290302,2903,남구,송암동,관내사전투표,1115,1115,308,375,114,111,100,77,1085,30,0
2900,광주광역시,남구나선거구,6290302,2903,남구,송암동,선거일투표,13816,3431,916,1082,457,377,353,184,3369,62,10385
2900,광주광역시,남구나선거구,6290302,2903,남구,대촌동,계,5669,2123,720,665,208,141,226,88,2048,75,3546
2900,광주광역시,남구나선거구,6290302,2903,남구,대촌동,관내사전투표,849,849,282,288,80,52,88,29,819,30,0
2900,광주광역시,남구나선거구,6290302,2903,남구,대촌동,선거일투표,4820,1274,438,377,128,89,138,59,1229,45,3546
2900,광주광역시,남구나선거구,6290302,2903,남구,잘못 투입·구분된 투표지,,0,0,0,0,0,0,0,0,0,0,0
2900,광주광역시,남구다선거구,6290303,2903,남구,합계,,39961,16736,5947,3715,2219,4277,16158,578,23225
2900,광주광역시,남구다선거구,6290303,2903,남구,거소투표,,66,63,29,13,6,9,57,6,3
2900,광주광역시,남구다선거구,6290303,2903,남구,관외사전투표,,2121,2120,923,425,246,451,2045,75,1
2900,광주광역시,남구다선거구,6290303,2903,남구,양림동,계,5722,2438,659,513,240,939,2351,87,3284
2900,광주광역시,남구다선거구,6290303,2903,남구,양림동,관내사전투표,1205,1204,315,236,114,490,1155,49,1
2900,광주광역시,남구다선거구,6290303,2903,남구,양림동,선거일투표,4517,1234,344,277,126,449,1196,38,3283
2900,광주광역시,남구다선거구,6290303,2903,남구,방림1동,계,5418,2197,718,712,287,410,2127,70,3221
2900,광주광역시,남구다선거구,6290303,2903,남구,방림1동,관내사전투표,1117,1116,347,375,132,219,1073,43,1
2900,광주광역시,남구다선거구,6290303,2903,남구,방림1동,선거일투표,4301,1081,371,337,155,191,1054,27,3220
2900,광주광역시,남구다선거구,6290303,2903,남구,방림2동,계,7190,2719,1114,684,348,467,2613,106,4471
2900,광주광역시,남구다선거구,6290303,2903,남구,방림2동,관내사전투표,772,771,294,202,76,153,725,46,1
2900,광주광역시,남구다선거구,6290303,2903,남구,방림2동,선거일투표,6418,1948,820,482,272,314,1888,60,4470
2900,광주광역시,남구다선거구,6290303,2903,남구,사직동,계,4337,1442,529,303,184,370,1386,56,2895
2900,광주광역시,남구다선거구,6290303,2903,남구,사직동,관내사전투표,630,630,206,135,88,165,594,36,0
2900,광주광역시,남구다선거구,6290303,2903,남구,사직동,선거일투표,3707,812,323,168,96,205,792,20,2895
2900,광주광역시,남구다선거구,6290303,2903,남구,백운1동,계,9930,4097,1393,776,666,1149,3984,113,5833
2900,광주광역시,남구다선거구,6290303,2903,남구,백운1동,관내사전투표,1731,1731,564,334,252,519,1669,62,0
2900,광주광역시,남구다선거구,6290303,2903,남구,백운1동,선거일투표,8199,2366,829,442,414,630,2315,51,5833
2900,광주광역시,남구다선거구,6290303,2903,남구,백운2동,계,5177,1656,581,289,242,479,1591,65,3521
2900,광주광역시,남구다선거구,6290303,2903,남구,백운2동,관내사전투표,651,650,216,109,92,200,617,33,1
2900,광주광역시,남구다선거구,6290303,2903,남구,백운2동,선거일투표,4526,1006,365,180,150,279,974,32,3520
2900,광주광역시,남구다선거구,6290303,2903,남구,잘못 투입·구분된 투표지,,0,4,1,0,0,3,4,0,-4
2900,광주광역시,북구가선거구,6290401,2904,북구,합계,,40172,14816,5743,2373,2221,1436,2371,14144,672,25356
2900,광주광역시,북구가선거구,6290401,2904,북구,거소투표,,41,34,14,3,2,5,7,31,3,7
2900,광주광역시,북구가선거구,6290401,2904,북구,관외사전투표,,2634,2634,1147,446,347,274,300,2514,120,0
2900,광주광역시,북구가선거구,6290401,2904,북구,중흥1동,계,4061,1246,546,189,163,112,170,1180,66,2815
2900,광주광역시,북구가선거구,6290401,2904,북구,중흥1동,관내사전투표,574,574,248,99,85,47,78,557,17,0
2900,광주광역시,북구가선거구,6290401,2904,북구,중흥1동,선거일투표,3487,672,298,90,78,65,92,623,49,2815
2900,광주광역시,북구가선거구,6290401,2904,북구,중흥2동,계,7038,2533,865,414,519,289,314,2401,132,4505
2900,광주광역시,북구가선거구,6290401,2904,북구,중흥2동,관내사전투표,1108,1107,398,172,236,120,143,1069,38,1
2900,광주광역시,북구가선거구,6290401,2904,북구,중흥2동,선거일투표,5930,1426,467,242,283,169,171,1332,94,4504
2900,광주광역시,북구가선거구,6290401,2904,북구,중흥3동,계,4957,1502,524,333,268,157,159,1441,61,3455
2900,광주광역시,북구가선거구,6290401,2904,북구,중흥3동,관내사전투표,689,689,259,161,124,62,58,664,25,0
2900,광주광역시,북구가선거구,6290401,2904,북구,중흥3동,선거일투표,4268,813,265,172,144,95,101,777,36,3455
2900,광주광역시,북구가선거구,6290401,2904,북구,중앙동,계,3454,1028,396,148,105,191,145,985,43,2426
2900,광주광역시,북구가선거구,6290401,2904,북구,중앙동,관내사전투표,481,481,198,60,48,92,73,471,10,0
2900,광주광역시,북구가선거구,6290401,2904,북구,중앙동,선거일투표,2973,547,198,88,57,99,72,514,33,2426
2900,광주광역시,북구가선거구,6290401,2904,북구,임동,계,7577,2874,1014,419,453,174,714,2774,100,4703
2900,광주광역시,북구가선거구,6290401,2904,북구,임동,관내사전투표,1246,1246,449,189,210,59,304,1211,35,0
2900,광주광역시,북구가선거구,6290401,2904,북구,임동,선거일투표,6331,1628,565,230,243,115,410,1563,65,4703
2900,광주광역시,북구가선거구,6290401,2904,북구,신안동,계,10410,2954,1233,420,364,233,559,2809,145,7456
2900,광주광역시,북구가선거구,6290401,2904,북구,신안동,관내사전투표,1156,1153,490,151,160,74,230,1105,48,3
2900,광주광역시,북구가선거구,6290401,2904,북구,신안동,선거일투표,9254,1801,743,269,204,159,329,1704,97,7453
2900,광주광역시,북구가선거구,6290401,2904,북구,잘못 투입·구분된 투표지,,0,11,4,1,0,1,3,9,2,-11
2900,광주광역시,북구나선거구,6290402,2904,북구,합계,,57089,21798,8398,3443,4862,2975,634,316,346,20974,824,35291
2900,광주광역시,북구나선거구,6290402,2904,북구,거소투표,,73,71,36,13,13,3,2,1,0,68,3,2
2900,광주광역시,북구나선거구,6290402,2904,북구,관외사전투표,,2808,2806,1182,451,471,369,123,41,53,2690,116,2
2900,광주광역시,북구나선거구,6290402,2904,북구,우산동,계,8980,3204,1342,739,454,325,93,44,64,3061,143,5776
2900,광주광역시,북구나선거구,6290402,2904,북구,우산동,관내사전투표,1589,1588,614,409,253,150,35,22,35,1518,70,1
2900,광주광역시,북구나선거구,6290402,2904,북구,우산동,선거일투표,7391,1616,728,330,201,175,58,22,29,1543,73,5775
2900,광주광역시,북구나선거구,6290402,2904,북구,문흥1동,계,12754,4964,1509,718,1633,711,107,68,62,4808,156,7790
2900,광주광역시,북구나선거구,6290402,2904,북구,문흥1동,관내사전투표,2330,2329,731,343,793,301,47,24,28,2267,62,1
2900,광주광역시,북구나선거구,6290402,2904,북구,문흥1동,선거일투표,10424,2635,778,375,840,410,60,44,34,2541,94,7789
2900,광주광역시,북구나선거구,6290402,2904,북구,문흥2동,계,12694,4367,1468,692,1165,683,90,45,63,4206,161,8327
2900,광주광역시,북구나선거구,6290402,2904,북구,문흥2동,관내사전투표,1808,1808,604,302,542,249,21,10,19,1747,61,0
2900,광주광역시,북구나선거구,6290402,2904,북구,문흥2동,선거일투표,10886,2559,864,390,623,434,69,35,44,2459,100,8327
2900,광주광역시,북구나선거구,6290402,2904,북구,오치1동,계,8875,2668,1105,362,513,371,94,55,56,2556,112,6207
2900,광주광역시,북구나선거구,6290402,2904,북구,오치1동,관내사전투표,1026,1025,409,155,218,152,21,13,18,986,39,1
2900,광주광역시,북구나선거구,6290402,2904,북구,오치1동,선거일투표,7849,1643,696,207,295,219,73,42,38,1570,73,6206
2900,광주광역시,북구나선거구,6290402,2904,북구,오치2동,계,10905,3717,1755,468,613,513,125,62,48,3584,133,7188
2900,광주광역시,북구나선거구,6290402,2904,북구,오치2동,관내사전투표,1683,1683,788,236,280,235,47,21,24,1631,52,0
2900,광주광역시,북구나선거구,6290402,2904,북구,오치2동,선거일투표,9222,2034,967,232,333,278,78,41,24,1953,81,7188
2900,광주광역시,북구나선거구,6290402,2904,북구,잘못 투입·구분된 투표지,,0,1,1,0,0,0,0,0,0,1,0,-1
2900,광주광역시,북구다선거구,6290403,2904,북구,합계,,58321,23021,6902,4680,4011,2000,4549,22142,879,35300
2900,광주광역시,북구다선거구,6290403,2904,북구,거소투표,,120,105,32,18,17,11,13,91,14,15
2900,광주광역시,북구다선거구,6290403,2904,북구,관외사전투표,,3370,3370,1129,617,627,429,464,3266,104,0
2900,광주광역시,북구다선거구,6290403,2904,북구,풍향동,계,4397,1514,478,274,174,168,356,1450,64,2883
2900,광주광역시,북구다선거구,6290403,2904,북구,풍향동,관내사전투표,669,669,207,136,70,61,167,641,28,0
2900,광주광역시,북구다선거구,6290403,2904,북구,풍향동,선거일투표,3728,845,271,138,104,107,189,809,36,2883
2900,광주광역시,북구다선거구,6290403,2904,북구,문화동,계,16468,5663,1588,1026,1563,499,748,5424,239,10805
2900,광주광역시,북구다선거구,6290403,2904,북구,문화동,관내사전투표,2100,2097,608,388,560,144,291,1991,106,3
2900,광주광역시,북구다선거구,6290403,2904,북구,문화동,선거일투표,14368,3566,980,638,1003,355,457,3433,133,10802
2900,광주광역시,북구다선거구,6290403,2904,북구,두암1동,계,6696,2468,804,484,338,184,570,2380,88,4228
2900,광주광역시,북구다선거구,6290403,2904,북구,두암1동,관내사전투표,1143,1143,337,222,166,80,294,1099,44,0
2900,광주광역시,북구다선거구,6290403,2904,북구,두암1동,선거일투표,5553,1325,467,262,172,104,276,1281,44,4228
2900,광주광역시,북구다선거구,6290403,2904,북구,두암2동,계,13411,4505,1381,947,717,361,953,4359,146,8906
2900,광주광역시,북구다선거구,6290403,2904,북구,두암2동,관내사전투표,1942,1942,620,415,306,122,432,1895,47,0
2900,광주광역시,북구다선거구,6290403,2904,북구,두암2동,선거일투표,11469,2563,761,532,411,239,521,2464,99,8906
2900,광주광역시,북구다선거구,6290403,2904,북구,두암3동,계,11699,4449,1236,1098,441,298,1188,4261,188,7250
2900,광주광역시,북구다선거구,6290403,2904,북구,두암3동,관내사전투표,2125,2124,588,541,214,126,559,2028,96,1
2900,광주광역시,북구다선거구,6290403,2904,북구,두암3동,선거일투표,9574,2325,648,557,227,172,629,2233,92,7249
2900,광주광역시,북구다선거구,6290403,2904,북구,석곡동,계,2160,942,252,215,133,50,257,907,35,1218
2900,광주광역시,북구다선거구,6290403,2904,북구,석곡동,관내사전투표,435,435,111,94,72,15,126,418,17,0
2900,광주광역시,북구다선거구,6290403,2904,북구,석곡동,선거일투표,1725,507,141,121,61,35,131,489,18,1218
2900,광주광역시,북구다선거구,6290403,2904,북구,잘못 투입·구분된 투표지,,0,5,2,1,1,0,0,4,1,-5
2900,광주광역시,북구라선거구,6290404,2904,북구,합계,,80352,31087,11734,6790,3906,3580,4140,30150,937,49265
2900,광주광역시,북구라선거구,6290404,2904,북구,거소투표,,110,102,40,20,12,11,9,92,10,8
2900,광주광역시,북구라선거구,6290404,2904,북구,관외사전투표,,4743,4742,1748,1075,569,650,554,4596,146,1
2900,광주광역시,북구라선거구,6290404,2904,북구,용봉동,계,29970,9304,3737,1497,1620,1158,961,8973,331,20666
2900,광주광역시,북구라선거구,6290404,2904,북구,용봉동,관내사전투표,2002,2001,812,341,332,233,225,1943,58,1
2900,광주광역시,북구라선거구,6290404,2904,북구,용봉동,선거일투표,27968,7303,2925,1156,1288,925,736,7030,273,20665
2900,광주광역시,북구라선거구,6290404,2904,북구,삼각동,계,11243,3739,1416,814,396,359,631,3616,123,7504
2900,광주광역시,북구라선거구,6290404,2904,북구,삼각동,관내사전투표,1530,1522,552,345,183,146,266,1492,30,8
2900,광주광역시,북구라선거구,6290404,2904,북구,삼각동,선거일투표,9713,2217,864,469,213,213,365,2124,93,7496
2900,광주광역시,북구라선거구,6290404,2904,북구,일곡동,계,22735,8372,2949,2312,712,930,1239,8142,230,14363
2900,광주광역시,북구라선거구,6290404,2904,북구,일곡동,관내사전투표,3394,3368,1279,965,274,330,462,3310,58,26
2900,광주광역시,북구라선거구,6290404,2904,북구,일곡동,선거일투표,19341,5004,1670,1347,438,600,777,4832,172,14337
2900,광주광역시,북구라선거구,6290404,2904,북구,매곡동,계,11551,4787,1834,1060,591,469,738,4692,95,6764
2900,광주광역시,북구라선거구,6290404,2904,북구,매곡동,관내사전투표,2561,2556,935,575,380,218,413,2521,35,5
2900,광주광역시,북구라선거구,6290404,2904,북구,매곡동,선거일투표,8990,2231,899,485,211,251,325,2171,60,6759
2900,광주광역시,북구라선거구,6290404,2904,북구,잘못 투입·구분된 투표지,,0,41,10,12,6,3,8,39,2,-41
2900,광주광역시,북구마선거구,6290405,2904,북구,합계,,56619,22977,6136,4766,4387,2931,3960,22180,797,33642
2900,광주광역시,북구마선거구,6290405,2904,북구,거소투표,,90,83,30,24,8,2,15,79,4,7
2900,광주광역시,북구마선거구,6290405,2904,북구,관외사전투표,,3132,3128,1037,695,464,366,439,3001,127,4
2900,광주광역시,북구마선거구,6290405,2904,북구,운암1동,계,15103,6356,1301,1281,1415,824,1336,6157,199,8747
2900,광주광역시,북구마선거구,6290405,2904,북구,운암1동,관내사전투표,2470,2467,452,495,616,273,568,2404,63,3
2900,광주광역시,북구마선거구,6290405,2904,북구,운암1동,선거일투표,12633,3889,849,786,799,551,768,3753,136,8744
2900,광주광역시,북구마선거구,6290405,2904,북구,운암2동,계,10154,3406,975,539,838,410,518,3280,126,6748
2900,광주광역시,북구마선거구,6290405,2904,북구,운암2동,관내사전투표,1646,1644,459,251,454,185,243,1592,52,2
2900,광주광역시,북구마선거구,6290405,2904,북구,운암2동,선거일투표,8508,1762,516,288,384,225,275,1688,74,6746
2900,광주광역시,북구마선거구,6290405,2904,북구,운암3동,계,10130,3875,911,1034,614,564,614,3737,138,6255
2900,광주광역시,북구마선거구,6290405,2904,북구,운암3동,관내사전투표,1997,1997,461,541,350,288,284,1924,73,0
2900,광주광역시,북구마선거구,6290405,2904,북구,운암3동,선거일투표,8133,1878,450,493,264,276,330,1813,65,6255
2900,광주광역시,북구마선거구,6290405,2904,북구,동림동,계,18010,6115,1879,1192,1045,763,1037,5916,199,11895
2900,광주광역시,북구마선거구,6290405,2904,북구,동림동,관내사전투표,1802,1802,538,353,342,201,322,1756,46,0
2900,광주광역시,북구마선거구,6290405,2904,북구,동림동,선거일투표,16208,4313,1341,839,703,562,715,4160,153,11895
2900,광주광역시,북구마선거구,6290405,2904,북구,잘못 투입·구분된 투표지,,0,14,3,1,3,2,1,10,4,-14
2900,광주광역시,북구바선거구,6290406,2904,북구,합계,,70669,24148,7037,4771,3311,2512,1806,2036,2004,23477,671,46521
2900,광주광역시,북구바선거구,6290406,2904,북구,거소투표,,104,92,26,23,8,13,5,3,6,84,8,12
2900,광주광역시,북구바선거구,6290406,2904,북구,관외사전투표,,3520,3519,1116,711,494,417,275,176,206,3395,124,1
2900,광주광역시,북구바선거구,6290406,2904,북구,건국동,계,16529,5231,1417,836,644,550,390,739,518,5094,137,11298
2900,광주광역시,북구바선거구,6290406,2904,북구,건국동,관내사전투표,1968,1968,529,321,232,183,153,294,197,1909,59,0
2900,광주광역시,북구바선거구,6290406,2904,북구,건국동,선거일투표,14561,3263,888,515,412,367,237,445,321,3185,78,11298
2900,광주광역시,북구바선거구,6290406,2904,북구,양산동,계,29577,9150,2690,1721,1392,902,663,733,785,8886,264,20427
2900,광주광역시,북구바선거구,6290406,2904,북구,양산동,관내사전투표,3020,3019,895,511,528,228,211,241,318,2932,87,1
2900,광주광역시,북구바선거구,6290406,2904,북구,양산동,선거일투표,26557,6131,1795,1210,864,674,452,492,467,5954,177,20426
2900,광주광역시,북구바선거구,6290406,2904,북구,신용동,계,20939,6155,1787,1480,773,630,473,385,489,6017,138,14784
2900,광주광역시,북구바선거구,6290406,2904,북구,신용동,관내사전투표,1579,1579,463,393,218,156,101,98,117,1546,33,0
2900,광주광역시,북구바선거구,6290406,2904,북구,신용동,선거일투표,19360,4576,1324,1087,555,474,372,287,372,4471,105,14784
2900,광주광역시,북구바선거구,6290406,2904,북구,잘못 투입·구분된 투표지,,0,1,1,0,0,0,0,0,0,1,0,-1
2900,광주광역시,광산구가선거구,6290501,2905,광산구,합계,,63644,23315,5343,2848,2671,1197,1698,6200,2585,22542,773,40329
2900,광주광역시,광산구가선거구,6290501,2905,광산구,거소투표,,82,77,25,13,6,2,6,12,5,69,8,5
2900,광주광역시,광산구가선거구,6290501,2905,광산구,관외사전투표,,2644,2643,756,348,319,152,317,468,216,2576,67,1
2900,광주광역시,광산구가선거구,6290501,2905,광산구,송정1동,계,9133,3447,758,390,252,133,179,1215,433,3360,87,5686
2900,광주광역시,광산구가선거구,6290501,2905,광산구,송정1동,관내사전투표,1323,1323,317,163,106,51,74,391,188,1290,33,0
2900,광주광역시,광산구가선거구,6290501,2905,광산구,송정1동,선거일투표,7810,2124,441,227,146,82,105,824,245,2070,54,5686
2900,광주광역시,광산구가선거구,6290501,2905,광산구,송정2동,계,5841,2042,465,228,217,96,157,469,337,1969,73,3799
2900,광주광역시,광산구가선거구,6290501,2905,광산구,송정2동,관내사전투표,912,911,193,96,112,45,72,200,165,883,28,1
2900,광주광역시,광산구가선거구,6290501,2905,광산구,송정2동,선거일투표,4929,1131,272,132,105,51,85,269,172,1086,45,3798
2900,광주광역시,광산구가선거구,6290501,2905,광산구,도산동,계,12318,4363,837,422,325,186,285,1618,557,4230,133,7955
2900,광주광역시,광산구가선거구,6290501,2905,광산구,도산동,관내사전투표,1772,1772,365,162,139,74,91,630,260,1721,51,0
2900,광주광역시,광산구가선거구,6290501,2905,광산구,도산동,선거일투표,10546,2591,472,260,186,112,194,988,297,2509,82,7955
2900,광주광역시,광산구가선거구,6290501,2905,광산구,어룡동,계,24491,7166,1632,1113,1254,387,551,1450,592,6979,187,17325
2900,광주광역시,광산구가선거구,6290501,2905,광산구,어룡동,관내사전투표,2010,2010,408,280,377,108,123,489,188,1973,37,0
2900,광주광역시,광산구가선거구,6290501,2905,광산구,어룡동,선거일투표,22481,5156,1224,833,877,279,428,961,404,5006,150,17325
2900,광주광역시,광산구가선거구,6290501,2905,광산구,동곡동,계,1700,778,174,65,63,116,51,201,79,749,29,922
2900,광주광역시,광산구가선거구,6290501,2905,광산구,동곡동,관내사전투표,368,368,79,25,31,62,26,87,47,357,11,0
2900,광주광역시,광산구가선거구,6290501,2905,광산구,동곡동,선거일투표,1332,410,95,40,32,54,25,114,32,392,18,922
2900,광주광역시,광산구가선거구,6290501,2905,광산구,평동,계,3719,1260,271,107,90,49,70,467,149,1203,57,2459
2900,광주광역시,광산구가선거구,6290501,2905,광산구,평동,관내사전투표,627,627,122,51,47,24,37,238,77,596,31,0
2900,광주광역시,광산구가선거구,6290501,2905,광산구,평동,선거일투표,3092,633,149,56,43,25,33,229,72,607,26,2459
2900,광주광역시,광산구가선거구,6290501,2905,광산구,삼도동,계,1982,830,224,99,67,44,43,154,113,744,86,1152
2900,광주광역시,광산구가선거구,6290501,2905,광산구,삼도동,관내사전투표,396,396,109,46,32,20,18,58,49,332,64,0
2900,광주광역시,광산구가선거구,6290501,2905,광산구,삼도동,선거일투표,1586,434,115,53,35,24,25,96,64,412,22,1152
2900,광주광역시,광산구가선거구,6290501,2905,광산구,본량동,계,1734,707,201,62,77,32,39,146,104,661,46,1027
2900,광주광역시,광산구가선거구,6290501,2905,광산구,본량동,관내사전투표,318,318,82,32,39,13,14,73,46,299,19,0
2900,광주광역시,광산구가선거구,6290501,2905,광산구,본량동,선거일투표,1416,389,119,30,38,19,25,73,58,362,27,1027
2900,광주광역시,광산구가선거구,6290501,2905,광산구,잘못 투입·구분된 투표지,,0,2,0,1,1,0,0,0,0,2,0,-2
2900,광주광역시,광산구나선거구,6290502,2905,광산구,합계,,77143,26506,9396,4876,4461,1883,3817,1133,25566,940,50637
2900,광주광역시,광산구나선거구,6290502,2905,광산구,거소투표,,106,94,38,20,6,7,6,6,83,11,12
2900,광주광역시,광산구나선거구,6290502,2905,광산구,관외사전투표,,3295,3295,1260,639,482,218,346,199,3144,151,0
2900,광주광역시,광산구나선거구,6290502,2905,광산구,신흥동,계,3648,1202,451,223,174,82,173,56,1159,43,2446
2900,광주광역시,광산구나선거구,6290502,2905,광산구,신흥동,관내사전투표,434,434,155,85,68,30,55,26,419,15,0
2900,광주광역시,광산구나선거구,6290502,2905,광산구,신흥동,선거일투표,3214,768,296,138,106,52,118,30,740,28,2446
2900,광주광역시,광산구나선거구,6290502,2905,광산구,우산동,계,24400,7093,2730,1556,868,559,820,279,6812,281,17307
2900,광주광역시,광산구나선거구,6290502,2905,광산구,우산동,관내사전투표,1928,1928,714,472,250,149,209,73,1867,61,0
2900,광주광역시,광산구나선거구,6290502,2905,광산구,우산동,선거일투표,22472,5165,2016,1084,618,410,611,206,4945,220,17307
2900,광주광역시,광산구나선거구,6290502,2905,광산구,월곡1동,계,9495,3275,1045,699,494,240,579,122,3179,96,6220
2900,광주광역시,광산구나선거구,6290502,2905,광산구,월곡1동,관내사전투표,1357,1357,453,260,230,101,240,39,1323,34,0
2900,광주광역시,광산구나선거구,6290502,2905,광산구,월곡1동,선거일투표,8138,1918,592,439,264,139,339,83,1856,62,6220
2900,광주광역시,광산구나선거구,6290502,2905,광산구,월곡2동,계,12112,3540,1202,673,564,239,605,144,3427,113,8572
2900,광주광역시,광산구나선거구,6290502,2905,광산구,월곡2동,관내사전투표,1079,1079,354,227,173,67,191,40,1052,27,0
2900,광주광역시,광산구나선거구,6290502,2905,광산구,월곡2동,선거일투표,11033,2461,848,446,391,172,414,104,2375,86,8572
2900,광주광역시,광산구나선거구,6290502,2905,광산구,운남동,계,24087,8007,2670,1066,1873,538,1288,327,7762,245,16080
2900,광주광역시,광산구나선거구,6290502,2905,광산구,운남동,관내사전투표,2406,2406,738,321,634,167,385,92,2337,69,0
2900,광주광역시,광산구나선거구,6290502,2905,광산구,운남동,선거일투표,21681,5601,1932,745,1239,371,903,235,5425,176,16080
2900,광주광역시,광산구나선거구,6290502,2905,광산구,잘못 투입·구분된 투표지,,0,0,0,0,0,0,0,0,0,0,0
2900,광주광역시,광산구다선거구,6290503,2905,광산구,합계,,58611,19383,6828,2887,2580,2801,3387,18483,900,39228
2900,광주광역시,광산구다선거구,6290503,2905,광산구,거소투표,,77,73,35,8,9,9,4,65,8,4
2900,광주광역시,광산구다선거구,6290503,2905,광산구,관외사전투표,,2832,2825,1190,413,351,348,359,2661,164,7
2900,광주광역시,광산구다선거구,6290503,2905,광산구,첨단1동,계,22211,7145,2459,1087,1014,1037,1233,6830,315,15066
2900,광주광역시,광산구다선거구,6290503,2905,광산구,첨단1동,관내사전투표,2641,2636,926,419,358,373,449,2525,111,5
2900,광주광역시,광산구다선거구,6290503,2905,광산구,첨단1동,선거일투표,19570,4509,1533,668,656,664,784,4305,204,15061
2900,광주광역시,광산구다선거구,6290503,2905,광산구,첨단2동,계,33491,9321,3140,1376,1202,1405,1787,8910,411,24170
2900,광주광역시,광산구다선거구,6290503,2905,광산구,첨단2동,관내사전투표,2010,2002,681,301,291,281,371,1925,77,8
2900,광주광역시,광산구다선거구,6290503,2905,광산구,첨단2동,선거일투표,31481,7319,2459,1075,911,1124,1416,6985,334,24162
2900,광주광역시,광산구다선거구,6290503,2905,광산구,잘못 투입·구분된 투표지,,0,19,4,3,4,2,4,17,2,-19
2900,광주광역시,광산구라선거구,6290504,2905,광산구,합계,,47887,15433,5509,2796,3006,3463,14774,659,32454
2900,광주광역시,광산구라선거구,6290504,2905,광산구,거소투표,,66,59,36,10,5,2,53,6,7
2900,광주광역시,광산구라선거구,6290504,2905,광산구,관외사전투표,,2101,2095,838,397,336,396,1967,128,6
2900,광주광역시,광산구라선거구,6290504,2905,광산구,비아동,계,5972,1502,661,261,235,271,1428,74,4470
2900,광주광역시,광산구라선거구,6290504,2905,광산구,비아동,관내사전투표,627,627,304,95,85,115,599,28,0
2900,광주광역시,광산구라선거구,6290504,2905,광산구,비아동,선거일투표,5345,875,357,166,150,156,829,46,4470
2900,광주광역시,광산구라선거구,6290504,2905,광산구,신가동,계,13675,4170,1503,800,898,795,3996,174,9505
2900,광주광역시,광산구라선거구,6290504,2905,광산구,신가동,관내사전투표,1327,1323,468,287,264,251,1270,53,4
2900,광주광역시,광산구라선거구,6290504,2905,광산구,신가동,선거일투표,12348,2847,1035,513,634,544,2726,121,9501
2900,광주광역시,광산구라선거구,6290504,2905,광산구,신창동,계,26073,7586,2463,1327,1525,1994,7309,277,18487
2900,광주광역시,광산구라선거구,6290504,2905,광산구,신창동,관내사전투표,2555,2549,810,464,557,623,2454,95,6
2900,광주광역시,광산구라선거구,6290504,2905,광산구,신창동,선거일투표,23518,5037,1653,863,968,1371,4855,182,18481
2900,광주광역시,광산구라선거구,6290504,2905,광산구,잘못 투입·구분된 투표지,,0,21,8,1,7,5,21,0,-21
2900,광주광역시,광산구마선거구,6290505,2905,광산구,합계,,79125,24186,10259,5180,1981,3798,2024,23242,944,54939
2900,광주광역시,광산구마선거구,6290505,2905,광산구,거소투표,,93,84,38,22,7,6,6,79,5,9
2900,광주광역시,광산구마선거구,6290505,2905,광산구,관외사전투표,,3950,3947,1783,807,270,587,324,3771,176,3
2900,광주광역시,광산구마선거구,6290505,2905,광산구,수완동,계,53663,14553,5440,3514,1286,2465,1290,13995,558,39110
2900,광주광역시,광산구마선거구,6290505,2905,광산구,수완동,관내사전투표,3311,3307,1140,944,335,523,273,3215,92,4
2900,광주광역시,광산구마선거구,6290505,2905,광산구,수완동,선거일투표,50352,11246,4300,2570,951,1942,1017,10780,466,39106
2900,광주광역시,광산구마선거구,6290505,2905,광산구,하남동,계,19543,4937,2673,761,328,657,357,4776,161,14606
2900,광주광역시,광산구마선거구,6290505,2905,광산구,하남동,관내사전투표,1719,1718,936,299,108,208,115,1666,52,1
2900,광주광역시,광산구마선거구,6290505,2905,광산구,하남동,선거일투표,17824,3219,1737,462,220,449,242,3110,109,14605
2900,광주광역시,광산구마선거구,6290505,2905,광산구,임곡동,계,1876,656,321,74,89,82,46,612,44,1220
2900,광주광역시,광산구마선거구,6290505,2905,광산구,임곡동,관내사전투표,376,373,187,40,53,45,24,349,24,3
2900,광주광역시,광산구마선거구,6290505,2905,광산구,임곡동,선거일투표,1500,283,134,34,36,37,22,263,20,1217
2900,광주광역시,광산구마선거구,6290505,2905,광산구,잘못 투입·구분된 투표지,,0,9,4,2,1,1,1,9,0,-93000,대전광역시,동구가선거구,6300101,3001,동구,합계,,73365,36828,11798,3611,2483,11798,4563,34253,2575,36537
3000,대전광역시,동구가선거구,6300101,3001,동구,거소투표,,98,88,32,6,5,23,14,80,8,10
3000,대전광역시,동구가선거구,6300101,3001,동구,관외사전투표,,4213,4209,1532,412,317,1231,422,3914,295,4
3000,대전광역시,동구가선거구,6300101,3001,동구,중앙동,계,3983,1863,435,152,198,735,186,1706,157,2120
3000,대전광역시,동구가선거구,6300101,3001,동구,중앙동,관내사전투표,694,693,182,48,102,242,60,634,59,1
3000,대전광역시,동구가선거구,6300101,3001,동구,중앙동,선거일투표,3289,1170,253,104,96,493,126,1072,98,2119
3000,대전광역시,동구가선거구,6300101,3001,동구,신인동,계,11082,5966,1832,602,413,1914,769,5530,436,5116
3000,대전광역시,동구가선거구,6300101,3001,동구,신인동,관내사전투표,2535,2535,820,260,165,790,306,2341,194,0
3000,대전광역시,동구가선거구,6300101,3001,동구,신인동,선거일투표,8547,3431,1012,342,248,1124,463,3189,242,5116
3000,대전광역시,동구가선거구,6300101,3001,동구,효동,계,17912,8187,2904,812,490,2264,1204,7674,513,9725
3000,대전광역시,동구가선거구,6300101,3001,동구,효동,관내사전투표,2659,2656,1009,299,185,686,322,2501,155,3
3000,대전광역시,동구가선거구,6300101,3001,동구,효동,선거일투표,15253,5531,1895,513,305,1578,882,5173,358,9722
3000,대전광역시,동구가선거구,6300101,3001,동구,홍도동,계,9410,3977,1223,361,263,1512,353,3712,265,5433
3000,대전광역시,동구가선거구,6300101,3001,동구,홍도동,관내사전투표,1513,1511,506,134,95,538,129,1402,109,2
3000,대전광역시,동구가선거구,6300101,3001,동구,홍도동,선거일투표,7897,2466,717,227,168,974,224,2310,156,5431
3000,대전광역시,동구가선거구,6300101,3001,동구,삼성동,계,11337,5628,1690,444,316,2232,568,5250,378,5709
3000,대전광역시,동구가선거구,6300101,3001,동구,삼성동,관내사전투표,1778,1775,562,139,97,694,153,1645,130,3
3000,대전광역시,동구가선거구,6300101,3001,동구,삼성동,선거일투표,9559,3853,1128,305,219,1538,415,3605,248,5706
3000,대전광역시,동구가선거구,6300101,3001,동구,산내동,계,15330,6901,2148,821,480,1884,1046,6379,522,8429
3000,대전광역시,동구가선거구,6300101,3001,동구,산내동,관내사전투표,2085,2084,637,275,153,547,302,1914,170,1
3000,대전광역시,동구가선거구,6300101,3001,동구,산내동,선거일투표,13245,4817,1511,546,327,1337,744,4465,352,8428
3000,대전광역시,동구가선거구,6300101,3001,동구,잘못 투입·구분된 투표지,,0,9,2,1,1,3,1,8,1,-9
3000,대전광역시,동구나선거구,6300102,3001,동구,합계,,62144,31357,8955,4648,10616,4043,28262,3095,30787
3000,대전광역시,동구나선거구,6300102,3001,동구,거소투표,,111,107,26,14,31,22,93,14,4
3000,대전광역시,동구나선거구,6300102,3001,동구,관외사전투표,,3142,3138,946,598,1002,300,2846,292,4
3000,대전광역시,동구나선거구,6300102,3001,동구,판암1동,계,9999,4990,1485,748,1726,564,4523,467,5009
3000,대전광역시,동구나선거구,6300102,3001,동구,판암1동,관내사전투표,1877,1863,557,255,668,193,1673,190,14
3000,대전광역시,동구나선거구,6300102,3001,동구,판암1동,선거일투표,8122,3127,928,493,1058,371,2850,277,4995
3000,대전광역시,동구나선거구,6300102,3001,동구,판암2동,계,7964,4061,1118,540,1434,464,3556,505,3903
3000,대전광역시,동구나선거구,6300102,3001,동구,판암2동,관내사전투표,1885,1884,549,235,623,215,1622,262,1
3000,대전광역시,동구나선거구,6300102,3001,동구,판암2동,선거일투표,6079,2177,569,305,811,249,1934,243,3902
3000,대전광역시,동구나선거구,6300102,3001,동구,용운동,계,17673,8353,2521,1269,2784,971,7545,808,9320
3000,대전광역시,동구나선거구,6300102,3001,동구,용운동,관내사전투표,2830,2826,905,380,900,318,2503,323,4
3000,대전광역시,동구나선거구,6300102,3001,동구,용운동,선거일투표,14843,5527,1616,889,1884,653,5042,485,9316
3000,대전광역시,동구나선거구,6300102,3001,동구,대동,계,11477,5677,1558,831,1732,1014,5135,542,5800
3000,대전광역시,동구나선거구,6300102,3001,동구,대동,관내사전투표,2291,2285,633,359,598,469,2059,226,6
3000,대전광역시,동구나선거구,6300102,3001,동구,대동,선거일투표,9186,3392,925,472,1134,545,3076,316,5794
3000,대전광역시,동구나선거구,6300102,3001,동구,자양동,계,9732,3870,1063,518,1449,497,3527,343,5862
3000,대전광역시,동구나선거구,6300102,3001,동구,자양동,관내사전투표,1551,1548,437,234,532,201,1404,144,3
3000,대전광역시,동구나선거구,6300102,3001,동구,자양동,선거일투표,8181,2322,626,284,917,296,2123,199,5859
3000,대전광역시,동구나선거구,6300102,3001,동구,대청동,계,2046,1128,224,129,450,205,1008,120,918
3000,대전광역시,동구나선거구,6300102,3001,동구,대청동,관내사전투표,362,362,87,40,130,62,319,43,0
3000,대전광역시,동구나선거구,6300102,3001,동구,대청동,선거일투표,1684,766,137,89,320,143,689,77,918
3000,대전광역시,동구나선거구,6300102,3001,동구,잘못 투입·구분된 투표지,,0,33,14,1,8,6,29,4,-33
3000,대전광역시,동구다선거구,6300103,3001,동구,검색된 결과가 없습니다.
3000,대전광역시,중구가선거구,6300201,3002,중구,합계,,55551,25625,6872,4930,7710,3454,22966,2659,29926
3000,대전광역시,중구가선거구,6300201,3002,중구,거소투표,,76,60,25,8,14,5,52,8,16
3000,대전광역시,중구가선거구,6300201,3002,중구,관외사전투표,,2987,2984,1034,486,854,302,2676,308,3
3000,대전광역시,중구가선거구,6300201,3002,중구,은행선화동,계,12906,4884,1502,676,1640,567,4385,499,8022
3000,대전광역시,중구가선거구,6300201,3002,중구,은행선화동,관내사전투표,1530,1529,518,229,456,146,1349,180,1
3000,대전광역시,중구가선거구,6300201,3002,중구,은행선화동,선거일투표,11376,3355,984,447,1184,421,3036,319,8021
3000,대전광역시,중구가선거구,6300201,3002,중구,대흥동,계,11312,4739,1386,847,1512,487,4232,507,6573
3000,대전광역시,중구가선거구,6300201,3002,중구,대흥동,관내사전투표,1617,1617,527,280,457,154,1418,199,0
3000,대전광역시,중구가선거구,6300201,3002,중구,대흥동,선거일투표,9695,3122,859,567,1055,333,2814,308,6573
3000,대전광역시,중구가선거구,6300201,3002,중구,문창동,계,4172,1997,467,449,591,283,1790,207,2175
3000,대전광역시,중구가선거구,6300201,3002,중구,문창동,관내사전투표,675,675,170,147,192,75,584,91,0
3000,대전광역시,중구가선거구,6300201,3002,중구,문창동,선거일투표,3497,1322,297,302,399,208,1206,116,2175
3000,대전광역시,중구가선거구,6300201,3002,중구,석교동,계,13410,6091,1347,1304,1632,1174,5457,634,7319
3000,대전광역시,중구가선거구,6300201,3002,중구,석교동,관내사전투표,1889,1887,450,378,458,331,1617,270,2
3000,대전광역시,중구가선거구,6300201,3002,중구,석교동,선거일투표,11521,4204,897,926,1174,843,3840,364,7317
3000,대전광역시,중구가선거구,6300201,3002,중구,대사동,계,4916,2201,541,398,741,277,1957,244,2715
3000,대전광역시,중구가선거구,6300201,3002,중구,대사동,관내사전투표,903,898,219,184,276,97,776,122,5
3000,대전광역시,중구가선거구,6300201,3002,중구,대사동,선거일투표,4013,1303,322,214,465,180,1181,122,2710
3000,대전광역시,중구가선거구,6300201,3002,중구,부사동,계,5772,2655,567,760,723,356,2406,249,3117
3000,대전광역시,중구가선거구,6300201,3002,중구,부사동,관내사전투표,942,942,189,278,248,111,826,116,0
3000,대전광역시,중구가선거구,6300201,3002,중구,부사동,선거일투표,4830,1713,378,482,475,245,1580,133,3117
3000,대전광역시,중구가선거구,6300201,3002,중구,잘못 투입·구분된 투표지,,0,14,3,2,3,3,11,3,-14
3000,대전광역시,중구나선거구,6300202,3002,중구,합계,,73102,39295,12867,5411,10206,7901,36385,2910,33807
3000,대전광역시,중구나선거구,6300202,3002,중구,거소투표,,92,84,28,10,21,19,78,6,8
3000,대전광역시,중구나선거구,6300202,3002,중구,관외사전투표,,4222,4222,1518,603,971,777,3869,353,0
3000,대전광역시,중구나선거구,6300202,3002,중구,목동,계,10354,5342,1878,878,948,1265,4969,373,5012
3000,대전광역시,중구나선거구,6300202,3002,중구,목동,관내사전투표,2023,2022,720,344,329,458,1851,171,1
3000,대전광역시,중구나선거구,6300202,3002,중구,목동,선거일투표,8331,3320,1158,534,619,807,3118,202,5011
3000,대전광역시,중구나선거구,6300202,3002,중구,중촌동,계,11436,5585,1650,916,1139,1413,5118,467,5851
3000,대전광역시,중구나선거구,6300202,3002,중구,중촌동,관내사전투표,1536,1534,426,243,305,399,1373,161,2
3000,대전광역시,중구나선거구,6300202,3002,중구,중촌동,선거일투표,9900,4051,1224,673,834,1014,3745,306,5849
3000,대전광역시,중구나선거구,6300202,3002,중구,용두동,계,8059,3873,1159,705,886,828,3578,295,4186
3000,대전광역시,중구나선거구,6300202,3002,중구,용두동,관내사전투표,1506,1505,454,301,331,292,1378,127,1
3000,대전광역시,중구나선거구,6300202,3002,중구,용두동,선거일투표,6553,2368,705,404,555,536,2200,168,4185
3000,대전광역시,중구나선거구,6300202,3002,중구,오류동,계,8928,4524,1422,530,1360,888,4200,324,4404
3000,대전광역시,중구나선거구,6300202,3002,중구,오류동,관내사전투표,1704,1704,535,211,502,305,1553,151,0
3000,대전광역시,중구나선거구,6300202,3002,중구,오류동,선거일투표,7224,2820,887,319,858,583,2647,173,4404
3000,대전광역시,중구나선거구,6300202,3002,중구,태평1동,계,10475,5405,2038,651,1523,850,5062,343,5070
3000,대전광역시,중구나선거구,6300202,3002,중구,태평1동,관내사전투표,1684,1671,627,203,467,248,1545,126,13
3000,대전광역시,중구나선거구,6300202,3002,중구,태평1동,선거일투표,8791,3734,1411,448,1056,602,3517,217,5057
3000,대전광역시,중구나선거구,6300202,3002,중구,태평2동,계,19536,10228,3165,1115,3351,1854,9485,743,9308
3000,대전광역시,중구나선거구,6300202,3002,중구,태평2동,관내사전투표,3120,3117,1012,364,981,485,2842,275,3
3000,대전광역시,중구나선거구,6300202,3002,중구,태평2동,선거일투표,16416,7111,2153,751,2370,1369,6643,468,9305
3000,대전광역시,중구나선거구,6300202,3002,중구,잘못 투입·구분된 투표지,,0,32,9,3,7,7,26,6,-32
3000,대전광역시,중구다선거구,6300203,3002,중구,합계,,71241,35403,10342,4791,11895,4958,31986,3417,35838
3000,대전광역시,중구다선거구,6300203,3002,중구,거소투표,,103,100,41,10,24,7,82,18,3
3000,대전광역시,중구다선거구,6300203,3002,중구,관외사전투표,,3815,3814,1283,635,1219,326,3463,351,1
3000,대전광역시,중구다선거구,6300203,3002,중구,유천1동,계,5708,2375,641,303,734,431,2109,266,3333
3000,대전광역시,중구다선거구,6300203,3002,중구,유천1동,관내사전투표,858,858,240,119,227,149,735,123,0
3000,대전광역시,중구다선거구,6300203,3002,중구,유천1동,선거일투표,4850,1517,401,184,507,282,1374,143,3333
3000,대전광역시,중구다선거구,6300203,3002,중구,유천2동,계,11411,5458,1482,735,1856,860,4933,525,5953
3000,대전광역시,중구다선거구,6300203,3002,중구,유천2동,관내사전투표,1767,1758,472,244,566,247,1529,229,9
3000,대전광역시,중구다선거구,6300203,3002,중구,유천2동,선거일투표,9644,3700,1010,491,1290,613,3404,296,5944
3000,대전광역시,중구다선거구,6300203,3002,중구,문화1동,계,16905,8713,2547,1171,2872,1361,7951,762,8192
3000,대전광역시,중구다선거구,6300203,3002,중구,문화1동,관내사전투표,2608,2607,797,353,801,393,2344,263,1
3000,대전광역시,중구다선거구,6300203,3002,중구,문화1동,선거일투표,14297,6106,1750,818,2071,968,5607,499,8191
3000,대전광역시,중구다선거구,6300203,3002,중구,문화2동,계,10732,5217,1695,617,1681,704,4697,520,5515
3000,대전광역시,중구다선거구,6300203,3002,중구,문화2동,관내사전투표,2053,2051,684,237,628,234,1783,268,2
3000,대전광역시,중구다선거구,6300203,3002,중구,문화2동,선거일투표,8679,3166,1011,380,1053,470,2914,252,5513
3000,대전광역시,중구다선거구,6300203,3002,중구,산성동,계,22567,9707,2651,1320,3504,1264,8739,968,12860
3000,대전광역시,중구다선거구,6300203,3002,중구,산성동,관내사전투표,2397,2395,665,309,829,308,2111,284,2
3000,대전광역시,중구다선거구,6300203,3002,중구,산성동,선거일투표,20170,7312,1986,1011,2675,956,6628,684,12858
3000,대전광역시,중구다선거구,6300203,3002,중구,잘못 투입·구분된 투표지,,0,19,2,0,5,5,12,7,-19
3000,대전광역시,서구가선거구,6300301,3003,서구,합계,,61124,29640,7596,5375,8848,4360,26179,3461,31484
3000,대전광역시,서구가선거구,6300301,3003,서구,거소투표,,85,79,31,15,16,11,73,6,6
3000,대전광역시,서구가선거구,6300301,3003,서구,관외사전투표,,3015,3014,840,664,788,411,2703,311,1
3000,대전광역시,서구가선거구,6300301,3003,서구,복수동,계,16777,7911,2175,1598,2423,1072,7268,643,8866
3000,대전광역시,서구가선거구,6300301,3003,서구,복수동,관내사전투표,2666,2666,759,577,823,340,2499,167,0
3000,대전광역시,서구가선거구,6300301,3003,서구,복수동,선거일투표,14111,5245,1416,1021,1600,732,4769,476,8866
3000,대전광역시,서구가선거구,6300301,3003,서구,도마1동,계,13220,5475,1313,805,1757,847,4722,753,7745
3000,대전광역시,서구가선거구,6300301,3003,서구,도마1동,관내사전투표,2164,2161,518,297,724,320,1859,302,3
3000,대전광역시,서구가선거구,6300301,3003,서구,도마1동,선거일투표,11056,3314,795,508,1033,527,2863,451,7742
3000,대전광역시,서구가선거구,6300301,3003,서구,도마2동,계,14628,6479,1649,950,2023,984,5606,873,8149
3000,대전광역시,서구가선거구,6300301,3003,서구,도마2동,관내사전투표,1833,1832,502,287,591,215,1595,237,1
3000,대전광역시,서구가선거구,6300301,3003,서구,도마2동,선거일투표,12795,4647,1147,663,1432,769,4011,636,8148
3000,대전광역시,서구가선거구,6300301,3003,서구,정림동,계,13399,6670,1584,1342,1839,1034,5799,871,6729
3000,대전광역시,서구가선거구,6300301,3003,서구,정림동,관내사전투표,2628,2625,663,567,685,382,2297,328,3
3000,대전광역시,서구가선거구,6300301,3003,서구,정림동,선거일투표,10771,4045,921,775,1154,652,3502,543,6726
3000,대전광역시,서구가선거구,6300301,3003,서구,잘못 투입·구분된 투표지,,0,12,4,1,2,1,8,4,-12
3000,대전광역시,서구나선거구,6300302,3003,서구,합계,,60965,27603,7229,4303,9240,4025,1024,25821,1782,33362
3000,대전광역시,서구나선거구,6300302,3003,서구,거소투표,,69,63,11,8,25,7,3,54,9,6
3000,대전광역시,서구나선거구,6300302,3003,서구,관외사전투표,,3693,3691,1220,603,1191,343,119,3476,215,2
3000,대전광역시,서구나선거구,6300302,3003,서구,변동,계,13226,5359,1429,697,1959,731,186,5002,357,7867
3000,대전광역시,서구나선거구,6300302,3003,서구,변동,관내사전투표,1468,1467,392,208,506,221,51,1378,89,1
3000,대전광역시,서구나선거구,6300302,3003,서구,변동,선거일투표,11758,3892,1037,489,1453,510,135,3624,268,7866
3000,대전광역시,서구나선거구,6300302,3003,서구,괴정동,계,16175,4884,1370,742,1458,821,171,4562,322,11291
3000,대전광역시,서구나선거구,6300302,3003,서구,괴정동,관내사전투표,1365,1364,365,243,365,240,43,1256,108,1
3000,대전광역시,서구나선거구,6300302,3003,서구,괴정동,선거일투표,14810,3520,1005,499,1093,581,128,3306,214,11290
3000,대전광역시,서구나선거구,6300302,3003,서구,가장동,계,9384,4767,1044,840,1651,740,159,4434,333,4617
3000,대전광역시,서구나선거구,6300302,3003,서구,가장동,관내사전투표,1552,1551,358,303,516,216,47,1440,111,1
3000,대전광역시,서구나선거구,6300302,3003,서구,가장동,선거일투표,7832,3216,686,537,1135,524,112,2994,222,4616
3000,대전광역시,서구나선거구,6300302,3003,서구,내동,계,18418,8827,2154,1410,2952,1381,386,8283,544,9591
3000,대전광역시,서구나선거구,6300302,3003,서구,내동,관내사전투표,2527,2524,600,469,809,400,114,2392,132,3
3000,대전광역시,서구나선거구,6300302,3003,서구,내동,선거일투표,15891,6303,1554,941,2143,981,272,5891,412,9588
3000,대전광역시,서구나선거구,6300302,3003,서구,잘못 투입·구분된 투표지,,0,12,1,3,4,2,0,10,2,-12
3000,대전광역시,서구다선거구,6300303,3003,서구,합계,,91323,43431,12600,6520,12270,5519,3749,40658,2773,47892
3000,대전광역시,서구다선거구,6300303,3003,서구,거소투표,,102,96,23,16,27,16,3,85,11,6
3000,대전광역시,서구다선거구,6300303,3003,서구,관외사전투표,,4990,4989,1614,785,1370,530,370,4669,320,1
3000,대전광역시,서구다선거구,6300303,3003,서구,가수원동,계,33130,14608,4076,2175,4425,1887,1168,13731,877,18522
3000,대전광역시,서구다선거구,6300303,3003,서구,가수원동,관내사전투표,2940,2933,843,436,893,343,229,2744,189,7
3000,대전광역시,서구다선거구,6300303,3003,서구,가수원동,선거일투표,30190,11675,3233,1739,3532,1544,939,10987,688,18515
3000,대전광역시,서구다선거구,6300303,3003,서구,관저1동,계,12737,5935,1676,890,1724,774,457,5521,414,6802
3000,대전광역시,서구다선거구,6300303,3003,서구,관저1동,관내사전투표,2506,2499,739,395,704,303,191,2332,167,7
3000,대전광역시,서구다선거구,6300303,3003,서구,관저1동,선거일투표,10231,3436,937,495,1020,471,266,3189,247,6795
3000,대전광역시,서구다선거구,6300303,3003,서구,관저2동,계,37020,16056,4859,2388,4134,2090,1652,15123,933,20964
3000,대전광역시,서구다선거구,6300303,3003,서구,관저2동,관내사전투표,5386,5379,1694,851,1286,670,520,5021,358,7
3000,대전광역시,서구다선거구,6300303,3003,서구,관저2동,선거일투표,31634,10677,3165,1537,2848,1420,1132,10102,575,20957
3000,대전광역시,서구다선거구,6300303,3003,서구,기성동,계,3344,1719,346,263,578,218,99,1504,215,1625
3000,대전광역시,서구다선거구,6300303,3003,서구,기성동,관내사전투표,801,799,158,135,266,80,60,699,100,2
3000,대전광역시,서구다선거구,6300303,3003,서구,기성동,선거일투표,2543,920,188,128,312,138,39,805,115,1623
3000,대전광역시,서구다선거구,6300303,3003,서구,잘못 투입·구분된 투표지,,0,28,6,3,12,4,0,25,3,-28
3000,대전광역시,서구라선거구,6300304,3003,서구,합계,,76243,31630,10767,3603,9535,4154,28059,3571,44613
3000,대전광역시,서구라선거구,6300304,3003,서구,거소투표,,75,68,24,4,13,14,55,13,7
3000,대전광역시,서구라선거구,6300304,3003,서구,관외사전투표,,4856,4853,1936,570,1378,567,4451,402,3
3000,대전광역시,서구라선거구,6300304,3003,서구,용문동,계,10985,4244,1316,405,1415,598,3734,510,6741
3000,대전광역시,서구라선거구,6300304,3003,서구,용문동,관내사전투표,1738,1735,579,182,559,223,1543,192,3
3000,대전광역시,서구라선거구,6300304,3003,서구,용문동,선거일투표,9247,2509,737,223,856,375,2191,318,6738
3000,대전광역시,서구라선거구,6300304,3003,서구,탄방동,계,21538,8330,2880,819,2689,1046,7434,896,13208
3000,대전광역시,서구라선거구,6300304,3003,서구,탄방동,관내사전투표,2049,2049,768,227,644,215,1854,195,0
3000,대전광역시,서구라선거구,6300304,3003,서구,탄방동,선거일투표,19489,6281,2112,592,2045,831,5580,701,13208
3000,대전광역시,서구라선거구,6300304,3003,서구,갈마1동,계,18108,6978,2163,960,2157,896,6176,802,11130
3000,대전광역시,서구라선거구,6300304,3003,서구,갈마1동,관내사전투표,2493,2491,769,346,753,337,2205,286,2
3000,대전광역시,서구라선거구,6300304,3003,서구,갈마1동,선거일투표,15615,4487,1394,614,1404,559,3971,516,11128
3000,대전광역시,서구라선거구,6300304,3003,서구,갈마2동,계,20681,7138,2443,845,1877,1029,6194,944,13543
3000,대전광역시,서구라선거구,6300304,3003,서구,갈마2동,관내사전투표,2650,2650,918,316,699,350,2283,367,0
3000,대전광역시,서구라선거구,6300304,3003,서구,갈마2동,선거일투표,18031,4488,1525,529,1178,679,3911,577,13543
3000,대전광역시,서구라선거구,6300304,3003,서구,잘못 투입·구분된 투표지,,0,19,5,0,6,4,15,4,-19
3000,대전광역시,서구마선거구,6300305,3003,서구,합계,,57798,32534,10520,4282,10889,3720,29411,3123,25264
3000,대전광역시,서구마선거구,6300305,3003,서구,거소투표,,88,85,18,18,34,6,76,9,3
3000,대전광역시,서구마선거구,6300305,3003,서구,관외사전투표,,3563,3560,1181,567,1125,364,3237,323,3
3000,대전광역시,서구마선거구,6300305,3003,서구,둔산1동,계,12071,7003,2054,769,2512,992,6327,676,5068
3000,대전광역시,서구마선거구,6300305,3003,서구,둔산1동,관내사전투표,2207,2206,787,317,631,253,1988,218,1
3000,대전광역시,서구마선거구,6300305,3003,서구,둔산1동,선거일투표,9864,4797,1267,452,1881,739,4339,458,5067
3000,대전광역시,서구마선거구,6300305,3003,서구,둔산2동,계,26030,12740,4507,1815,3888,1250,11460,1280,13290
3000,대전광역시,서구마선거구,6300305,3003,서구,둔산2동,관내사전투표,2246,2244,867,332,617,205,2021,223,2
3000,대전광역시,서구마선거구,6300305,3003,서구,둔산2동,선거일투표,23784,10496,3640,1483,3271,1045,9439,1057,13288
3000,대전광역시,서구마선거구,6300305,3003,서구,둔산3동,계,16046,9132,2759,1108,3325,1107,8299,833,6914
3000,대전광역시,서구마선거구,6300305,3003,서구,둔산3동,관내사전투표,3672,3671,1166,488,1278,410,3342,329,1
3000,대전광역시,서구마선거구,6300305,3003,서구,둔산3동,선거일투표,12374,5461,1593,620,2047,697,4957,504,6913
3000,대전광역시,서구마선거구,6300305,3003,서구,잘못 투입·구분된 투표지,,0,14,1,5,5,1,12,2,-14
3000,대전광역시,서구바선거구,6300306,3003,서구,검색된 결과가 없습니다.
3000,대전광역시,유성구가선거구,6300401,3004,유성구,합계,,77057,39270,10292,6947,10475,7527,1722,36963,2307,37787
3000,대전광역시,유성구가선거구,6300401,3004,유성구,거소투표,,118,114,37,23,22,18,2,102,12,4
3000,대전광역시,유성구가선거구,6300401,3004,유성구,관외사전투표,,5276,5275,1540,878,1391,960,189,4958,317,1
3000,대전광역시,유성구가선거구,6300401,3004,유성구,진잠동,계,19932,8869,2585,1337,1994,2053,351,8320,549,11063
3000,대전광역시,유성구가선거구,6300401,3004,유성구,진잠동,관내사전투표,2329,2324,671,401,484,541,91,2188,136,5
3000,대전광역시,유성구가선거구,6300401,3004,유성구,진잠동,선거일투표,17603,6545,1914,936,1510,1512,260,6132,413,11058
3000,대전광역시,유성구가선거구,6300401,3004,유성구,학하동,계,13441,6203,1760,882,1800,1205,213,5860,343,7238
3000,대전광역시,유성구가선거구,6300401,3004,유성구,학하동,관내사전투표,2070,2070,600,346,586,381,63,1976,94,0
3000,대전광역시,유성구가선거구,6300401,3004,유성구,학하동,선거일투표,11371,4133,1160,536,1214,824,150,3884,249,7238
3000,대전광역시,유성구가선거구,6300401,3004,유성구,원신흥동,계,21228,10235,2519,2026,2796,1778,498,9617,618,10993
3000,대전광역시,유성구가선거구,6300401,3004,유성구,원신흥동,관내사전투표,3326,3326,743,777,861,560,139,3080,246,0
3000,대전광역시,유성구가선거구,6300401,3004,유성구,원신흥동,선거일투표,17902,6909,1776,1249,1935,1218,359,6537,372,10993
3000,대전광역시,유성구가선거구,6300401,3004,유성구,상대동,계,17062,8564,1848,1800,2472,1509,469,8098,466,8498
3000,대전광역시,유성구가선거구,6300401,3004,유성구,상대동,관내사전투표,2194,2192,520,536,589,351,110,2106,86,2
3000,대전광역시,유성구가선거구,6300401,3004,유성구,상대동,선거일투표,14868,6372,1328,1264,1883,1158,359,5992,380,8496
3000,대전광역시,유성구가선거구,6300401,3004,유성구,잘못 투입·구분된 투표지,,0,10,3,1,0,4,0,8,2,-10
3000,대전광역시,유성구나선거구,6300402,3004,유성구,합계,,76535,37642,11875,4713,9307,7289,1076,1135,35395,2247,38893
3000,대전광역시,유성구나선거구,6300402,3004,유성구,거소투표,,88,80,26,8,18,16,1,2,71,9,8
3000,대전광역시,유성구나선거구,6300402,3004,유성구,관외사전투표,,4749,4747,1719,612,1123,755,121,119,4449,298,2
3000,대전광역시,유성구나선거구,6300402,3004,유성구,온천1동,계,24014,9232,2690,990,2324,2154,259,176,8593,639,14782
3000,대전광역시,유성구나선거구,6300402,3004,유성구,온천1동,관내사전투표,3353,3348,1029,396,780,726,90,62,3083,265,5
3000,대전광역시,유성구나선거구,6300402,3004,유성구,온천1동,선거일투표,20661,5884,1661,594,1544,1428,169,114,5510,374,14777
3000,대전광역시,유성구나선거구,6300402,3004,유성구,온천2동,계,31199,15088,4380,1997,3660,3037,485,714,14273,815,16111
3000,대전광역시,유성구나선거구,6300402,3004,유성구,온천2동,관내사전투표,3025,3020,917,482,629,510,121,213,2872,148,5
3000,대전광역시,유성구나선거구,6300402,3004,유성구,온천2동,선거일투표,28174,12068,3463,1515,3031,2527,364,501,11401,667,16106
3000,대전광역시,유성구나선거구,6300402,3004,유성구,노은1동,계,16485,8478,3055,1101,2180,1324,210,123,7993,485,8007
3000,대전광역시,유성구나선거구,6300402,3004,유성구,노은1동,관내사전투표,3016,3013,1079,479,707,448,85,36,2834,179,3
3000,대전광역시,유성구나선거구,6300402,3004,유성구,노은1동,선거일투표,13469,5465,1976,622,1473,876,125,87,5159,306,8004
3000,대전광역시,유성구나선거구,6300402,3004,유성구,잘못 투입·구분된 투표지,,0,17,5,5,2,3,0,1,16,1,-17
3000,대전광역시,유성구다선거구,6300403,3004,유성구,합계,,69081,37776,11393,7133,9777,6056,34359,3417,31305
3000,대전광역시,유성구다선거구,6300403,3004,유성구,거소투표,,79,73,24,5,19,10,58,15,6
3000,대전광역시,유성구다선거구,6300403,3004,유성구,관외사전투표,,4841,4803,1556,857,1365,590,4368,435,38
3000,대전광역시,유성구다선거구,6300403,3004,유성구,노은2동,계,17460,8868,2784,1554,2091,1547,7976,892,8592
3000,대전광역시,유성구다선거구,6300403,3004,유성구,노은2동,관내사전투표,2330,2319,763,402,493,396,2054,265,11
3000,대전광역시,유성구다선거구,6300403,3004,유성구,노은2동,선거일투표,15130,6549,2021,1152,1598,1151,5922,627,8581
3000,대전광역시,유성구다선거구,6300403,3004,유성구,노은3동,계,27149,14441,4593,2811,3405,2371,13180,1261,12708
3000,대전광역시,유성구다선거구,6300403,3004,유성구,노은3동,관내사전투표,4526,4513,1473,924,966,638,4001,512,13
3000,대전광역시,유성구다선거구,6300403,3004,유성구,노은3동,선거일투표,22623,9928,3120,1887,2439,1733,9179,749,12695
3000,대전광역시,유성구다선거구,6300403,3004,유성구,신성동,계,19552,9522,2414,1894,2881,1532,8721,801,10030
3000,대전광역시,유성구다선거구,6300403,3004,유성구,신성동,관내사전투표,2804,2802,740,682,706,403,2531,271,2
3000,대전광역시,유성구다선거구,6300403,3004,유성구,신성동,선거일투표,16748,6720,1674,1212,2175,1129,6190,530,10028
3000,대전광역시,유성구다선거구,6300403,3004,유성구,잘못 투입·구분된 투표지,,0,69,22,12,16,6,56,13,-69
3000,대전광역시,유성구라선거구,6300404,3004,유성구,합계,,67307,34855,10551,3989,8173,6405,3946,33064,1791,32452
3000,대전광역시,유성구라선거구,6300404,3004,유성구,거소투표,,107,103,29,12,21,21,4,87,16,4
3000,대전광역시,유성구라선거구,6300404,3004,유성구,관외사전투표,,3099,3095,959,385,846,451,266,2907,188,4
3000,대전광역시,유성구라선거구,6300404,3004,유성구,전민동,계,20818,11026,3226,1327,3065,1669,1201,10488,538,9792
3000,대전광역시,유성구라선거구,6300404,3004,유성구,전민동,관내사전투표,3540,3539,1126,463,879,505,406,3379,160,1
3000,대전광역시,유성구라선거구,6300404,3004,유성구,전민동,선거일투표,17278,7487,2100,864,2186,1164,795,7109,378,9791
3000,대전광역시,유성구라선거구,6300404,3004,유성구,구즉동,계,21975,9503,2950,991,1770,2059,1209,8979,524,12472
3000,대전광역시,유성구라선거구,6300404,3004,유성구,구즉동,관내사전투표,3349,3348,1094,348,619,682,447,3190,158,1
3000,대전광역시,유성구라선거구,6300404,3004,유성구,구즉동,선거일투표,18626,6155,1856,643,1151,1377,762,5789,366,12471
3000,대전광역시,유성구라선거구,6300404,3004,유성구,관평동,계,21308,11121,3383,1274,2470,2204,1266,10597,524,10187
3000,대전광역시,유성구라선거구,6300404,3004,유성구,관평동,관내사전투표,4125,4122,1399,524,816,753,442,3934,188,3
3000,대전광역시,유성구라선거구,6300404,3004,유성구,관평동,선거일투표,17183,6999,1984,750,1654,1451,824,6663,336,10184
3000,대전광역시,유성구라선거구,6300404,3004,유성구,잘못 투입·구분된 투표지,,0,7,4,0,1,1,0,6,1,-7
3000,대전광역시,대덕구가선거구,6300501,3005,대덕구,합계,,44585,23089,8276,10896,832,1927,21931,1158,21496
3000,대전광역시,대덕구가선거구,6300501,3005,대덕구,거소투표,,64,60,24,24,3,7,58,2,4
3000,대전광역시,대덕구가선거구,6300501,3005,대덕구,관외사전투표,,2538,2537,1169,1049,101,162,2481,56,1
3000,대전광역시,대덕구가선거구,6300501,3005,대덕구,오정동,계,12209,5334,1894,2798,141,283,5116,218,6875
3000,대전광역시,대덕구가선거구,6300501,3005,대덕구,오정동,관내사전투표,1399,1399,556,684,45,79,1364,35,0
3000,대전광역시,대덕구가선거구,6300501,3005,대덕구,오정동,선거일투표,10810,3935,1338,2114,96,204,3752,183,6875
3000,대전광역시,대덕구가선거구,6300501,3005,대덕구,대화동,계,6092,2798,863,1224,83,349,2519,279,3294
3000,대전광역시,대덕구가선거구,6300501,3005,대덕구,대화동,관내사전투표,965,963,310,428,30,134,902,61,2
3000,대전광역시,대덕구가선거구,6300501,3005,대덕구,대화동,선거일투표,5127,1835,553,796,53,215,1617,218,3292
3000,대전광역시,대덕구가선거구,6300501,3005,대덕구,법1동,계,10578,5272,1946,2440,209,412,5007,265,5306
3000,대전광역시,대덕구가선거구,6300501,3005,대덕구,법1동,관내사전투표,1961,1957,761,908,68,180,1917,40,4
3000,대전광역시,대덕구가선거구,6300501,3005,대덕구,법1동,선거일투표,8617,3315,1185,1532,141,232,3090,225,5302
3000,대전광역시,대덕구가선거구,6300501,3005,대덕구,법2동,계,13104,7075,2375,3357,294,713,6739,336,6029
3000,대전광역시,대덕구가선거구,6300501,3005,대덕구,법2동,관내사전투표,2360,2359,858,1155,89,224,2326,33,1
3000,대전광역시,대덕구가선거구,6300501,3005,대덕구,법2동,선거일투표,10744,4716,1517,2202,205,489,4413,303,6028
3000,대전광역시,대덕구가선거구,6300501,3005,대덕구,잘못 투입·구분된 투표지,,0,13,5,4,1,1,11,2,-13
3000,대전광역시,대덕구나선거구,6300502,3005,대덕구,합계,,54327,26506,7582,4453,8359,2954,23348,3158,27821
3000,대전광역시,대덕구나선거구,6300502,3005,대덕구,거소투표,,63,59,15,8,23,7,53,6,4
3000,대전광역시,대덕구나선거구,6300502,3005,대덕구,관외사전투표,,2132,2131,786,330,672,164,1952,179,1
3000,대전광역시,대덕구나선거구,6300502,3005,대덕구,회덕동,계,10125,5301,1582,643,1729,654,4608,693,4824
3000,대전광역시,대덕구나선거구,6300502,3005,대덕구,회덕동,관내사전투표,1371,1371,449,198,418,161,1226,145,0
3000,대전광역시,대덕구나선거구,6300502,3005,대덕구,회덕동,선거일투표,8754,3930,1133,445,1311,493,3382,548,4824
3000,대전광역시,대덕구나선거구,6300502,3005,대덕구,신탄진동,계,12243,5897,1425,1205,1983,576,5189,708,6346
3000,대전광역시,대덕구나선거구,6300502,3005,대덕구,신탄진동,관내사전투표,2066,2064,511,437,656,204,1808,256,2
3000,대전광역시,대덕구나선거구,6300502,3005,대덕구,신탄진동,선거일투표,10177,3833,914,768,1327,372,3381,452,6344
3000,대전광역시,대덕구나선거구,6300502,3005,대덕구,석봉동,계,12656,5840,1752,1019,1805,658,5234,606,6816
3000,대전광역시,대덕구나선거구,6300502,3005,대덕구,석봉동,관내사전투표,1811,1811,535,343,528,242,1648,163,0
3000,대전광역시,대덕구나선거구,6300502,3005,대덕구,석봉동,선거일투표,10845,4029,1217,676,1277,416,3586,443,6816
3000,대전광역시,대덕구나선거구,6300502,3005,대덕구,덕암동,계,11575,4967,1330,874,1464,641,4309,658,6608
3000,대전광역시,대덕구나선거구,6300502,3005,대덕구,덕암동,관내사전투표,1764,1760,493,332,517,229,1571,189,4
3000,대전광역시,대덕구나선거구,6300502,3005,대덕구,덕암동,선거일투표,9811,3207,837,542,947,412,2738,469,6604
3000,대전광역시,대덕구나선거구,6300502,3005,대덕구,목상동,계,5533,2300,689,373,680,253,1995,305,3233
3000,대전광역시,대덕구나선거구,6300502,3005,대덕구,목상동,관내사전투표,957,957,306,158,271,98,833,124,0
3000,대전광역시,대덕구나선거구,6300502,3005,대덕구,목상동,선거일투표,4576,1343,383,215,409,155,1162,181,3233
3000,대전광역시,대덕구나선거구,6300502,3005,대덕구,잘못 투입·구분된 투표지,,0,11,3,1,3,1,8,3,-11
3000,대전광역시,대덕구다선거구,6300503,3005,대덕구,검색된 결과가 없습니다.3100,울산광역시,중구가선거구,6310101,3101,중구,검색된 결과가 없습니다.
3100,울산광역시,중구나선거구,6310102,3101,중구,합계,,35670,19497,4713,7451,2656,3794,18614,883,16173
3100,울산광역시,중구나선거구,6310102,3101,중구,거소투표,,42,42,12,16,5,5,38,4,0
3100,울산광역시,중구나선거구,6310102,3101,중구,관외사전투표,,1854,1851,591,733,181,273,1778,73,3
3100,울산광역시,중구나선거구,6310102,3101,중구,병영1동,계,18285,9912,2428,3759,1560,1708,9455,457,8373
3100,울산광역시,중구나선거구,6310102,3101,중구,병영1동,관내사전투표,3476,3469,798,1267,551,687,3303,166,7
3100,울산광역시,중구나선거구,6310102,3101,중구,병영1동,선거일투표,14809,6443,1630,2492,1009,1021,6152,291,8366
3100,울산광역시,중구나선거구,6310102,3101,중구,병영2동,계,15489,7663,1678,2932,907,1801,7318,345,7826
3100,울산광역시,중구나선거구,6310102,3101,중구,병영2동,관내사전투표,2133,2124,486,780,220,550,2036,88,9
3100,울산광역시,중구나선거구,6310102,3101,중구,병영2동,선거일투표,13356,5539,1192,2152,687,1251,5282,257,7817
3100,울산광역시,중구나선거구,6310102,3101,중구,잘못 투입·구분된 투표지,,0,29,4,11,3,7,25,4,-29
3100,울산광역시,중구다선거구,6310103,3101,중구,합계,,62602,35328,8483,3781,12742,6885,31891,3437,27274
3100,울산광역시,중구다선거구,6310103,3101,중구,거소투표,,90,80,19,9,32,9,69,11,10
3100,울산광역시,중구다선거구,6310103,3101,중구,관외사전투표,,2986,2973,851,325,1052,476,2704,269,13
3100,울산광역시,중구다선거구,6310103,3101,중구,우정동,계,14768,8205,1892,785,3288,1380,7345,860,6563
3100,울산광역시,중구다선거구,6310103,3101,중구,우정동,관내사전투표,2343,2338,556,224,888,400,2068,270,5
3100,울산광역시,중구다선거구,6310103,3101,중구,우정동,선거일투표,12425,5867,1336,561,2400,980,5277,590,6558
3100,울산광역시,중구다선거구,6310103,3101,중구,태화동,계,25033,13803,3460,1626,4386,3083,12555,1248,11230
3100,울산광역시,중구다선거구,6310103,3101,중구,태화동,관내사전투표,3397,3389,909,475,1053,666,3103,286,8
3100,울산광역시,중구다선거구,6310103,3101,중구,태화동,선거일투표,21636,10414,2551,1151,3333,2417,9452,962,11222
3100,울산광역시,중구다선거구,6310103,3101,중구,다운동,계,19725,10227,2248,1033,3971,1929,9181,1046,9498
3100,울산광역시,중구다선거구,6310103,3101,중구,다운동,관내사전투표,2736,2735,607,321,945,535,2408,327,1
3100,울산광역시,중구다선거구,6310103,3101,중구,다운동,선거일투표,16989,7492,1641,712,3026,1394,6773,719,9497
3100,울산광역시,중구다선거구,6310103,3101,중구,잘못 투입·구분된 투표지,,0,40,13,3,13,8,37,3,-40
3100,울산광역시,중구라선거구,6310104,3101,중구,합계,,30674,16891,6184,6125,3962,16271,620,13783
3100,울산광역시,중구라선거구,6310104,3101,중구,거소투표,,28,28,6,8,10,24,4,0
3100,울산광역시,중구라선거구,6310104,3101,중구,관외사전투표,,1335,1335,543,440,312,1295,40,0
3100,울산광역시,중구라선거구,6310104,3101,중구,반구1동,계,13876,7028,2431,2285,2011,6727,301,6848
3100,울산광역시,중구라선거구,6310104,3101,중구,반구1동,관내사전투표,2364,2360,888,720,681,2289,71,4
3100,울산광역시,중구라선거구,6310104,3101,중구,반구1동,선거일투표,11512,4668,1543,1565,1330,4438,230,6844
3100,울산광역시,중구라선거구,6310104,3101,중구,반구2동,계,7434,3843,1207,1660,837,3704,139,3591
3100,울산광역시,중구라선거구,6310104,3101,중구,반구2동,관내사전투표,1361,1358,456,577,272,1305,53,3
3100,울산광역시,중구라선거구,6310104,3101,중구,반구2동,선거일투표,6073,2485,751,1083,565,2399,86,3588
3100,울산광역시,중구라선거구,6310104,3101,중구,약사동,계,8001,4640,1992,1727,785,4504,136,3361
3100,울산광역시,중구라선거구,6310104,3101,중구,약사동,관내사전투표,1995,1990,926,707,307,1940,50,5
3100,울산광역시,중구라선거구,6310104,3101,중구,약사동,선거일투표,6006,2650,1066,1020,478,2564,86,3356
3100,울산광역시,중구라선거구,6310104,3101,중구,잘못 투입·구분된 투표지,,0,17,5,5,7,17,0,-17
3100,울산광역시,남구가선거구,6310201,3102,남구,합계,,58328,29298,6439,3231,19054,28724,574,29030
3100,울산광역시,남구가선거구,6310201,3102,남구,거소투표,,61,55,21,6,22,49,6,6
3100,울산광역시,남구가선거구,6310201,3102,남구,관외사전투표,,2719,2717,737,306,1606,2649,68,2
3100,울산광역시,남구가선거구,6310201,3102,남구,신정1동,계,16013,7597,1431,798,5208,7437,160,8416
3100,울산광역시,남구가선거구,6310201,3102,남구,신정1동,관내사전투표,2594,2590,500,262,1765,2527,63,4
3100,울산광역시,남구가선거구,6310201,3102,남구,신정1동,선거일투표,13419,5007,931,536,3443,4910,97,8412
3100,울산광역시,남구가선거구,6310201,3102,남구,신정2동,계,18322,9026,2076,880,5913,8869,157,9296
3100,울산광역시,남구가선거구,6310201,3102,남구,신정2동,관내사전투표,2133,2132,513,217,1360,2090,42,1
3100,울산광역시,남구가선거구,6310201,3102,남구,신정2동,선거일투표,16189,6894,1563,663,4553,6779,115,9295
3100,울산광역시,남구가선거구,6310201,3102,남구,신정3동,계,13462,6482,1401,887,4071,6359,123,6980
3100,울산광역시,남구가선거구,6310201,3102,남구,신정3동,관내사전투표,2185,2176,453,324,1349,2126,50,9
3100,울산광역시,남구가선거구,6310201,3102,남구,신정3동,선거일투표,11277,4306,948,563,2722,4233,73,6971
3100,울산광역시,남구가선거구,6310201,3102,남구,신정5동,계,7751,3405,770,352,2223,3345,60,4346
3100,울산광역시,남구가선거구,6310201,3102,남구,신정5동,관내사전투표,1274,1272,313,121,818,1252,20,2
3100,울산광역시,남구가선거구,6310201,3102,남구,신정5동,선거일투표,6477,2133,457,231,1405,2093,40,4344
3100,울산광역시,남구가선거구,6310201,3102,남구,잘못 투입·구분된 투표지,,0,16,3,2,11,16,0,-16
3100,울산광역시,남구나선거구,6310202,3102,남구,합계,,38973,21360,5135,1933,6519,5607,19194,2166,17613
3100,울산광역시,남구나선거구,6310202,3102,남구,거소투표,,57,54,7,3,29,9,48,6,3
3100,울산광역시,남구나선거구,6310202,3102,남구,관외사전투표,,2465,2465,638,307,773,489,2207,258,0
3100,울산광역시,남구나선거구,6310202,3102,남구,신정4동,계,16126,7616,1867,693,2144,2078,6782,834,8510
3100,울산광역시,남구나선거구,6310202,3102,남구,신정4동,관내사전투표,2636,2628,676,198,659,789,2322,306,8
3100,울산광역시,남구나선거구,6310202,3102,남구,신정4동,선거일투표,13490,4988,1191,495,1485,1289,4460,528,8502
3100,울산광역시,남구나선거구,6310202,3102,남구,옥동,계,20325,11203,2620,928,3566,3026,10140,1063,9122
3100,울산광역시,남구나선거구,6310202,3102,남구,옥동,관내사전투표,2856,2850,668,228,781,819,2496,354,6
3100,울산광역시,남구나선거구,6310202,3102,남구,옥동,선거일투표,17469,8353,1952,700,2785,2207,7644,709,9116
3100,울산광역시,남구나선거구,6310202,3102,남구,잘못 투입·구분된 투표지,,0,22,3,2,7,5,17,5,-22
3100,울산광역시,남구다선거구,6310203,3102,남구,합계,,45447,23567,8658,9232,4883,22773,794,21880
3100,울산광역시,남구다선거구,6310203,3102,남구,거소투표,,69,66,25,20,16,61,5,3
3100,울산광역시,남구다선거구,6310203,3102,남구,관외사전투표,,2073,2072,823,751,428,2002,70,1
3100,울산광역시,남구다선거구,6310203,3102,남구,삼호동,계,17449,8753,2936,3455,2035,8426,327,8696
3100,울산광역시,남구다선거구,6310203,3102,남구,삼호동,관내사전투표,3173,3166,1188,1135,747,3070,96,7
3100,울산광역시,남구다선거구,6310203,3102,남구,삼호동,선거일투표,14276,5587,1748,2320,1288,5356,231,8689
3100,울산광역시,남구다선거구,6310203,3102,남구,무거동,계,25856,12654,4868,4999,2396,12263,391,13202
3100,울산광역시,남구다선거구,6310203,3102,남구,무거동,관내사전투표,2888,2884,1195,1048,532,2775,109,4
3100,울산광역시,남구다선거구,6310203,3102,남구,무거동,선거일투표,22968,9770,3673,3951,1864,9488,282,13198
3100,울산광역시,남구다선거구,6310203,3102,남구,잘못 투입·구분된 투표지,,0,22,6,7,8,21,1,-22
3100,울산광역시,남구라선거구,6310204,3102,남구,합계,,50982,23011,6145,3377,12734,22256,755,27971
3100,울산광역시,남구라선거구,6310204,3102,남구,거소투표,,66,62,14,9,31,54,8,4
3100,울산광역시,남구라선거구,6310204,3102,남구,관외사전투표,,2498,2494,699,325,1388,2412,82,4
3100,울산광역시,남구라선거구,6310204,3102,남구,삼산동,계,40343,16721,4599,2659,8946,16204,517,23622
3100,울산광역시,남구라선거구,6310204,3102,남구,삼산동,관내사전투표,4130,4121,1211,637,2168,4016,105,9
3100,울산광역시,남구라선거구,6310204,3102,남구,삼산동,선거일투표,36213,12600,3388,2022,6778,12188,412,23613
3100,울산광역시,남구라선거구,6310204,3102,남구,야음장생포동,계,8075,3710,826,379,2358,3563,147,4365
3100,울산광역시,남구라선거구,6310204,3102,남구,야음장생포동,관내사전투표,1097,1092,231,124,687,1042,50,5
3100,울산광역시,남구라선거구,6310204,3102,남구,야음장생포동,선거일투표,6978,2618,595,255,1671,2521,97,4360
3100,울산광역시,남구라선거구,6310204,3102,남구,잘못 투입·구분된 투표지,,0,24,7,5,11,23,1,-24
3100,울산광역시,남구마선거구,6310205,3102,남구,합계,,37864,19076,3760,2336,7000,3949,17045,2031,18788
3100,울산광역시,남구마선거구,6310205,3102,남구,거소투표,,49,45,9,6,13,9,37,8,4
3100,울산광역시,남구마선거구,6310205,3102,남구,관외사전투표,,2131,2130,497,276,755,321,1849,281,1
3100,울산광역시,남구마선거구,6310205,3102,남구,달동,계,22657,9753,1820,1122,3480,2231,8653,1100,12904
3100,울산광역시,남구마선거구,6310205,3102,남구,달동,관내사전투표,2888,2881,517,336,1010,662,2525,356,7
3100,울산광역시,남구마선거구,6310205,3102,남구,달동,선거일투표,19769,6872,1303,786,2470,1569,6128,744,12897
3100,울산광역시,남구마선거구,6310205,3102,남구,수암동,계,13027,7120,1429,929,2738,1385,6481,639,5907
3100,울산광역시,남구마선거구,6310205,3102,남구,수암동,관내사전투표,2393,2385,480,306,850,471,2107,278,8
3100,울산광역시,남구마선거구,6310205,3102,남구,수암동,선거일투표,10634,4735,949,623,1888,914,4374,361,5899
3100,울산광역시,남구마선거구,6310205,3102,남구,잘못 투입·구분된 투표지,,0,28,5,3,14,3,25,3,-28
3100,울산광역시,남구바선거구,6310206,3102,남구,검색된 결과가 없습니다.
3100,울산광역시,동구가선거구,6310301,3103,동구,합계,,58996,30041,5851,3139,12414,6934,799,29137,904,28955
3100,울산광역시,동구가선거구,6310301,3103,동구,거소투표,,99,92,32,8,32,11,2,85,7,7
3100,울산광역시,동구가선거구,6310301,3103,동구,관외사전투표,,2248,2238,529,222,942,396,75,2164,74,10
3100,울산광역시,동구가선거구,6310301,3103,동구,방어동,계,31954,14786,2719,1693,6180,3405,354,14351,435,17168
3100,울산광역시,동구가선거구,6310301,3103,동구,방어동,관내사전투표,4272,4269,752,460,1840,1047,74,4173,96,3
3100,울산광역시,동구가선거구,6310301,3103,동구,방어동,선거일투표,27682,10517,1967,1233,4340,2358,280,10178,339,17165
3100,울산광역시,동구가선거구,6310301,3103,동구,화정동,계,15260,8032,1564,816,3285,1885,249,7799,233,7228
3100,울산광역시,동구가선거구,6310301,3103,동구,화정동,관내사전투표,2735,2731,516,293,1116,669,68,2662,69,4
3100,울산광역시,동구가선거구,6310301,3103,동구,화정동,선거일투표,12525,5301,1048,523,2169,1216,181,5137,164,7224
3100,울산광역시,동구가선거구,6310301,3103,동구,대송동,계,9435,4871,1003,398,1968,1229,118,4716,155,4564
3100,울산광역시,동구가선거구,6310301,3103,동구,대송동,관내사전투표,1982,1982,414,162,797,515,34,1922,60,0
3100,울산광역시,동구가선거구,6310301,3103,동구,대송동,선거일투표,7453,2889,589,236,1171,714,84,2794,95,4564
3100,울산광역시,동구가선거구,6310301,3103,동구,잘못 투입·구분된 투표지,,0,22,4,2,7,8,1,22,0,-22
3100,울산광역시,동구나선거구,6310302,3103,동구,합계,,34417,20688,4602,1754,8632,2993,2149,20130,558,13729
3100,울산광역시,동구나선거구,6310302,3103,동구,거소투표,,49,48,13,5,18,6,3,45,3,1
3100,울산광역시,동구나선거구,6310302,3103,동구,관외사전투표,,1275,1275,328,111,584,130,88,1241,34,0
3100,울산광역시,동구나선거구,6310302,3103,동구,일산동,계,5036,2690,550,193,1353,275,234,2605,85,2346
3100,울산광역시,동구나선거구,6310302,3103,동구,일산동,관내사전투표,1194,1194,231,80,604,140,105,1160,34,0
3100,울산광역시,동구나선거구,6310302,3103,동구,일산동,선거일투표,3842,1496,319,113,749,135,129,1445,51,2346
3100,울산광역시,동구나선거구,6310302,3103,동구,전하1동,계,11847,6538,1524,461,2772,1009,609,6375,163,5309
3100,울산광역시,동구나선거구,6310302,3103,동구,전하1동,관내사전투표,2396,2388,552,170,1014,399,196,2331,57,8
3100,울산광역시,동구나선거구,6310302,3103,동구,전하1동,선거일투표,9451,4150,972,291,1758,610,413,4044,106,5301
3100,울산광역시,동구나선거구,6310302,3103,동구,전하2동,계,16210,10125,2181,983,3902,1573,1213,9852,273,6085
3100,울산광역시,동구나선거구,6310302,3103,동구,전하2동,관내사전투표,4018,4015,846,347,1564,691,472,3920,95,3
3100,울산광역시,동구나선거구,6310302,3103,동구,전하2동,선거일투표,12192,6110,1335,636,2338,882,741,5932,178,6082
3100,울산광역시,동구나선거구,6310302,3103,동구,잘못 투입·구분된 투표지,,0,12,6,1,3,0,2,12,0,-12
3100,울산광역시,동구다선거구,6310303,3103,동구,합계,,33956,20087,5465,10134,2676,1098,19373,714,13869
3100,울산광역시,동구다선거구,6310303,3103,동구,거소투표,,50,48,13,18,4,8,43,5,2
3100,울산광역시,동구다선거구,6310303,3103,동구,관외사전투표,,1280,1280,427,609,142,63,1241,39,0
3100,울산광역시,동구다선거구,6310303,3103,동구,남목1동,계,7240,4321,1049,2321,520,242,4132,189,2919
3100,울산광역시,동구다선거구,6310303,3103,동구,남목1동,관내사전투표,1733,1731,473,878,248,97,1696,35,2
3100,울산광역시,동구다선거구,6310303,3103,동구,남목1동,선거일투표,5507,2590,576,1443,272,145,2436,154,2917
3100,울산광역시,동구다선거구,6310303,3103,동구,남목2동,계,15910,8842,2629,4298,1213,419,8559,283,7068
3100,울산광역시,동구다선거구,6310303,3103,동구,남목2동,관내사전투표,3269,3269,961,1663,451,138,3213,56,0
3100,울산광역시,동구다선거구,6310303,3103,동구,남목2동,선거일투표,12641,5573,1668,2635,762,281,5346,227,7068
3100,울산광역시,동구다선거구,6310303,3103,동구,남목3동,계,9476,5582,1345,2882,792,366,5385,197,3894
3100,울산광역시,동구다선거구,6310303,3103,동구,남목3동,관내사전투표,2226,2221,586,1097,350,135,2168,53,5
3100,울산광역시,동구다선거구,6310303,3103,동구,남목3동,선거일투표,7250,3361,759,1785,442,231,3217,144,3889
3100,울산광역시,동구다선거구,6310303,3103,동구,잘못 투입·구분된 투표지,,0,14,2,6,5,0,13,1,-14
3100,울산광역시,북구가선거구,6310401,3104,북구,합계,,58476,30281,12330,14137,3018,29485,796,28195
3100,울산광역시,북구가선거구,6310401,3104,북구,거소투표,,55,54,23,20,5,48,6,1
3100,울산광역시,북구가선거구,6310401,3104,북구,관외사전투표,,3442,3438,1439,1600,305,3344,94,4
3100,울산광역시,북구가선거구,6310401,3104,북구,농소1동,계,26928,12479,4725,6327,1079,12131,348,14449
3100,울산광역시,북구가선거구,6310401,3104,북구,농소1동,관내사전투표,2654,2646,963,1391,227,2581,65,8
3100,울산광역시,북구가선거구,6310401,3104,북구,농소1동,선거일투표,24274,9833,3762,4936,852,9550,283,14441
3100,울산광역시,북구가선거구,6310401,3104,북구,송정동,계,28051,14293,6135,6185,1626,13946,347,13758
3100,울산광역시,북구가선거구,6310401,3104,북구,송정동,관내사전투표,4677,4674,2040,1943,615,4598,76,3
3100,울산광역시,북구가선거구,6310401,3104,북구,송정동,선거일투표,23374,9619,4095,4242,1011,9348,271,13755
3100,울산광역시,북구가선거구,6310401,3104,북구,잘못 투입·구분된 투표지,,0,17,8,5,3,16,1,-17
3100,울산광역시,북구나선거구,6310402,3104,북구,합계,,62295,30723,7577,4561,8770,3582,3605,471,28566,2157,31572
3100,울산광역시,북구나선거구,6310402,3104,북구,거소투표,,62,60,19,8,17,7,4,1,56,4,2
3100,울산광역시,북구나선거구,6310402,3104,북구,관외사전투표,,2643,2643,633,391,900,258,204,75,2461,182,0
3100,울산광역시,북구나선거구,6310402,3104,북구,농소2동,계,31355,14348,3734,1996,4268,1612,1477,210,13297,1051,17007
3100,울산광역시,북구나선거구,6310402,3104,북구,농소2동,관내사전투표,3451,3451,914,466,961,338,403,56,3138,313,0
3100,울산광역시,북구나선거구,6310402,3104,북구,농소2동,선거일투표,27904,10897,2820,1530,3307,1274,1074,154,10159,738,17007
3100,울산광역시,북구나선거구,6310402,3104,북구,농소3동,계,28235,13668,3191,2164,3584,1704,1920,185,12748,920,14567
3100,울산광역시,북구나선거구,6310402,3104,북구,농소3동,관내사전투표,4429,4428,1028,756,1021,520,721,54,4100,328,1
3100,울산광역시,북구나선거구,6310402,3104,북구,농소3동,선거일투표,23806,9240,2163,1408,2563,1184,1199,131,8648,592,14566
3100,울산광역시,북구나선거구,6310402,3104,북구,잘못 투입·구분된 투표지,,0,4,0,2,1,1,0,0,4,0,-4
3100,울산광역시,북구다선거구,6310403,3104,북구,합계,,55013,27499,7126,2394,7055,4567,4661,25803,1696,27514
3100,울산광역시,북구다선거구,6310403,3104,북구,거소투표,,40,38,11,2,12,6,2,33,5,2
3100,울산광역시,북구다선거구,6310403,3104,북구,관외사전투표,,2760,2760,789,256,695,516,305,2561,199,0
3100,울산광역시,북구다선거구,6310403,3104,북구,강동동,계,12027,5578,1366,614,1452,1189,582,5203,375,6449
3100,울산광역시,북구다선거구,6310403,3104,북구,강동동,관내사전투표,1901,1898,504,207,483,378,204,1776,122,3
3100,울산광역시,북구다선거구,6310403,3104,북구,강동동,선거일투표,10126,3680,862,407,969,811,378,3427,253,6446
3100,울산광역시,북구다선거구,6310403,3104,북구,효문동,계,23445,10662,2842,856,2731,1855,1806,10090,572,12783
3100,울산광역시,북구다선거구,6310403,3104,북구,효문동,관내사전투표,2786,2783,803,210,622,413,606,2654,129,3
3100,울산광역시,북구다선거구,6310403,3104,북구,효문동,선거일투표,20659,7879,2039,646,2109,1442,1200,7436,443,12780
3100,울산광역시,북구다선거구,6310403,3104,북구,양정동,계,8163,4136,1013,365,1146,482,886,3892,244,4027
3100,울산광역시,북구다선거구,6310403,3104,북구,양정동,관내사전투표,1519,1510,394,137,365,162,348,1406,104,9
3100,울산광역시,북구다선거구,6310403,3104,북구,양정동,선거일투표,6644,2626,619,228,781,320,538,2486,140,4018
3100,울산광역시,북구다선거구,6310403,3104,북구,염포동,계,8578,4303,1101,299,1015,513,1074,4002,301,4275
3100,울산광역시,북구다선거구,6310403,3104,북구,염포동,관내사전투표,1861,1856,509,127,391,195,505,1727,129,5
3100,울산광역시,북구다선거구,6310403,3104,북구,염포동,선거일투표,6717,2447,592,172,624,318,569,2275,172,4270
3100,울산광역시,북구다선거구,6310403,3104,북구,잘못 투입·구분된 투표지,,0,22,4,2,4,6,6,22,0,-22
3100,울산광역시,울주군가선거구,6310501,3105,울주군,합계,,72952,35572,7187,3292,2091,10938,4203,4819,32530,3042,37380
3100,울산광역시,울주군가선거구,6310501,3105,울주군,거소투표,,118,113,22,13,9,30,14,16,104,9,5
3100,울산광역시,울주군가선거구,6310501,3105,울주군,관외사전투표,,3095,3095,707,283,213,1073,287,251,2814,281,0
3100,울산광역시,울주군가선거구,6310501,3105,울주군,온산읍,계,17611,7105,2121,883,191,1931,597,763,6486,619,10506
3100,울산광역시,울주군가선거구,6310501,3105,울주군,온산읍,관내사전투표,2211,2211,663,277,60,551,194,233,1978,233,0
3100,울산광역시,울주군가선거구,6310501,3105,울주군,온산읍,선거일투표,15400,4894,1458,606,131,1380,403,530,4508,386,10506
3100,울산광역시,울주군가선거구,6310501,3105,울주군,온양읍,계,22846,10671,1824,1285,468,2277,2214,1723,9791,880,12175
3100,울산광역시,울주군가선거구,6310501,3105,울주군,온양읍,관내사전투표,3153,3152,504,431,123,600,672,533,2863,289,1
3100,울산광역시,울주군가선거구,6310501,3105,울주군,온양읍,선거일투표,19693,7519,1320,854,345,1677,1542,1190,6928,591,12174
3100,울산광역시,울주군가선거구,6310501,3105,울주군,청량읍,계,15197,7274,1208,374,990,3421,426,249,6668,606,7923
3100,울산광역시,울주군가선거구,6310501,3105,울주군,청량읍,관내사전투표,2019,2010,282,96,306,947,112,66,1809,201,9
3100,울산광역시,울주군가선거구,6310501,3105,울주군,청량읍,선거일투표,13178,5264,926,278,684,2474,314,183,4859,405,7914
3100,울산광역시,울주군가선거구,6310501,3105,울주군,서생면,계,7081,3599,590,229,62,693,251,1459,3284,315,3482
3100,울산광역시,울주군가선거구,6310501,3105,울주군,서생면,관내사전투표,1122,1122,204,71,21,210,71,446,1023,99,0
3100,울산광역시,울주군가선거구,6310501,3105,울주군,서생면,선거일투표,5959,2477,386,158,41,483,180,1013,2261,216,3482
3100,울산광역시,울주군가선거구,6310501,3105,울주군,웅촌면,계,7004,3704,715,225,158,1506,413,357,3374,330,3300
3100,울산광역시,울주군가선거구,6310501,3105,울주군,웅촌면,관내사전투표,1238,1238,271,78,61,433,150,128,1121,117,0
3100,울산광역시,울주군가선거구,6310501,3105,울주군,웅촌면,선거일투표,5766,2466,444,147,97,1073,263,229,2253,213,3300
3100,울산광역시,울주군가선거구,6310501,3105,울주군,잘못 투입·구분된 투표지,,0,11,0,0,0,7,1,1,9,2,-11
3100,울산광역시,울주군나선거구,6310502,3105,울주군,합계,,60122,32562,6927,2284,9568,5221,3989,2623,30612,1950,27560
3100,울산광역시,울주군나선거구,6310502,3105,울주군,거소투표,,155,151,35,14,50,24,10,8,141,10,4
3100,울산광역시,울주군나선거구,6310502,3105,울주군,관외사전투표,,2904,2903,741,247,947,404,178,157,2674,229,1
3100,울산광역시,울주군나선거구,6310502,3105,울주군,언양읍,계,23084,12210,2452,967,2619,1857,2303,1352,11550,660,10874
3100,울산광역시,울주군나선거구,6310502,3105,울주군,언양읍,관내사전투표,4686,4686,999,361,1025,678,874,458,4395,291,0
3100,울산광역시,울주군나선거구,6310502,3105,울주군,언양읍,선거일투표,18398,7524,1453,606,1594,1179,1429,894,7155,369,10874
3100,울산광역시,울주군나선거구,6310502,3105,울주군,삼남읍,계,18752,8637,1676,607,3465,991,876,574,8189,448,10115
3100,울산광역시,울주군나선거구,6310502,3105,울주군,삼남읍,관내사전투표,2973,2973,612,230,1219,321,262,165,2809,164,0
3100,울산광역시,울주군나선거구,6310502,3105,울주군,삼남읍,선거일투표,15779,5664,1064,377,2246,670,614,409,5380,284,10115
3100,울산광역시,울주군나선거구,6310502,3105,울주군,두동면,계,3617,1930,466,102,729,257,125,101,1780,150,1687
3100,울산광역시,울주군나선거구,6310502,3105,울주군,두동면,관내사전투표,691,691,171,42,242,97,44,43,639,52,0
3100,울산광역시,울주군나선거구,6310502,3105,울주군,두동면,선거일투표,2926,1239,295,60,487,160,81,58,1141,98,1687
3100,울산광역시,울주군나선거구,6310502,3105,울주군,두서면,계,2893,1765,670,62,469,177,135,108,1621,144,1128
3100,울산광역시,울주군나선거구,6310502,3105,울주군,두서면,관내사전투표,796,795,316,29,198,87,46,47,723,72,1
3100,울산광역시,울주군나선거구,6310502,3105,울주군,두서면,선거일투표,2097,970,354,33,271,90,89,61,898,72,1127
3100,울산광역시,울주군나선거구,6310502,3105,울주군,상북면,계,7134,3932,720,219,797,1379,315,262,3692,240,3202
3100,울산광역시,울주군나선거구,6310502,3105,울주군,상북면,관내사전투표,1767,1767,361,110,334,627,121,99,1652,115,0
3100,울산광역시,울주군나선거구,6310502,3105,울주군,상북면,선거일투표,5367,2165,359,109,463,752,194,163,2040,125,3202
3100,울산광역시,울주군나선거구,6310502,3105,울주군,삼동면,계,1583,1030,166,66,490,132,46,61,961,69,553
3100,울산광역시,울주군나선거구,6310502,3105,울주군,삼동면,관내사전투표,381,381,79,32,156,46,21,25,359,22,0
3100,울산광역시,울주군나선거구,6310502,3105,울주군,삼동면,선거일투표,1202,649,87,34,334,86,25,36,602,47,553
3100,울산광역시,울주군나선거구,6310502,3105,울주군,잘못 투입·구분된 투표지,,0,4,1,0,2,0,1,0,4,0,-4
3100,울산광역시,울주군다선거구,6310503,3105,울주군,합계,,55977,31233,13950,13925,2389,30264,969,24744
3100,울산광역시,울주군다선거구,6310503,3105,울주군,거소투표,,66,61,21,34,2,57,4,5
3100,울산광역시,울주군다선거구,6310503,3105,울주군,관외사전투표,,3690,3685,1705,1617,266,3588,97,5
3100,울산광역시,울주군다선거구,6310503,3105,울주군,범서읍,계,52221,27473,12217,12270,2120,26607,866,24748
3100,울산광역시,울주군다선거구,6310503,3105,울주군,범서읍,관내사전투표,7903,7894,3874,3216,584,7674,220,9
3100,울산광역시,울주군다선거구,6310503,3105,울주군,범서읍,선거일투표,44318,19579,8343,9054,1536,18933,646,24739
3100,울산광역시,울주군다선거구,6310503,3105,울주군,잘못 투입·구분된 투표지,,0,14,7,4,1,12,2,-144100,경기도,수원시가선거구,6410101,4101,수원시장안구,합계,,58092,28002,12426,14167,498,27091,911,30090
4100,경기도,수원시가선거구,6410101,4101,수원시장안구,거소투표,,203,186,49,111,6,166,20,17
4100,경기도,수원시가선거구,6410101,4101,수원시장안구,관외사전투표,,3019,3017,1530,1370,60,2960,57,2
4100,경기도,수원시가선거구,6410101,4101,수원시장안구,영화동,계,17707,7568,3256,3978,118,7352,216,10139
4100,경기도,수원시가선거구,6410101,4101,수원시장안구,영화동,관내사전투표,2593,2593,1152,1359,41,2552,41,0
4100,경기도,수원시가선거구,6410101,4101,수원시장안구,영화동,선거일투표,15114,4975,2104,2619,77,4800,175,10139
4100,경기도,수원시가선거구,6410101,4101,수원시장안구,조원1동,계,23273,10918,5023,5310,187,10520,398,12355
4100,경기도,수원시가선거구,6410101,4101,수원시장안구,조원1동,관내사전투표,3362,3360,1577,1617,51,3245,115,2
4100,경기도,수원시가선거구,6410101,4101,수원시장안구,조원1동,선거일투표,19911,7558,3446,3693,136,7275,283,12353
4100,경기도,수원시가선거구,6410101,4101,수원시장안구,연무동,계,13890,6297,2559,3392,127,6078,219,7593
4100,경기도,수원시가선거구,6410101,4101,수원시장안구,연무동,관내사전투표,1893,1891,841,948,43,1832,59,2
4100,경기도,수원시가선거구,6410101,4101,수원시장안구,연무동,선거일투표,11997,4406,1718,2444,84,4246,160,7591
4100,경기도,수원시가선거구,6410101,4101,수원시장안구,잘못 투입·구분된 투표지,,0,16,9,6,0,15,1,-16
4100,경기도,수원시나선거구,6410102,4101,수원시장안구,검색된 결과가 없습니다.
4100,경기도,수원시다선거구,6410103,4101,수원시장안구,합계,,87726,49063,17784,6127,12097,6893,3689,46590,2473,38663
4100,경기도,수원시다선거구,6410103,4101,수원시장안구,거소투표,,105,100,35,12,30,11,3,91,9,5
4100,경기도,수원시다선거구,6410103,4101,수원시장안구,관외사전투표,,5569,5565,2155,758,1501,556,312,5282,283,4
4100,경기도,수원시다선거구,6410103,4101,수원시장안구,정자1동,계,22734,12050,3900,1204,2929,2205,1173,11411,639,10684
4100,경기도,수원시다선거구,6410103,4101,수원시장안구,정자1동,관내사전투표,3526,3524,1167,391,808,635,323,3324,200,2
4100,경기도,수원시다선거구,6410103,4101,수원시장안구,정자1동,선거일투표,19208,8526,2733,813,2121,1570,850,8087,439,10682
4100,경기도,수원시다선거구,6410103,4101,수원시장안구,정자2동,계,27879,13316,4765,1586,3681,1617,910,12559,757,14563
4100,경기도,수원시다선거구,6410103,4101,수원시장안구,정자2동,관내사전투표,3195,3187,1097,402,908,369,207,2983,204,8
4100,경기도,수원시다선거구,6410103,4101,수원시장안구,정자2동,선거일투표,24684,10129,3668,1184,2773,1248,703,9576,553,14555
4100,경기도,수원시다선거구,6410103,4101,수원시장안구,정자3동,계,31439,18009,6923,2562,3949,2501,1290,17225,784,13430
4100,경기도,수원시다선거구,6410103,4101,수원시장안구,정자3동,관내사전투표,4899,4891,1902,792,1042,636,296,4668,223,8
4100,경기도,수원시다선거구,6410103,4101,수원시장안구,정자3동,선거일투표,26540,13118,5021,1770,2907,1865,994,12557,561,13422
4100,경기도,수원시다선거구,6410103,4101,수원시장안구,잘못 투입·구분된 투표지,,0,23,6,5,7,3,1,22,1,-23
4100,경기도,수원시라선거구,6410104,4102,수원시권선구,합계,,105546,52788,17727,8894,13021,9090,627,49359,3429,52758
4100,경기도,수원시라선거구,6410104,4102,수원시권선구,거소투표,,110,106,35,21,26,13,2,97,9,4
4100,경기도,수원시라선거구,6410104,4102,수원시권선구,관외사전투표,,6114,6108,2236,1019,1491,914,98,5758,350,6
4100,경기도,수원시라선거구,6410104,4102,수원시권선구,서둔동,계,31769,12831,4004,2098,3310,2308,123,11843,988,18938
4100,경기도,수원시라선거구,6410104,4102,수원시권선구,서둔동,관내사전투표,2833,2828,884,502,707,489,21,2603,225,5
4100,경기도,수원시라선거구,6410104,4102,수원시권선구,서둔동,선거일투표,28936,10003,3120,1596,2603,1819,102,9240,763,18933
4100,경기도,수원시라선거구,6410104,4102,수원시권선구,구운동,계,20118,9637,2958,1502,2479,2013,90,9042,595,10481
4100,경기도,수원시라선거구,6410104,4102,수원시권선구,구운동,관내사전투표,2735,2731,871,460,738,509,13,2591,140,4
4100,경기도,수원시라선거구,6410104,4102,수원시권선구,구운동,선거일투표,17383,6906,2087,1042,1741,1504,77,6451,455,10477
4100,경기도,수원시라선거구,6410104,4102,수원시권선구,입북동,계,12937,6874,2509,1127,1590,1143,96,6465,409,6063
4100,경기도,수원시라선거구,6410104,4102,수원시권선구,입북동,관내사전투표,1822,1822,679,337,400,283,20,1719,103,0
4100,경기도,수원시라선거구,6410104,4102,수원시권선구,입북동,선거일투표,11115,5052,1830,790,1190,860,76,4746,306,6063
4100,경기도,수원시라선거구,6410104,4102,수원시권선구,율천동,계,34498,17208,5980,3122,4120,2693,217,16132,1076,17290
4100,경기도,수원시라선거구,6410104,4102,수원시권선구,율천동,관내사전투표,4344,4343,1560,746,1065,636,48,4055,288,1
4100,경기도,수원시라선거구,6410104,4102,수원시권선구,율천동,선거일투표,30154,12865,4420,2376,3055,2057,169,12077,788,17289
4100,경기도,수원시라선거구,6410104,4102,수원시권선구,잘못 투입·구분된 투표지,,0,24,5,5,5,6,1,22,2,-24
4100,경기도,수원시마선거구,6410201,4102,수원시권선구,합계,,107195,54616,14610,5659,4346,13410,4526,9052,51603,3013,52579
4100,경기도,수원시마선거구,6410201,4102,수원시권선구,거소투표,,191,179,36,27,13,48,9,12,145,34,12
4100,경기도,수원시마선거구,6410201,4102,수원시권선구,관외사전투표,,5325,5300,1659,671,354,1435,317,564,5000,300,25
4100,경기도,수원시마선거구,6410201,4102,수원시권선구,평동,계,32793,14929,4219,1923,559,3789,2583,923,13996,933,17864
4100,경기도,수원시마선거구,6410201,4102,수원시권선구,평동,관내사전투표,3884,3870,1136,513,142,902,689,245,3627,243,14
4100,경기도,수원시마선거구,6410201,4102,수원시권선구,평동,선거일투표,28909,11059,3083,1410,417,2887,1894,678,10369,690,17850
4100,경기도,수원시마선거구,6410201,4102,수원시권선구,금곡동,계,35335,18561,4475,1324,1255,4515,754,5273,17596,965,16774
4100,경기도,수원시마선거구,6410201,4102,수원시권선구,금곡동,관내사전투표,5393,5388,1403,442,418,1356,194,1324,5137,251,5
4100,경기도,수원시마선거구,6410201,4102,수원시권선구,금곡동,선거일투표,29942,13173,3072,882,837,3159,560,3949,12459,714,16769
4100,경기도,수원시마선거구,6410201,4102,수원시권선구,호매실동,계,33551,15577,4195,1702,2160,3611,860,2269,14797,780,17974
4100,경기도,수원시마선거구,6410201,4102,수원시권선구,호매실동,관내사전투표,5326,5309,1434,614,686,1214,292,767,5007,302,17
4100,경기도,수원시마선거구,6410201,4102,수원시권선구,호매실동,선거일투표,28225,10268,2761,1088,1474,2397,568,1502,9790,478,17957
4100,경기도,수원시마선거구,6410201,4102,수원시권선구,잘못 투입·구분된 투표지,,0,70,26,12,5,12,3,11,69,1,-70
4100,경기도,수원시카선거구,6410401,4102,수원시권선구,합계,,70578,30845,13682,14969,936,29587,1258,39733
4100,경기도,수원시카선거구,6410401,4102,수원시권선구,거소투표,,76,71,22,37,5,64,7,5
4100,경기도,수원시카선거구,6410401,4102,수원시권선구,관외사전투표,,3787,3785,2013,1604,80,3697,88,2
4100,경기도,수원시카선거구,6410401,4102,수원시권선구,세류1동,계,8800,4523,2051,2238,91,4380,143,4277
4100,경기도,수원시카선거구,6410401,4102,수원시권선구,세류1동,관내사전투표,1762,1762,826,885,37,1748,14,0
4100,경기도,수원시카선거구,6410401,4102,수원시권선구,세류1동,선거일투표,7038,2761,1225,1353,54,2632,129,4277
4100,경기도,수원시카선거구,6410401,4102,수원시권선구,세류2동,계,20875,7684,3242,3722,272,7236,448,13191
4100,경기도,수원시카선거구,6410401,4102,수원시권선구,세류2동,관내사전투표,2287,2286,1050,1095,82,2227,59,1
4100,경기도,수원시카선거구,6410401,4102,수원시권선구,세류2동,선거일투표,18588,5398,2192,2627,190,5009,389,13190
4100,경기도,수원시카선거구,6410401,4102,수원시권선구,세류3동,계,16357,6603,2677,3276,330,6283,320,9754
4100,경기도,수원시카선거구,6410401,4102,수원시권선구,세류3동,관내사전투표,2333,2333,980,1122,170,2272,61,0
4100,경기도,수원시카선거구,6410401,4102,수원시권선구,세류3동,선거일투표,14024,4270,1697,2154,160,4011,259,9754
4100,경기도,수원시카선거구,6410401,4102,수원시권선구,권선1동,계,20683,8170,3674,4088,158,7920,250,12513
4100,경기도,수원시카선거구,6410401,4102,수원시권선구,권선1동,관내사전투표,2060,2059,976,1011,47,2034,25,1
4100,경기도,수원시카선거구,6410401,4102,수원시권선구,권선1동,선거일투표,18623,6111,2698,3077,111,5886,225,12512
4100,경기도,수원시카선거구,6410401,4102,수원시권선구,잘못 투입·구분된 투표지,,0,9,3,4,0,7,2,-9
4100,경기도,수원시타선거구,6410402,4102,수원시권선구,합계,,69088,35516,11166,6603,15307,411,33487,2029,33572
4100,경기도,수원시타선거구,6410402,4102,수원시권선구,거소투표,,76,73,24,10,27,3,64,9,3
4100,경기도,수원시타선거구,6410402,4102,수원시권선구,관외사전투표,,3672,3667,1246,609,1604,83,3542,125,5
4100,경기도,수원시타선거구,6410402,4102,수원시권선구,권선2동,계,36331,19114,5778,3245,8594,177,17794,1320,17217
4100,경기도,수원시타선거구,6410402,4102,수원시권선구,권선2동,관내사전투표,5080,5072,1557,991,2318,38,4904,168,8
4100,경기도,수원시타선거구,6410402,4102,수원시권선구,권선2동,선거일투표,31251,14042,4221,2254,6276,139,12890,1152,17209
4100,경기도,수원시타선거구,6410402,4102,수원시권선구,곡선동,계,29009,12641,4110,2735,5077,148,12070,571,16368
4100,경기도,수원시타선거구,6410402,4102,수원시권선구,곡선동,관내사전투표,3436,3435,1134,795,1396,43,3368,67,1
4100,경기도,수원시타선거구,6410402,4102,수원시권선구,곡선동,선거일투표,25573,9206,2976,1940,3681,105,8702,504,16367
4100,경기도,수원시타선거구,6410402,4102,수원시권선구,잘못 투입·구분된 투표지,,0,21,8,4,5,0,17,4,-21
4100,경기도,수원시바선거구,6410202,4103,수원시팔달구,합계,,75362,38178,18018,12310,6316,36644,1534,37184
4100,경기도,수원시바선거구,6410202,4103,수원시팔달구,거소투표,,90,86,33,22,24,79,7,4
4100,경기도,수원시바선거구,6410202,4103,수원시팔달구,관외사전투표,,4207,4206,2227,1238,644,4109,97,1
4100,경기도,수원시바선거구,6410202,4103,수원시팔달구,매교동,계,5462,2194,929,926,257,2112,82,3268
4100,경기도,수원시바선거구,6410202,4103,수원시팔달구,매교동,관내사전투표,996,996,438,419,102,959,37,0
4100,경기도,수원시바선거구,6410202,4103,수원시팔달구,매교동,선거일투표,4466,1198,491,507,155,1153,45,3268
4100,경기도,수원시바선거구,6410202,4103,수원시팔달구,매산동,계,9341,3773,1458,1647,445,3550,223,5568
4100,경기도,수원시바선거구,6410202,4103,수원시팔달구,매산동,관내사전투표,979,978,428,389,130,947,31,1
4100,경기도,수원시바선거구,6410202,4103,수원시팔달구,매산동,선거일투표,8362,2795,1030,1258,315,2603,192,5567
4100,경기도,수원시바선거구,6410202,4103,수원시팔달구,고등동,계,17038,7816,3721,2667,1104,7492,324,9222
4100,경기도,수원시바선거구,6410202,4103,수원시팔달구,고등동,관내사전투표,2995,2994,1473,1025,401,2899,95,1
4100,경기도,수원시바선거구,6410202,4103,수원시팔달구,고등동,선거일투표,14043,4822,2248,1642,703,4593,229,9221
4100,경기도,수원시바선거구,6410202,4103,수원시팔달구,화서1동,계,18894,8626,3986,2635,1562,8183,443,10268
4100,경기도,수원시바선거구,6410202,4103,수원시팔달구,화서1동,관내사전투표,2625,2625,1250,787,493,2530,95,0
4100,경기도,수원시바선거구,6410202,4103,수원시팔달구,화서1동,선거일투표,16269,6001,2736,1848,1069,5653,348,10268
4100,경기도,수원시바선거구,6410202,4103,수원시팔달구,화서2동,계,20330,11458,5656,3169,2278,11103,355,8872
4100,경기도,수원시바선거구,6410202,4103,수원시팔달구,화서2동,관내사전투표,3557,3557,1923,867,691,3481,76,0
4100,경기도,수원시바선거구,6410202,4103,수원시팔달구,화서2동,선거일투표,16773,7901,3733,2302,1587,7622,279,8872
4100,경기도,수원시바선거구,6410202,4103,수원시팔달구,잘못 투입·구분된 투표지,,0,19,8,6,2,16,3,-19
4100,경기도,수원시사선거구,6410203,4103,수원시팔달구,합계,,88724,41066,13811,5261,11794,6167,1437,38470,2596,47658
4100,경기도,수원시사선거구,6410203,4103,수원시팔달구,거소투표,,110,105,34,11,28,15,10,98,7,5
4100,경기도,수원시사선거구,6410203,4103,수원시팔달구,관외사전투표,,4971,4966,1925,700,1288,595,163,4671,295,5
4100,경기도,수원시사선거구,6410203,4103,수원시팔달구,행궁동,계,9424,4080,1315,470,1375,513,108,3781,299,5344
4100,경기도,수원시사선거구,6410203,4103,수원시팔달구,행궁동,관내사전투표,1365,1361,444,159,466,151,35,1255,106,4
4100,경기도,수원시사선거구,6410203,4103,수원시팔달구,행궁동,선거일투표,8059,2719,871,311,909,362,73,2526,193,5340
4100,경기도,수원시사선거구,6410203,4103,수원시팔달구,지동,계,9575,4343,1281,582,1407,603,82,3955,388,5232
4100,경기도,수원시사선거구,6410203,4103,수원시팔달구,지동,관내사전투표,1897,1879,536,283,609,250,36,1714,165,18
4100,경기도,수원시사선거구,6410203,4103,수원시팔달구,지동,선거일투표,7678,2464,745,299,798,353,46,2241,223,5214
4100,경기도,수원시사선거구,6410203,4103,수원시팔달구,우만1동,계,17434,7658,2629,955,2191,1156,263,7194,464,9776
4100,경기도,수원시사선거구,6410203,4103,수원시팔달구,우만1동,관내사전투표,2117,2116,737,287,581,279,109,1993,123,1
4100,경기도,수원시사선거구,6410203,4103,수원시팔달구,우만1동,선거일투표,15317,5542,1892,668,1610,877,154,5201,341,9775
4100,경기도,수원시사선거구,6410203,4103,수원시팔달구,우만2동,계,14074,7467,2491,944,1976,1349,309,7069,398,6607
4100,경기도,수원시사선거구,6410203,4103,수원시팔달구,우만2동,관내사전투표,2634,2629,918,323,688,439,111,2479,150,5
4100,경기도,수원시사선거구,6410203,4103,수원시팔달구,우만2동,선거일투표,11440,4838,1573,621,1288,910,198,4590,248,6602
4100,경기도,수원시사선거구,6410203,4103,수원시팔달구,인계동,계,33136,12398,4117,1594,3514,1928,502,11655,743,20738
4100,경기도,수원시사선거구,6410203,4103,수원시팔달구,인계동,관내사전투표,2497,2494,862,327,710,349,83,2331,163,3
4100,경기도,수원시사선거구,6410203,4103,수원시팔달구,인계동,선거일투표,30639,9904,3255,1267,2804,1579,419,9324,580,20735
4100,경기도,수원시사선거구,6410203,4103,수원시팔달구,잘못 투입·구분된 투표지,,0,49,19,5,15,8,0,47,2,-49
4100,경기도,수원시아선거구,6410204,4104,수원시영통구,합계,,76503,39309,10573,5889,9189,7423,2602,1237,36913,2396,37194
4100,경기도,수원시아선거구,6410204,4104,수원시영통구,거소투표,,86,80,21,12,23,7,6,2,71,9,6
4100,경기도,수원시아선거구,6410204,4104,수원시영통구,관외사전투표,,4656,4650,1382,762,1217,693,220,107,4381,269,6
4100,경기도,수원시아선거구,6410204,4104,수원시영통구,매탄1동,계,14309,7168,1806,1055,1849,1414,361,170,6655,513,7141
4100,경기도,수원시아선거구,6410204,4104,수원시영통구,매탄1동,관내사전투표,2238,2236,566,367,553,449,93,51,2079,157,2
4100,경기도,수원시아선거구,6410204,4104,수원시영통구,매탄1동,선거일투표,12071,4932,1240,688,1296,965,268,119,4576,356,7139
4100,경기도,수원시아선거구,6410204,4104,수원시영통구,매탄2동,계,12177,5782,1565,779,1362,1163,289,239,5397,385,6395
4100,경기도,수원시아선거구,6410204,4104,수원시영통구,매탄2동,관내사전투표,1954,1952,533,299,409,396,89,78,1804,148,2
4100,경기도,수원시아선거구,6410204,4104,수원시영통구,매탄2동,선거일투표,10223,3830,1032,480,953,767,200,161,3593,237,6393
4100,경기도,수원시아선거구,6410204,4104,수원시영통구,매탄3동,계,27893,13728,3728,2169,3017,2581,1069,390,12954,774,14165
4100,경기도,수원시아선거구,6410204,4104,수원시영통구,매탄3동,관내사전투표,4169,4163,1148,731,834,803,277,109,3902,261,6
4100,경기도,수원시아선거구,6410204,4104,수원시영통구,매탄3동,선거일투표,23724,9565,2580,1438,2183,1778,792,281,9052,513,14159
4100,경기도,수원시아선거구,6410204,4104,수원시영통구,매탄4동,계,17382,7877,2062,1109,1719,1559,656,327,7432,445,9505
4100,경기도,수원시아선거구,6410204,4104,수원시영통구,매탄4동,관내사전투표,2415,2412,671,421,472,419,160,108,2251,161,3
4100,경기도,수원시아선거구,6410204,4104,수원시영통구,매탄4동,선거일투표,14967,5465,1391,688,1247,1140,496,219,5181,284,9502
4100,경기도,수원시아선거구,6410204,4104,수원시영통구,잘못 투입·구분된 투표지,,0,24,9,3,2,6,1,2,23,1,-24
4100,경기도,수원시자선거구,6410301,4104,수원시영통구,검색된 결과가 없습니다.
4100,경기도,수원시차선거구,6410302,4104,수원시영통구,검색된 결과가 없습니다.
4100,경기도,수원시파선거구,6410403,4104,수원시영통구,합계,,94443,50776,17048,8253,11664,9538,2016,48519,2257,43667
4100,경기도,수원시파선거구,6410403,4104,수원시영통구,거소투표,,79,73,29,12,17,9,3,70,3,6
4100,경기도,수원시파선거구,6410403,4104,수원시영통구,관외사전투표,,5150,5138,1668,879,1425,710,179,4861,277,12
4100,경기도,수원시파선거구,6410403,4104,수원시영통구,영통2동,계,21995,10851,3631,1685,2363,2133,541,10353,498,11144
4100,경기도,수원시파선거구,6410403,4104,수원시영통구,영통2동,관내사전투표,3621,3618,1246,667,720,649,160,3442,176,3
4100,경기도,수원시파선거구,6410403,4104,수원시영통구,영통2동,선거일투표,18374,7233,2385,1018,1643,1484,381,6911,322,11141
4100,경기도,수원시파선거구,6410403,4104,수원시영통구,영통3동,계,24882,12566,3974,1987,2798,2700,500,11959,607,12316
4100,경기도,수원시파선거구,6410403,4104,수원시영통구,영통3동,관내사전투표,2497,2493,773,441,580,499,97,2390,103,4
4100,경기도,수원시파선거구,6410403,4104,수원시영통구,영통3동,선거일투표,22385,10073,3201,1546,2218,2201,403,9569,504,12312
4100,경기도,수원시파선거구,6410403,4104,수원시영통구,망포1동,계,21590,10666,3653,1730,2433,2014,343,10173,493,10924
4100,경기도,수원시파선거구,6410403,4104,수원시영통구,망포1동,관내사전투표,2752,2750,960,527,595,474,72,2628,122,2
4100,경기도,수원시파선거구,6410403,4104,수원시영통구,망포1동,선거일투표,18838,7916,2693,1203,1838,1540,271,7545,371,10922
4100,경기도,수원시파선거구,6410403,4104,수원시영통구,망포2동,계,20747,11445,4084,1953,2618,1964,448,11067,378,9302
4100,경기도,수원시파선거구,6410403,4104,수원시영통구,망포2동,관내사전투표,4187,4183,1498,762,904,777,128,4069,114,4
4100,경기도,수원시파선거구,6410403,4104,수원시영통구,망포2동,선거일투표,16560,7262,2586,1191,1714,1187,320,6998,264,9298
4100,경기도,수원시파선거구,6410403,4104,수원시영통구,잘못 투입·구분된 투표지,,0,37,9,7,10,8,2,36,1,-37
4100,경기도,성남시가선거구,6410501,4105,성남시수정구,검색된 결과가 없습니다.
4100,경기도,성남시나선거구,6410502,4105,성남시수정구,합계,,41355,22397,10319,6997,4208,21524,873,18958
4100,경기도,성남시나선거구,6410502,4105,성남시수정구,거소투표,,44,44,24,12,8,44,0,0
4100,경기도,성남시나선거구,6410502,4105,성남시수정구,관외사전투표,,3674,3673,1864,1205,500,3569,104,1
4100,경기도,성남시나선거구,6410502,4105,성남시수정구,신흥2동,계,14835,7811,3213,2506,1762,7481,330,7024
4100,경기도,성남시나선거구,6410502,4105,성남시수정구,신흥2동,관내사전투표,1913,1913,844,611,411,1866,47,0
4100,경기도,성남시나선거구,6410502,4105,성남시수정구,신흥2동,선거일투표,12922,5898,2369,1895,1351,5615,283,7024
4100,경기도,성남시나선거구,6410502,4105,성남시수정구,신흥3동,계,10553,4699,2256,1516,771,4543,156,5854
4100,경기도,성남시나선거구,6410502,4105,성남시수정구,신흥3동,관내사전투표,2401,2401,1116,781,424,2321,80,0
4100,경기도,성남시나선거구,6410502,4105,성남시수정구,신흥3동,선거일투표,8152,2298,1140,735,347,2222,76,5854
4100,경기도,성남시나선거구,6410502,4105,성남시수정구,단대동,계,12249,6159,2958,1755,1167,5880,279,6090
4100,경기도,성남시나선거구,6410502,4105,성남시수정구,단대동,관내사전투표,2009,2008,1032,581,361,1974,34,1
4100,경기도,성남시나선거구,6410502,4105,성남시수정구,단대동,선거일투표,10240,4151,1926,1174,806,3906,245,6089
4100,경기도,성남시나선거구,6410502,4105,성남시수정구,잘못 투입·구분된 투표지,,0,11,4,3,0,7,4,-11
4100,경기도,성남시다선거구,6410503,4105,성남시수정구,합계,,52350,25198,12067,6590,1724,3343,23724,1474,27152
4100,경기도,성남시다선거구,6410503,4105,성남시수정구,거소투표,,43,42,20,8,3,5,36,6,1
4100,경기도,성남시다선거구,6410503,4105,성남시수정구,관외사전투표,,3340,3338,1758,996,198,273,3225,113,2
4100,경기도,성남시다선거구,6410503,4105,성남시수정구,태평1동,계,13607,6118,2906,1676,302,912,5796,322,7489
4100,경기도,성남시다선거구,6410503,4105,성남시수정구,태평1동,관내사전투표,2366,2366,1190,663,108,342,2303,63,0
4100,경기도,성남시다선거구,6410503,4105,성남시수정구,태평1동,선거일투표,11241,3752,1716,1013,194,570,3493,259,7489
4100,경기도,성남시다선거구,6410503,4105,성남시수정구,태평2동,계,12696,5482,2552,1359,419,736,5066,416,7214
4100,경기도,성남시다선거구,6410503,4105,성남시수정구,태평2동,관내사전투표,1672,1671,844,413,127,216,1600,71,1
4100,경기도,성남시다선거구,6410503,4105,성남시수정구,태평2동,선거일투표,11024,3811,1708,946,292,520,3466,345,7213
4100,경기도,성남시다선거구,6410503,4105,성남시수정구,태평3동,계,11922,5659,2651,1423,374,899,5347,312,6263
4100,경기도,성남시다선거구,6410503,4105,성남시수정구,태평3동,관내사전투표,2427,2425,1247,581,151,373,2352,73,2
4100,경기도,성남시다선거구,6410503,4105,성남시수정구,태평3동,선거일투표,9495,3234,1404,842,223,526,2995,239,6261
4100,경기도,성남시다선거구,6410503,4105,성남시수정구,태평4동,계,10742,4546,2174,1125,426,516,4241,305,6196
4100,경기도,성남시다선거구,6410503,4105,성남시수정구,태평4동,관내사전투표,1927,1926,919,504,192,227,1842,84,1
4100,경기도,성남시다선거구,6410503,4105,성남시수정구,태평4동,선거일투표,8815,2620,1255,621,234,289,2399,221,6195
4100,경기도,성남시다선거구,6410503,4105,성남시수정구,잘못 투입·구분된 투표지,,0,13,6,3,2,2,13,0,-13
4100,경기도,성남시라선거구,6410504,4105,성남시수정구,합계,,60402,32626,14107,10920,4361,1882,31270,1356,27776
4100,경기도,성남시라선거구,6410504,4105,성남시수정구,거소투표,,56,50,21,21,6,0,48,2,6
4100,경기도,성남시라선거구,6410504,4105,성남시수정구,관외사전투표,,3895,3894,1839,1388,405,166,3798,96,1
4100,경기도,성남시라선거구,6410504,4105,성남시수정구,산성동,계,4294,2090,930,551,245,236,1962,128,2204
4100,경기도,성남시라선거구,6410504,4105,성남시수정구,산성동,관내사전투표,730,729,337,203,86,75,701,28,1
4100,경기도,성남시라선거구,6410504,4105,성남시수정구,산성동,선거일투표,3564,1361,593,348,159,161,1261,100,2203
4100,경기도,성남시라선거구,6410504,4105,성남시수정구,양지동,계,8173,3846,1754,1150,436,312,3652,194,4327
4100,경기도,성남시라선거구,6410504,4105,성남시수정구,양지동,관내사전투표,1501,1500,697,442,191,125,1455,45,1
4100,경기도,성남시라선거구,6410504,4105,성남시수정구,양지동,선거일투표,6672,2346,1057,708,245,187,2197,149,4326
4100,경기도,성남시라선거구,6410504,4105,성남시수정구,복정동,계,9520,4123,2008,1293,413,232,3946,177,5397
4100,경기도,성남시라선거구,6410504,4105,성남시수정구,복정동,관내사전투표,1568,1568,802,482,162,81,1527,41,0
4100,경기도,성남시라선거구,6410504,4105,성남시수정구,복정동,선거일투표,7952,2555,1206,811,251,151,2419,136,5397
4100,경기도,성남시라선거구,6410504,4105,성남시수정구,위례동,계,34464,18598,7547,6507,2853,934,17841,757,15866
4100,경기도,성남시라선거구,6410504,4105,성남시수정구,위례동,관내사전투표,5655,5650,2464,1908,895,251,5518,132,5
4100,경기도,성남시라선거구,6410504,4105,성남시수정구,위례동,선거일투표,28809,12948,5083,4599,1958,683,12323,625,15861
4100,경기도,성남시라선거구,6410504,4105,성남시수정구,잘못 투입·구분된 투표지,,0,25,8,10,3,2,23,2,-25
4100,경기도,성남시마선거구,6410601,4106,성남시중원구,합계,,44857,21261,8507,3217,8527,20251,1010,23596
4100,경기도,성남시마선거구,6410601,4106,성남시중원구,거소투표,,57,54,23,8,19,50,4,3
4100,경기도,성남시마선거구,6410601,4106,성남시중원구,관외사전투표,,2619,2615,1140,377,1019,2536,79,4
4100,경기도,성남시마선거구,6410601,4106,성남시중원구,상대원1동,계,20470,9095,3575,1447,3588,8610,485,11375
4100,경기도,성남시마선거구,6410601,4106,성남시중원구,상대원1동,관내사전투표,2375,2375,970,366,972,2308,67,0
4100,경기도,성남시마선거구,6410601,4106,성남시중원구,상대원1동,선거일투표,18095,6720,2605,1081,2616,6302,418,11375
4100,경기도,성남시마선거구,6410601,4106,성남시중원구,상대원2동,계,10979,4821,1900,718,1989,4607,214,6158
4100,경기도,성남시마선거구,6410601,4106,성남시중원구,상대원2동,관내사전투표,2146,2141,832,339,887,2058,83,5
4100,경기도,성남시마선거구,6410601,4106,성남시중원구,상대원2동,선거일투표,8833,2680,1068,379,1102,2549,131,6153
4100,경기도,성남시마선거구,6410601,4106,성남시중원구,상대원3동,계,10732,4659,1864,664,1905,4433,226,6073
4100,경기도,성남시마선거구,6410601,4106,성남시중원구,상대원3동,관내사전투표,2071,2070,849,295,836,1980,90,1
4100,경기도,성남시마선거구,6410601,4106,성남시중원구,상대원3동,선거일투표,8661,2589,1015,369,1069,2453,136,6072
4100,경기도,성남시마선거구,6410601,4106,성남시중원구,잘못 투입·구분된 투표지,,0,17,5,3,7,15,2,-17
4100,경기도,성남시바선거구,6410602,4106,성남시중원구,검색된 결과가 없습니다.
4100,경기도,성남시사선거구,6410603,4106,성남시중원구,합계,,69429,35459,11428,4852,6415,7158,2749,189,32791,2668,33970
4100,경기도,성남시사선거구,6410603,4106,성남시중원구,거소투표,,106,100,30,9,20,14,3,1,77,23,6
4100,경기도,성남시사선거구,6410603,4106,성남시중원구,관외사전투표,,5038,5028,1883,710,986,793,295,45,4712,316,10
4100,경기도,성남시사선거구,6410603,4106,성남시중원구,중앙동,계,9774,4794,1619,499,982,907,313,30,4350,444,4980
4100,경기도,성남시사선거구,6410603,4106,성남시중원구,중앙동,관내사전투표,1810,1807,589,217,343,359,120,9,1637,170,3
4100,경기도,성남시사선거구,6410603,4106,성남시중원구,중앙동,선거일투표,7964,2987,1030,282,639,548,193,21,2713,274,4977
4100,경기도,성남시사선거구,6410603,4106,성남시중원구,금광1동,계,5837,2799,1036,345,519,536,183,14,2633,166,3038
4100,경기도,성남시사선거구,6410603,4106,성남시중원구,금광1동,관내사전투표,1077,1055,395,143,158,216,61,5,978,77,22
4100,경기도,성남시사선거구,6410603,4106,성남시중원구,금광1동,선거일투표,4760,1744,641,202,361,320,122,9,1655,89,3016
4100,경기도,성남시사선거구,6410603,4106,성남시중원구,금광2동,계,20538,9316,2853,1194,1660,2177,767,41,8692,624,11222
4100,경기도,성남시사선거구,6410603,4106,성남시중원구,금광2동,관내사전투표,3402,3395,1020,518,606,729,265,17,3155,240,7
4100,경기도,성남시사선거구,6410603,4106,성남시중원구,금광2동,선거일투표,17136,5921,1833,676,1054,1448,502,24,5537,384,11215
4100,경기도,성남시사선거구,6410603,4106,성남시중원구,은행1동,계,8475,4087,1182,633,586,917,420,17,3755,332,4388
4100,경기도,성남시사선거구,6410603,4106,성남시중원구,은행1동,관내사전투표,1854,1851,547,327,253,402,180,5,1714,137,3
4100,경기도,성남시사선거구,6410603,4106,성남시중원구,은행1동,선거일투표,6621,2236,635,306,333,515,240,12,2041,195,4385
4100,경기도,성남시사선거구,6410603,4106,성남시중원구,은행2동,계,19661,9270,2804,1450,1652,1801,766,41,8514,756,10391
4100,경기도,성남시사선거구,6410603,4106,성남시중원구,은행2동,관내사전투표,3234,3227,997,569,571,656,232,8,3033,194,7
4100,경기도,성남시사선거구,6410603,4106,성남시중원구,은행2동,선거일투표,16427,6043,1807,881,1081,1145,534,33,5481,562,10384
4100,경기도,성남시사선거구,6410603,4106,성남시중원구,잘못 투입·구분된 투표지,,0,65,21,12,10,13,2,0,58,7,-65
4100,경기도,성남시아선거구,6410701,4107,성남시분당구,합계,,51348,33275,12799,14081,5508,32388,887,18073
4100,경기도,성남시아선거구,6410701,4107,성남시분당구,거소투표,,56,53,26,22,2,50,3,3
4100,경기도,성남시아선거구,6410701,4107,성남시분당구,관외사전투표,,3120,3114,1429,1253,358,3040,74,6
4100,경기도,성남시아선거구,6410701,4107,성남시분당구,이매1동,계,19350,12325,4459,5631,1919,12009,316,7025
4100,경기도,성남시아선거구,6410701,4107,성남시분당구,이매1동,관내사전투표,3127,3121,1217,1318,543,3078,43,6
4100,경기도,성남시아선거구,6410701,4107,성남시분당구,이매1동,선거일투표,16223,9204,3242,4313,1376,8931,273,7019
4100,경기도,성남시아선거구,6410701,4107,성남시분당구,이매2동,계,10486,6875,2198,2839,1651,6688,187,3611
4100,경기도,성남시아선거구,6410701,4107,성남시분당구,이매2동,관내사전투표,2182,2160,781,805,512,2098,62,22
4100,경기도,성남시아선거구,6410701,4107,성남시분당구,이매2동,선거일투표,8304,4715,1417,2034,1139,4590,125,3589
4100,경기도,성남시아선거구,6410701,4107,성남시분당구,삼평동,계,18336,10827,4657,4299,1566,10522,305,7509
4100,경기도,성남시아선거구,6410701,4107,성남시분당구,삼평동,관내사전투표,3197,3162,1573,1067,461,3101,61,35
4100,경기도,성남시아선거구,6410701,4107,성남시분당구,삼평동,선거일투표,15139,7665,3084,3232,1105,7421,244,7474
4100,경기도,성남시아선거구,6410701,4107,성남시분당구,잘못 투입·구분된 투표지,,0,81,30,37,12,79,2,-81
4100,경기도,성남시자선거구,6410702,4107,성남시분당구,합계,,53271,33486,13176,19163,156,32495,991,19785
4100,경기도,성남시자선거구,6410702,4107,성남시분당구,거소투표,,118,111,24,46,2,72,39,7
4100,경기도,성남시자선거구,6410702,4107,성남시분당구,관외사전투표,,3243,3235,1534,1623,15,3172,63,8
4100,경기도,성남시자선거구,6410702,4107,성남시분당구,야탑1동,계,15195,9583,3688,5606,36,9330,253,5612
4100,경기도,성남시자선거구,6410702,4107,성남시분당구,야탑1동,관내사전투표,3623,3600,1548,1989,10,3547,53,23
4100,경기도,성남시자선거구,6410702,4107,성남시분당구,야탑1동,선거일투표,11572,5983,2140,3617,26,5783,200,5589
4100,경기도,성남시자선거구,6410702,4107,성남시분당구,야탑2동,계,12782,8341,2739,5358,35,8132,209,4441
4100,경기도,성남시자선거구,6410702,4107,성남시분당구,야탑2동,관내사전투표,2352,2343,879,1421,8,2308,35,9
4100,경기도,성남시자선거구,6410702,4107,성남시분당구,야탑2동,선거일투표,10430,5998,1860,3937,27,5824,174,4432
4100,경기도,성남시자선거구,6410702,4107,성남시분당구,야탑3동,계,21933,12137,5160,6485,67,11712,425,9796
4100,경기도,성남시자선거구,6410702,4107,성남시분당구,야탑3동,관내사전투표,3145,3092,1424,1585,14,3023,69,53
4100,경기도,성남시자선거구,6410702,4107,성남시분당구,야탑3동,선거일투표,18788,9045,3736,4900,53,8689,356,9743
4100,경기도,성남시자선거구,6410702,4107,성남시분당구,잘못 투입·구분된 투표지,,0,79,31,45,1,77,2,-79
4100,경기도,성남시차선거구,6410703,4107,성남시분당구,검색된 결과가 없습니다.
4100,경기도,성남시카선거구,6410704,4107,성남시분당구,합계,,68503,43971,17859,17687,5358,2093,42997,974,24532
4100,경기도,성남시카선거구,6410704,4107,성남시분당구,거소투표,,74,72,25,30,8,4,67,5,2
4100,경기도,성남시카선거구,6410704,4107,성남시분당구,관외사전투표,,4317,4310,1859,1831,399,121,4210,100,7
4100,경기도,성남시카선거구,6410704,4107,성남시분당구,판교동,계,19110,12111,4763,4760,1626,776,11925,186,6999
4100,경기도,성남시카선거구,6410704,4107,성남시분당구,판교동,관내사전투표,3503,3484,1434,1351,470,172,3427,57,19
4100,경기도,성남시카선거구,6410704,4107,성남시분당구,판교동,선거일투표,15607,8627,3329,3409,1156,604,8498,129,6980
4100,경기도,성남시카선거구,6410704,4107,성남시분당구,백현동,계,20607,12299,5122,4913,1490,417,11942,357,8308
4100,경기도,성남시카선거구,6410704,4107,성남시분당구,백현동,관내사전투표,3438,3428,1539,1305,409,87,3340,88,10
4100,경기도,성남시카선거구,6410704,4107,성남시분당구,백현동,선거일투표,17169,8871,3583,3608,1081,330,8602,269,8298
4100,경기도,성남시카선거구,6410704,4107,성남시분당구,운중동,계,24395,15108,6059,6126,1826,772,14783,325,9287
4100,경기도,성남시카선거구,6410704,4107,성남시분당구,운중동,관내사전투표,3510,3487,1503,1362,401,159,3425,62,23
4100,경기도,성남시카선거구,6410704,4107,성남시분당구,운중동,선거일투표,20885,11621,4556,4764,1425,613,11358,263,9264
4100,경기도,성남시카선거구,6410704,4107,성남시분당구,잘못 투입·구분된 투표지,,0,71,31,27,9,3,70,1,-71
4100,경기도,성남시타선거구,6410705,4107,성남시분당구,합계,,86151,51780,15013,5081,19427,5333,3048,867,380,49149,2631,34371
4100,경기도,성남시타선거구,6410705,4107,성남시분당구,거소투표,,81,78,26,12,22,6,3,1,1,71,7,3
4100,경기도,성남시타선거구,6410705,4107,성남시분당구,관외사전투표,,6629,6627,2294,753,2253,535,302,68,67,6272,355,2
4100,경기도,성남시타선거구,6410705,4107,성남시분당구,분당동,계,19349,10582,2938,1073,3884,1261,621,203,58,10038,544,8767
4100,경기도,성남시타선거구,6410705,4107,성남시분당구,분당동,관내사전투표,2201,2193,604,260,770,254,118,43,6,2055,138,8
4100,경기도,성남시타선거구,6410705,4107,성남시분당구,분당동,선거일투표,17148,8389,2334,813,3114,1007,503,160,52,7983,406,8759
4100,경기도,성남시타선거구,6410705,4107,성남시분당구,수내3동,계,10386,5840,1642,580,2096,685,481,61,31,5576,264,4546
4100,경기도,성남시타선거구,6410705,4107,성남시분당구,수내3동,관내사전투표,1983,1982,636,256,639,192,149,16,9,1897,85,1
4100,경기도,성남시타선거구,6410705,4107,성남시분당구,수내3동,선거일투표,8403,3858,1006,324,1457,493,332,45,22,3679,179,4545
4100,경기도,성남시타선거구,6410705,4107,성남시분당구,정자2동,계,12448,7044,2065,722,2678,607,453,79,45,6649,395,5404
4100,경기도,성남시타선거구,6410705,4107,성남시분당구,정자2동,관내사전투표,1910,1902,581,237,722,122,95,26,7,1790,112,8
4100,경기도,성남시타선거구,6410705,4107,성남시분당구,정자2동,선거일투표,10538,5142,1484,485,1956,485,358,53,38,4859,283,5396
4100,경기도,성남시타선거구,6410705,4107,성남시분당구,정자3동,계,13089,7695,2175,700,2850,883,540,128,55,7331,364,5394
4100,경기도,성남시타선거구,6410705,4107,성남시분당구,정자3동,관내사전투표,2441,2438,733,268,890,241,146,38,13,2329,109,3
4100,경기도,성남시타선거구,6410705,4107,성남시분당구,정자3동,선거일투표,10648,5257,1442,432,1960,642,394,90,42,5002,255,5391
4100,경기도,성남시타선거구,6410705,4107,성남시분당구,구미동,계,24169,13884,3860,1240,5634,1352,647,327,122,13182,702,10285
4100,경기도,성남시타선거구,6410705,4107,성남시분당구,구미동,관내사전투표,3318,3311,934,358,1337,299,134,71,33,3166,145,7
4100,경기도,성남시타선거구,6410705,4107,성남시분당구,구미동,선거일투표,20851,10573,2926,882,4297,1053,513,256,89,10016,557,10278
4100,경기도,성남시타선거구,6410705,4107,성남시분당구,잘못 투입·구분된 투표지,,0,30,13,1,10,4,1,0,1,30,0,-30
4100,경기도,성남시파선거구,6410706,4107,성남시분당구,합계,,48488,28808,10171,14463,3443,28077,731,19680
4100,경기도,성남시파선거구,6410706,4107,성남시분당구,거소투표,,41,39,14,20,4,38,1,2
4100,경기도,성남시파선거구,6410706,4107,성남시분당구,관외사전투표,,2825,2823,1202,1313,249,2764,59,2
4100,경기도,성남시파선거구,6410706,4107,성남시분당구,수내1동,계,14283,8351,3240,3880,1018,8138,213,5932
4100,경기도,성남시파선거구,6410706,4107,성남시분당구,수내1동,관내사전투표,2651,2644,1184,1137,279,2600,44,7
4100,경기도,성남시파선거구,6410706,4107,성남시분당구,수내1동,선거일투표,11632,5707,2056,2743,739,5538,169,5925
4100,경기도,성남시파선거구,6410706,4107,성남시분당구,수내2동,계,7251,4633,1755,2249,540,4544,89,2618
4100,경기도,성남시파선거구,6410706,4107,성남시분당구,수내2동,관내사전투표,1316,1314,537,617,125,1279,35,2
4100,경기도,성남시파선거구,6410706,4107,성남시분당구,수내2동,선거일투표,5935,3319,1218,1632,415,3265,54,2616
4100,경기도,성남시파선거구,6410706,4107,성남시분당구,정자1동,계,24088,12926,3946,6982,1630,12558,368,11162
4100,경기도,성남시파선거구,6410706,4107,성남시분당구,정자1동,관내사전투표,3095,3083,1075,1656,311,3042,41,12
4100,경기도,성남시파선거구,6410706,4107,성남시분당구,정자1동,선거일투표,20993,9843,2871,5326,1319,9516,327,11150
4100,경기도,성남시파선거구,6410706,4107,성남시분당구,잘못 투입·구분된 투표지,,0,36,14,19,2,35,1,-36
4100,경기도,성남시하선거구,6410707,4107,성남시분당구,검색된 결과가 없습니다.
4100,경기도,의정부시가선거구,6410801,4108,의정부시,합계,,89180,37045,16477,15036,3675,35188,1857,52135
4100,경기도,의정부시가선거구,6410801,4108,의정부시,거소투표,,162,149,64,46,21,131,18,13
4100,경기도,의정부시가선거구,6410801,4108,의정부시,관외사전투표,,4556,4556,2340,1704,375,4419,137,0
4100,경기도,의정부시가선거구,6410801,4108,의정부시,의정부1동,계,28647,9083,3806,3870,869,8545,538,19564
4100,경기도,의정부시가선거구,6410801,4108,의정부시,의정부1동,관내사전투표,2452,2444,1040,1079,230,2349,95,8
4100,경기도,의정부시가선거구,6410801,4108,의정부시,의정부1동,선거일투표,26195,6639,2766,2791,639,6196,443,19556
4100,경기도,의정부시가선거구,6410801,4108,의정부시,가능동,계,21733,8551,3652,3446,939,8037,514,13182
4100,경기도,의정부시가선거구,6410801,4108,의정부시,가능동,관내사전투표,3295,3291,1416,1398,368,3182,109,4
4100,경기도,의정부시가선거구,6410801,4108,의정부시,가능동,선거일투표,18438,5260,2236,2048,571,4855,405,13178
4100,경기도,의정부시가선거구,6410801,4108,의정부시,흥선동,계,16413,6601,2923,2692,611,6226,375,9812
4100,경기도,의정부시가선거구,6410801,4108,의정부시,흥선동,관내사전투표,2357,2355,1093,987,214,2294,61,2
4100,경기도,의정부시가선거구,6410801,4108,의정부시,흥선동,선거일투표,14056,4246,1830,1705,397,3932,314,9810
4100,경기도,의정부시가선거구,6410801,4108,의정부시,녹양동,계,17669,8059,3676,3266,854,7796,263,9610
4100,경기도,의정부시가선거구,6410801,4108,의정부시,녹양동,관내사전투표,3132,3131,1434,1299,312,3045,86,1
4100,경기도,의정부시가선거구,6410801,4108,의정부시,녹양동,선거일투표,14537,4928,2242,1967,542,4751,177,9609
4100,경기도,의정부시가선거구,6410801,4108,의정부시,잘못 투입·구분된 투표지,,0,46,16,12,6,34,12,-46
4100,경기도,의정부시나선거구,6410802,4108,의정부시,합계,,89471,43957,14468,7483,12223,5506,39680,4277,45514
4100,경기도,의정부시나선거구,6410802,4108,의정부시,거소투표,,124,119,47,13,33,11,104,15,5
4100,경기도,의정부시나선거구,6410802,4108,의정부시,관외사전투표,,4065,4063,1503,719,1099,370,3691,372,2
4100,경기도,의정부시나선거구,6410802,4108,의정부시,의정부2동,계,26263,9873,3128,1806,2855,1040,8829,1044,16390
4100,경기도,의정부시나선거구,6410802,4108,의정부시,의정부2동,관내사전투표,2383,2382,767,491,686,231,2175,207,1
4100,경기도,의정부시나선거구,6410802,4108,의정부시,의정부2동,선거일투표,23880,7491,2361,1315,2169,809,6654,837,16389
4100,경기도,의정부시나선거구,6410802,4108,의정부시,호원1동,계,30175,14748,5116,2208,4303,1678,13305,1443,15427
4100,경기도,의정부시나선거구,6410802,4108,의정부시,호원1동,관내사전투표,4888,4873,1756,747,1454,516,4473,400,15
4100,경기도,의정부시나선거구,6410802,4108,의정부시,호원1동,선거일투표,25287,9875,3360,1461,2849,1162,8832,1043,15412
4100,경기도,의정부시나선거구,6410802,4108,의정부시,호원2동,계,28844,15112,4664,2733,3921,2401,13719,1393,13732
4100,경기도,의정부시나선거구,6410802,4108,의정부시,호원2동,관내사전투표,5773,5765,1814,1149,1420,875,5258,507,8
4100,경기도,의정부시나선거구,6410802,4108,의정부시,호원2동,선거일투표,23071,9347,2850,1584,2501,1526,8461,886,13724
4100,경기도,의정부시나선거구,6410802,4108,의정부시,잘못 투입·구분된 투표지,,0,42,10,4,12,6,32,10,-42
4100,경기도,의정부시다선거구,6410803,4108,의정부시,합계,,117623,58782,19252,7557,17438,6377,1424,2241,810,55099,3683,58841
4100,경기도,의정부시다선거구,6410803,4108,의정부시,거소투표,,181,162,59,23,34,22,4,4,7,153,9,19
4100,경기도,의정부시다선거구,6410803,4108,의정부시,관외사전투표,,5760,5760,2044,739,1534,655,151,210,95,5428,332,0
4100,경기도,의정부시다선거구,6410803,4108,의정부시,장암동,계,16293,8410,2654,1198,2517,886,194,357,71,7877,533,7883
4100,경기도,의정부시다선거구,6410803,4108,의정부시,장암동,관내사전투표,2745,2745,843,400,835,278,70,101,23,2550,195,0
4100,경기도,의정부시다선거구,6410803,4108,의정부시,장암동,선거일투표,13548,5665,1811,798,1682,608,124,256,48,5327,338,7883
4100,경기도,의정부시다선거구,6410803,4108,의정부시,신곡1동,계,34451,16063,5173,2260,4921,1515,442,635,141,15087,976,18388
4100,경기도,의정부시다선거구,6410803,4108,의정부시,신곡1동,관내사전투표,4545,4543,1487,754,1369,349,132,139,32,4262,281,2
4100,경기도,의정부시다선거구,6410803,4108,의정부시,신곡1동,선거일투표,29906,11520,3686,1506,3552,1166,310,496,109,10825,695,18386
4100,경기도,의정부시다선거구,6410803,4108,의정부시,신곡2동,계,38551,18750,6151,2277,5439,2343,403,724,192,17529,1221,19801
4100,경기도,의정부시다선거구,6410803,4108,의정부시,신곡2동,관내사전투표,5303,5298,1757,631,1550,638,96,170,48,4890,408,5
4100,경기도,의정부시다선거구,6410803,4108,의정부시,신곡2동,선거일투표,33248,13452,4394,1646,3889,1705,307,554,144,12639,813,19796
4100,경기도,의정부시다선거구,6410803,4108,의정부시,자금동,계,22387,9622,3169,1060,2986,955,229,309,304,9012,610,12765
4100,경기도,의정부시다선거구,6410803,4108,의정부시,자금동,관내사전투표,2511,2511,821,315,762,247,64,83,61,2353,158,0
4100,경기도,의정부시다선거구,6410803,4108,의정부시,자금동,선거일투표,19876,7111,2348,745,2224,708,165,226,243,6659,452,12765
4100,경기도,의정부시다선거구,6410803,4108,의정부시,잘못 투입·구분된 투표지,,0,15,2,0,7,1,1,2,0,13,2,-15
4100,경기도,의정부시라선거구,6410804,4108,의정부시,합계,,103903,48049,17409,5286,14141,5142,2960,44938,3111,55854
4100,경기도,의정부시라선거구,6410804,4108,의정부시,거소투표,,150,143,59,17,39,9,6,130,13,7
4100,경기도,의정부시라선거구,6410804,4108,의정부시,관외사전투표,,4967,4965,1939,546,1500,381,284,4650,315,2
4100,경기도,의정부시라선거구,6410804,4108,의정부시,송산1동,계,37448,15543,5537,1630,4680,1780,835,14462,1081,21905
4100,경기도,의정부시라선거구,6410804,4108,의정부시,송산1동,관내사전투표,3967,3963,1432,417,1196,461,183,3689,274,4
4100,경기도,의정부시라선거구,6410804,4108,의정부시,송산1동,선거일투표,33481,11580,4105,1213,3484,1319,652,10773,807,21901
4100,경기도,의정부시라선거구,6410804,4108,의정부시,송산2동,계,26770,12280,4452,1418,3610,1351,668,11499,781,14490
4100,경기도,의정부시라선거구,6410804,4108,의정부시,송산2동,관내사전투표,4188,4184,1554,526,1199,425,204,3908,276,4
4100,경기도,의정부시라선거구,6410804,4108,의정부시,송산2동,선거일투표,22582,8096,2898,892,2411,926,464,7591,505,14486
4100,경기도,의정부시라선거구,6410804,4108,의정부시,송산3동,계,34568,15099,5416,1673,4307,1620,1164,14180,919,19469
4100,경기도,의정부시라선거구,6410804,4108,의정부시,송산3동,관내사전투표,4867,4867,1727,593,1379,517,337,4553,314,0
4100,경기도,의정부시라선거구,6410804,4108,의정부시,송산3동,선거일투표,29701,10232,3689,1080,2928,1103,827,9627,605,19469
4100,경기도,의정부시라선거구,6410804,4108,의정부시,잘못 투입·구분된 투표지,,0,19,6,2,5,1,3,17,2,-19
4100,경기도,안양시가선거구,6410901,4109,안양시만안구,합계,,56742,29709,9329,6052,12967,28348,1361,27033
4100,경기도,안양시가선거구,6410901,4109,안양시만안구,거소투표,,81,79,28,14,27,69,10,2
4100,경기도,안양시가선거구,6410901,4109,안양시만안구,관외사전투표,,2731,2725,1000,512,1129,2641,84,6
4100,경기도,안양시가선거구,6410901,4109,안양시만안구,안양1동,계,10151,5362,1777,984,2348,5109,253,4789
4100,경기도,안양시가선거구,6410901,4109,안양시만안구,안양1동,관내사전투표,1820,1820,636,378,747,1761,59,0
4100,경기도,안양시가선거구,6410901,4109,안양시만안구,안양1동,선거일투표,8331,3542,1141,606,1601,3348,194,4789
4100,경기도,안양시가선거구,6410901,4109,안양시만안구,안양3동,계,14256,6845,2141,1544,2894,6579,266,7411
4100,경기도,안양시가선거구,6410901,4109,안양시만안구,안양3동,관내사전투표,2689,2687,872,665,1079,2616,71,2
4100,경기도,안양시가선거구,6410901,4109,안양시만안구,안양3동,선거일투표,11567,4158,1269,879,1815,3963,195,7409
4100,경기도,안양시가선거구,6410901,4109,안양시만안구,안양4동,계,6412,3377,1053,679,1509,3241,136,3035
4100,경기도,안양시가선거구,6410901,4109,안양시만안구,안양4동,관내사전투표,1531,1530,485,334,639,1458,72,1
4100,경기도,안양시가선거구,6410901,4109,안양시만안구,안양4동,선거일투표,4881,1847,568,345,870,1783,64,3034
4100,경기도,안양시가선거구,6410901,4109,안양시만안구,안양5동,계,8912,4134,1213,756,1938,3907,227,4778
4100,경기도,안양시가선거구,6410901,4109,안양시만안구,안양5동,관내사전투표,1558,1558,444,305,721,1470,88,0
4100,경기도,안양시가선거구,6410901,4109,안양시만안구,안양5동,선거일투표,7354,2576,769,451,1217,2437,139,4778
4100,경기도,안양시가선거구,6410901,4109,안양시만안구,안양9동,계,14199,7156,2108,1560,3108,6776,380,7043
4100,경기도,안양시가선거구,6410901,4109,안양시만안구,안양9동,관내사전투표,2633,2625,799,589,1144,2532,93,8
4100,경기도,안양시가선거구,6410901,4109,안양시만안구,안양9동,선거일투표,11566,4531,1309,971,1964,4244,287,7035
4100,경기도,안양시가선거구,6410901,4109,안양시만안구,잘못 투입·구분된 투표지,,0,31,9,3,14,26,5,-31
4100,경기도,안양시나선거구,6410902,4109,안양시만안구,합계,,45765,23574,7932,3928,7298,2271,21429,2145,22191
4100,경기도,안양시나선거구,6410902,4109,안양시만안구,거소투표,,46,42,10,7,14,4,35,7,4
4100,경기도,안양시나선거구,6410902,4109,안양시만안구,관외사전투표,,2624,2623,947,407,808,214,2376,247,1
4100,경기도,안양시나선거구,6410902,4109,안양시만안구,안양6동,계,21753,9828,3390,1633,2940,990,8953,875,11925
4100,경기도,안양시나선거구,6410902,4109,안양시만안구,안양6동,관내사전투표,2824,2823,1008,445,813,285,2551,272,1
4100,경기도,안양시나선거구,6410902,4109,안양시만안구,안양6동,선거일투표,18929,7005,2382,1188,2127,705,6402,603,11924
4100,경기도,안양시나선거구,6410902,4109,안양시만안구,안양7동,계,12171,6745,2220,1082,2229,654,6185,560,5426
4100,경기도,안양시나선거구,6410902,4109,안양시만안구,안양7동,관내사전투표,2564,2563,819,459,818,234,2330,233,1
4100,경기도,안양시나선거구,6410902,4109,안양시만안구,안양7동,선거일투표,9607,4182,1401,623,1411,420,3855,327,5425
4100,경기도,안양시나선거구,6410902,4109,안양시만안구,안양8동,계,9171,4317,1358,795,1303,409,3865,452,4854
4100,경기도,안양시나선거구,6410902,4109,안양시만안구,안양8동,관내사전투표,1867,1862,559,379,550,174,1662,200,5
4100,경기도,안양시나선거구,6410902,4109,안양시만안구,안양8동,선거일투표,7304,2455,799,416,753,235,2203,252,4849
4100,경기도,안양시나선거구,6410902,4109,안양시만안구,잘못 투입·구분된 투표지,,0,19,7,4,4,0,15,4,-19
4100,경기도,안양시다선거구,6410903,4109,안양시만안구,합계,,50983,26548,7628,5074,7316,3948,773,24739,1809,24435
4100,경기도,안양시다선거구,6410903,4109,안양시만안구,거소투표,,78,77,18,7,17,7,9,58,19,1
4100,경기도,안양시다선거구,6410903,4109,안양시만안구,관외사전투표,,2783,2778,885,520,809,302,99,2615,163,5
4100,경기도,안양시다선거구,6410903,4109,안양시만안구,안양2동,계,17835,8186,2484,1412,2420,1013,198,7527,659,9649
4100,경기도,안양시다선거구,6410903,4109,안양시만안구,안양2동,관내사전투표,2767,2763,898,465,751,358,64,2536,227,4
4100,경기도,안양시다선거구,6410903,4109,안양시만안구,안양2동,선거일투표,15068,5423,1586,947,1669,655,134,4991,432,9645
4100,경기도,안양시다선거구,6410903,4109,안양시만안구,박달1동,계,12972,6234,1674,1327,1776,855,179,5811,423,6738
4100,경기도,안양시다선거구,6410903,4109,안양시만안구,박달1동,관내사전투표,2634,2629,693,569,767,330,83,2442,187,5
4100,경기도,안양시다선거구,6410903,4109,안양시만안구,박달1동,선거일투표,10338,3605,981,758,1009,525,96,3369,236,6733
4100,경기도,안양시다선거구,6410903,4109,안양시만안구,박달2동,계,17315,9255,2563,1805,2289,1767,287,8711,544,8060
4100,경기도,안양시다선거구,6410903,4109,안양시만안구,박달2동,관내사전투표,2956,2953,787,614,716,574,71,2762,191,3
4100,경기도,안양시다선거구,6410903,4109,안양시만안구,박달2동,선거일투표,14359,6302,1776,1191,1573,1193,216,5949,353,8057
4100,경기도,안양시다선거구,6410903,4109,안양시만안구,잘못 투입·구분된 투표지,,0,18,4,3,5,4,1,17,1,-18
4100,경기도,안양시라선거구,6410904,4109,안양시만안구,검색된 결과가 없습니다.
4100,경기도,안양시마선거구,6411001,4110,안양시동안구,합계,,59262,35735,11140,7108,16219,34467,1268,23527
4100,경기도,안양시마선거구,6411001,4110,안양시동안구,거소투표,,73,70,24,9,29,62,8,3
4100,경기도,안양시마선거구,6411001,4110,안양시동안구,관외사전투표,,3369,3366,1289,531,1465,3285,81,3
4100,경기도,안양시마선거구,6411001,4110,안양시동안구,비산1동,계,20492,11977,3366,2823,5313,11502,475,8515
4100,경기도,안양시마선거구,6411001,4110,안양시동안구,비산1동,관내사전투표,3306,3305,941,880,1432,3253,52,1
4100,경기도,안양시마선거구,6411001,4110,안양시동안구,비산1동,선거일투표,17186,8672,2425,1943,3881,8249,423,8514
4100,경기도,안양시마선거구,6411001,4110,안양시동안구,비산2동,계,12019,7351,2280,1425,3384,7089,262,4668
4100,경기도,안양시마선거구,6411001,4110,안양시동안구,비산2동,관내사전투표,3046,3044,927,641,1384,2952,92,2
4100,경기도,안양시마선거구,6411001,4110,안양시동안구,비산2동,선거일투표,8973,4307,1353,784,2000,4137,170,4666
4100,경기도,안양시마선거구,6411001,4110,안양시동안구,비산3동,계,10262,5245,1650,902,2499,5051,194,5017
4100,경기도,안양시마선거구,6411001,4110,안양시동안구,비산3동,관내사전투표,1830,1830,540,354,867,1761,69,0
4100,경기도,안양시마선거구,6411001,4110,안양시동안구,비산3동,선거일투표,8432,3415,1110,548,1632,3290,125,5017
4100,경기도,안양시마선거구,6411001,4110,안양시동안구,부흥동,계,13047,7713,2526,1415,3524,7465,248,5334
4100,경기도,안양시마선거구,6411001,4110,안양시동안구,부흥동,관내사전투표,2788,2787,958,542,1228,2728,59,1
4100,경기도,안양시마선거구,6411001,4110,안양시동안구,부흥동,선거일투표,10259,4926,1568,873,2296,4737,189,5333
4100,경기도,안양시마선거구,6411001,4110,안양시동안구,잘못 투입·구분된 투표지,,0,13,5,3,5,13,0,-13
4100,경기도,안양시바선거구,6411002,4110,안양시동안구,합계,,80021,43916,12213,7850,12732,5953,2011,293,41052,2864,36105
4100,경기도,안양시바선거구,6411002,4110,안양시동안구,거소투표,,78,73,22,11,19,13,1,2,68,5,5
4100,경기도,안양시바선거구,6411002,4110,안양시동안구,관외사전투표,,4967,4965,1560,914,1500,463,189,59,4685,280,2
4100,경기도,안양시바선거구,6411002,4110,안양시동안구,달안동,계,8860,4576,1144,925,1337,584,213,35,4238,338,4284
4100,경기도,안양시바선거구,6411002,4110,안양시동안구,달안동,관내사전투표,1536,1535,361,369,412,218,70,12,1442,93,1
4100,경기도,안양시바선거구,6411002,4110,안양시동안구,달안동,선거일투표,7324,3041,783,556,925,366,143,23,2796,245,4283
4100,경기도,안양시바선거구,6411002,4110,안양시동안구,관양1동,계,29299,15043,3824,2682,4356,2424,697,67,14050,993,14256
4100,경기도,안양시바선거구,6411002,4110,안양시동안구,관양1동,관내사전투표,4082,4080,1113,791,1075,656,147,12,3794,286,2
4100,경기도,안양시바선거구,6411002,4110,안양시동안구,관양1동,선거일투표,25217,10963,2711,1891,3281,1768,550,55,10256,707,14254
4100,경기도,안양시바선거구,6411002,4110,안양시동안구,관양2동,계,15647,8178,2423,1314,2379,1112,338,45,7611,567,7469
4100,경기도,안양시바선거구,6411002,4110,안양시동안구,관양2동,관내사전투표,2548,2542,760,455,665,351,117,11,2359,183,6
4100,경기도,안양시바선거구,6411002,4110,안양시동안구,관양2동,선거일투표,13099,5636,1663,859,1714,761,221,34,5252,384,7463
4100,경기도,안양시바선거구,6411002,4110,안양시동안구,부림동,계,21170,11054,3233,2000,3134,1352,572,85,10376,678,10116
4100,경기도,안양시바선거구,6411002,4110,안양시동안구,부림동,관내사전투표,3651,3645,1128,705,970,443,167,19,3432,213,6
4100,경기도,안양시바선거구,6411002,4110,안양시동안구,부림동,선거일투표,17519,7409,2105,1295,2164,909,405,66,6944,465,10110
4100,경기도,안양시바선거구,6411002,4110,안양시동안구,잘못 투입·구분된 투표지,,0,27,7,4,7,5,1,0,24,3,-27
4100,경기도,안양시사선거구,6411003,4110,안양시동안구,합계,,63923,39851,10420,8115,7677,10335,36547,3304,24072
4100,경기도,안양시사선거구,6411003,4110,안양시동안구,거소투표,,69,68,14,18,17,13,62,6,1
4100,경기도,안양시사선거구,6411003,4110,안양시동안구,관외사전투표,,3516,3513,1012,646,874,701,3233,280,3
4100,경기도,안양시사선거구,6411003,4110,안양시동안구,평촌동,계,11299,6739,1919,1240,1177,1806,6142,597,4560
4100,경기도,안양시사선거구,6411003,4110,안양시동안구,평촌동,관내사전투표,2374,2371,651,459,410,618,2138,233,3
4100,경기도,안양시사선거구,6411003,4110,안양시동안구,평촌동,선거일투표,8925,4368,1268,781,767,1188,4004,364,4557
4100,경기도,안양시사선거구,6411003,4110,안양시동안구,평안동,계,17028,10246,2667,2452,1652,2543,9314,932,6782
4100,경기도,안양시사선거구,6411003,4110,안양시동안구,평안동,관내사전투표,3399,3399,915,794,572,795,3076,323,0
4100,경기도,안양시사선거구,6411003,4110,안양시동안구,평안동,선거일투표,13629,6847,1752,1658,1080,1748,6238,609,6782
4100,경기도,안양시사선거구,6411003,4110,안양시동안구,귀인동,계,11598,7149,1844,1392,1248,2139,6623,526,4449
4100,경기도,안양시사선거구,6411003,4110,안양시동안구,귀인동,관내사전투표,2325,2322,641,438,407,699,2185,137,3
4100,경기도,안양시사선거구,6411003,4110,안양시동안구,귀인동,선거일투표,9273,4827,1203,954,841,1440,4438,389,4446
4100,경기도,안양시사선거구,6411003,4110,안양시동안구,범계동,계,11963,7130,1528,1554,1613,1897,6592,538,4833
4100,경기도,안양시사선거구,6411003,4110,안양시동안구,범계동,관내사전투표,2305,2304,548,552,504,559,2163,141,1
4100,경기도,안양시사선거구,6411003,4110,안양시동안구,범계동,선거일투표,9658,4826,980,1002,1109,1338,4429,397,4832
4100,경기도,안양시사선거구,6411003,4110,안양시동안구,갈산동,계,8450,4988,1431,811,1094,1230,4566,422,3462
4100,경기도,안양시사선거구,6411003,4110,안양시동안구,갈산동,관내사전투표,1665,1665,481,265,358,430,1534,131,0
4100,경기도,안양시사선거구,6411003,4110,안양시동안구,갈산동,선거일투표,6785,3323,950,546,736,800,3032,291,3462
4100,경기도,안양시사선거구,6411003,4110,안양시동안구,잘못 투입·구분된 투표지,,0,18,5,2,2,6,15,3,-18
4100,경기도,안양시아선거구,6411004,4110,안양시동안구,검색된 결과가 없습니다.
4100,경기도,부천시가선거구,6411101,4145,부천시,합계,,79200,37863,14269,5177,8772,6163,1134,35515,2348,41337
4100,경기도,부천시가선거구,6411101,4145,부천시,거소투표,,68,67,22,16,14,8,2,62,5,1
4100,경기도,부천시가선거구,6411101,4145,부천시,관외사전투표,,4051,4046,1573,586,1007,460,151,3777,269,5
4100,경기도,부천시가선거구,6411101,4145,부천시,부천동,계,75081,33710,12664,4568,7740,5689,980,31641,2069,41371
4100,경기도,부천시가선거구,6411101,4145,부천시,부천동,관내사전투표,11409,11382,4388,1736,2506,1777,290,10697,685,27
4100,경기도,부천시가선거구,6411101,4145,부천시,부천동,선거일투표,63672,22328,8276,2832,5234,3912,690,20944,1384,41344
4100,경기도,부천시가선거구,6411101,4145,부천시,잘못 투입·구분된 투표지,,0,40,10,7,11,6,1,35,5,-40
4100,경기도,부천시나선거구,6411102,4145,부천시,합계,,58772,24790,12512,9521,1539,23572,1218,33982
4100,경기도,부천시나선거구,6411102,4145,부천시,거소투표,,74,71,36,21,9,66,5,3
4100,경기도,부천시나선거구,6411102,4145,부천시,관외사전투표,,3154,3150,1778,1175,116,3069,81,4
4100,경기도,부천시나선거구,6411102,4145,부천시,심곡동,계,55544,21498,10668,8306,1413,20387,1111,34046
4100,경기도,부천시나선거구,6411102,4145,부천시,심곡동,관내사전투표,7646,7628,3936,2974,496,7406,222,18
4100,경기도,부천시나선거구,6411102,4145,부천시,심곡동,선거일투표,47898,13870,6732,5332,917,12981,889,34028
4100,경기도,부천시나선거구,6411102,4145,부천시,잘못 투입·구분된 투표지,,0,71,30,19,1,50,21,-71
4100,경기도,부천시다선거구,6411103,4145,부천시,합계,,35642,18383,8678,5330,3358,17366,1017,17259
4100,경기도,부천시다선거구,6411103,4145,부천시,거소투표,,52,49,15,23,4,42,7,3
4100,경기도,부천시다선거구,6411103,4145,부천시,관외사전투표,,2335,2305,1227,763,249,2239,66,30
4100,경기도,부천시다선거구,6411103,4145,부천시,중동,계,33255,15957,7401,4523,3098,15022,935,17298
4100,경기도,부천시다선거구,6411103,4145,부천시,중동,관내사전투표,5125,5102,2483,1435,1035,4953,149,23
4100,경기도,부천시다선거구,6411103,4145,부천시,중동,선거일투표,28130,10855,4918,3088,2063,10069,786,17275
4100,경기도,부천시다선거구,6411103,4145,부천시,잘못 투입·구분된 투표지,,0,72,35,21,7,63,9,-72
4100,경기도,부천시라선거구,6411104,4145,부천시,합계,,69841,39211,15931,5611,10039,4157,35738,3473,30630
4100,경기도,부천시라선거구,6411104,4145,부천시,거소투표,,81,78,22,7,22,11,62,16,3
4100,경기도,부천시라선거구,6411104,4145,부천시,관외사전투표,,4037,4027,1701,523,1145,348,3717,310,10
4100,경기도,부천시라선거구,6411104,4145,부천시,상동,계,65723,35032,14181,5071,8852,3791,31895,3137,30691
4100,경기도,부천시라선거구,6411104,4145,부천시,상동,관내사전투표,12380,12342,5072,1905,2986,1316,11279,1063,38
4100,경기도,부천시라선거구,6411104,4145,부천시,상동,선거일투표,53343,22690,9109,3166,5866,2475,20616,2074,30653
4100,경기도,부천시라선거구,6411104,4145,부천시,잘못 투입·구분된 투표지,,0,74,27,10,20,7,64,10,-74
4100,경기도,부천시마선거구,6411105,4145,부천시,합계,,112051,58833,19776,9168,18194,6171,2197,55506,3327,53218
4100,경기도,부천시마선거구,6411105,4145,부천시,거소투표,,127,120,42,17,37,11,2,109,11,7
4100,경기도,부천시마선거구,6411105,4145,부천시,관외사전투표,,7033,7018,2503,1052,2168,622,319,6664,354,15
4100,경기도,부천시마선거구,6411105,4145,부천시,신중동,계,104891,51647,17222,8093,15965,5532,1873,48685,2962,53244
4100,경기도,부천시마선거구,6411105,4145,부천시,신중동,관내사전투표,14948,14921,5245,2529,4334,1482,437,14027,894,27
4100,경기도,부천시마선거구,6411105,4145,부천시,신중동,선거일투표,89943,36726,11977,5564,11631,4050,1436,34658,2068,53217
4100,경기도,부천시마선거구,6411105,4145,부천시,잘못 투입·구분된 투표지,,0,48,9,6,24,6,3,48,0,-48
4100,경기도,부천시바선거구,6411201,4145,부천시,합계,,72828,35586,16024,11138,5259,1571,665,34657,929,37242
4100,경기도,부천시바선거구,6411201,4145,부천시,거소투표,,151,139,37,21,22,6,7,93,46,12
4100,경기도,부천시바선거구,6411201,4145,부천시,관외사전투표,,3460,3450,1715,1071,360,145,70,3361,89,10
4100,경기도,부천시바선거구,6411201,4145,부천시,대산동,계,69217,31963,14260,10032,4874,1418,587,31171,792,37254
4100,경기도,부천시바선거구,6411201,4145,부천시,대산동,관내사전투표,10727,10705,5021,3361,1544,434,139,10499,206,22
4100,경기도,부천시바선거구,6411201,4145,부천시,대산동,선거일투표,58490,21258,9239,6671,3330,984,448,20672,586,37232
4100,경기도,부천시바선거구,6411201,4145,부천시,잘못 투입·구분된 투표지,,0,34,12,14,3,2,1,32,2,-34
4100,경기도,부천시사선거구,6411202,4145,부천시,합계,,50236,25352,12623,8717,2567,593,24500,852,24884
4100,경기도,부천시사선거구,6411202,4145,부천시,거소투표,,53,49,23,13,6,2,44,5,4
4100,경기도,부천시사선거구,6411202,4145,부천시,관외사전투표,,2863,2849,1619,996,145,41,2801,48,14
4100,경기도,부천시사선거구,6411202,4145,부천시,소사본동,계,47320,22371,10952,7686,2406,545,21589,782,24949
4100,경기도,부천시사선거구,6411202,4145,부천시,소사본동,관내사전투표,7201,7180,3605,2451,827,179,7062,118,21
4100,경기도,부천시사선거구,6411202,4145,부천시,소사본동,선거일투표,40119,15191,7347,5235,1579,366,14527,664,24928
4100,경기도,부천시사선거구,6411202,4145,부천시,잘못 투입·구분된 투표지,,0,83,29,22,10,5,66,17,-83
4100,경기도,부천시아선거구,6411203,4145,부천시,합계,,78062,41783,16200,5641,10597,5008,37446,4337,36279
4100,경기도,부천시아선거구,6411203,4145,부천시,거소투표,,106,100,26,19,32,11,88,12,6
4100,경기도,부천시아선거구,6411203,4145,부천시,관외사전투표,,4258,4249,1792,625,1043,401,3861,388,9
4100,경기도,부천시아선거구,6411203,4145,부천시,범안동,계,73698,37366,14353,4993,9506,4590,33442,3924,36332
4100,경기도,부천시아선거구,6411203,4145,부천시,범안동,관내사전투표,10306,10286,4083,1374,2599,1241,9297,989,20
4100,경기도,부천시아선거구,6411203,4145,부천시,범안동,선거일투표,63392,27080,10270,3619,6907,3349,24145,2935,36312
4100,경기도,부천시아선거구,6411203,4145,부천시,잘못 투입·구분된 투표지,,0,68,29,4,16,6,55,13,-68
4100,경기도,부천시자선거구,6411301,4145,부천시,합계,,73228,33323,11898,4799,8380,4465,1477,31019,2304,39905
4100,경기도,부천시자선거구,6411301,4145,부천시,거소투표,,78,74,27,8,25,4,2,66,8,4
4100,경기도,부천시자선거구,6411301,4145,부천시,관외사전투표,,3425,3421,1304,520,877,371,145,3217,204,4
4100,경기도,부천시자선거구,6411301,4145,부천시,성곡동,계,69725,29797,10559,4268,7473,4085,1326,27711,2086,39928
4100,경기도,부천시자선거구,6411301,4145,부천시,성곡동,관내사전투표,9420,9405,3443,1410,2193,1269,408,8723,682,15
4100,경기도,부천시자선거구,6411301,4145,부천시,성곡동,선거일투표,60305,20392,7116,2858,5280,2816,918,18988,1404,39913
4100,경기도,부천시자선거구,6411301,4145,부천시,잘못 투입·구분된 투표지,,0,31,8,3,5,5,4,25,6,-31
4100,경기도,부천시차선거구,6411302,4145,부천시,합계,,73114,32276,15716,10008,4937,30661,1615,40838
4100,경기도,부천시차선거구,6411302,4145,부천시,거소투표,,98,91,41,23,18,82,9,7
4100,경기도,부천시차선거구,6411302,4145,부천시,관외사전투표,,3964,3953,2174,1185,479,3838,115,11
4100,경기도,부천시차선거구,6411302,4145,부천시,오정동,계,69052,28169,13484,8773,4433,26690,1479,40883
4100,경기도,부천시차선거구,6411302,4145,부천시,오정동,관내사전투표,7478,7464,3761,2192,1252,7205,259,14
4100,경기도,부천시차선거구,6411302,4145,부천시,오정동,선거일투표,61574,20705,9723,6581,3181,19485,1220,40869
4100,경기도,부천시차선거구,6411302,4145,부천시,잘못 투입·구분된 투표지,,0,63,17,27,7,51,12,-63
4100,경기도,광명시가선거구,6411401,4114,광명시,합계,,56395,32569,10327,6089,8902,4055,29373,3196,23826
4100,경기도,광명시가선거구,6411401,4114,광명시,거소투표,,55,52,17,8,17,5,47,5,3
4100,경기도,광명시가선거구,6411401,4114,광명시,관외사전투표,,3443,3435,1218,582,951,349,3100,335,8
4100,경기도,광명시가선거구,6411401,4114,광명시,광명2동,계,3227,1546,505,247,487,110,1349,197,1681
4100,경기도,광명시가선거구,6411401,4114,광명시,광명2동,관내사전투표,799,799,274,128,241,58,701,98,0
4100,경기도,광명시가선거구,6411401,4114,광명시,광명2동,선거일투표,2428,747,231,119,246,52,648,99,1681
4100,경기도,광명시가선거구,6411401,4114,광명시,광명3동,계,8354,3680,1109,613,1250,303,3275,405,4674
4100,경기도,광명시가선거구,6411401,4114,광명시,광명3동,관내사전투표,977,974,318,178,282,91,869,105,3
4100,경기도,광명시가선거구,6411401,4114,광명시,광명3동,선거일투표,7377,2706,791,435,968,212,2406,300,4671
4100,경기도,광명시가선거구,6411401,4114,광명시,철산1동,계,8504,4785,1509,1132,1374,362,4377,408,3719
4100,경기도,광명시가선거구,6411401,4114,광명시,철산1동,관내사전투표,2136,2135,720,541,555,152,1968,167,1
4100,경기도,광명시가선거구,6411401,4114,광명시,철산1동,선거일투표,6368,2650,789,591,819,210,2409,241,3718
4100,경기도,광명시가선거구,6411401,4114,광명시,철산2동,계,5130,2431,699,578,729,221,2227,204,2699
4100,경기도,광명시가선거구,6411401,4114,광명시,철산2동,관내사전투표,1104,1103,327,291,314,99,1031,72,1
4100,경기도,광명시가선거구,6411401,4114,광명시,철산2동,선거일투표,4026,1328,372,287,415,122,1196,132,2698
4100,경기도,광명시가선거구,6411401,4114,광명시,철산3동,계,27682,16586,5256,2922,4079,2699,14956,1630,11096
4100,경기도,광명시가선거구,6411401,4114,광명시,철산3동,관내사전투표,4282,4275,1390,744,920,820,3874,401,7
4100,경기도,광명시가선거구,6411401,4114,광명시,철산3동,선거일투표,23400,12311,3866,2178,3159,1879,11082,1229,11089
4100,경기도,광명시가선거구,6411401,4114,광명시,잘못 투입·구분된 투표지,,0,54,14,7,15,6,42,12,-54
4100,경기도,광명시나선거구,6411402,4114,광명시,합계,,61051,33538,12148,5734,14196,32078,1460,27513
4100,경기도,광명시나선거구,6411402,4114,광명시,거소투표,,94,91,45,8,29,82,9,3
4100,경기도,광명시나선거구,6411402,4114,광명시,관외사전투표,,3605,3596,1324,662,1507,3493,103,9
4100,경기도,광명시나선거구,6411402,4114,광명시,광명4동,계,11197,5736,2031,871,2572,5474,262,5461
4100,경기도,광명시나선거구,6411402,4114,광명시,광명4동,관내사전투표,2117,2110,814,343,882,2039,71,7
4100,경기도,광명시나선거구,6411402,4114,광명시,광명4동,선거일투표,9080,3626,1217,528,1690,3435,191,5454
4100,경기도,광명시나선거구,6411402,4114,광명시,광명5동,계,10205,5100,1808,855,2195,4858,242,5105
4100,경기도,광명시나선거구,6411402,4114,광명시,광명5동,관내사전투표,1984,1981,748,356,825,1929,52,3
4100,경기도,광명시나선거구,6411402,4114,광명시,광명5동,선거일투표,8221,3119,1060,499,1370,2929,190,5102
4100,경기도,광명시나선거구,6411402,4114,광명시,광명6동,계,8442,4655,1509,875,2047,4431,224,3787
4100,경기도,광명시나선거구,6411402,4114,광명시,광명6동,관내사전투표,1724,1723,583,348,737,1668,55,1
4100,경기도,광명시나선거구,6411402,4114,광명시,광명6동,선거일투표,6718,2932,926,527,1310,2763,169,3786
4100,경기도,광명시나선거구,6411402,4114,광명시,광명7동,계,17095,8641,3168,1425,3756,8349,292,8454
4100,경기도,광명시나선거구,6411402,4114,광명시,광명7동,관내사전투표,3239,3224,1179,561,1398,3138,86,15
4100,경기도,광명시나선거구,6411402,4114,광명시,광명7동,선거일투표,13856,5417,1989,864,2358,5211,206,8439
4100,경기도,광명시나선거구,6411402,4114,광명시,철산4동,계,10413,5655,2241,1031,2066,5338,317,4758
4100,경기도,광명시나선거구,6411402,4114,광명시,철산4동,관내사전투표,1865,1861,808,386,595,1789,72,4
4100,경기도,광명시나선거구,6411402,4114,광명시,철산4동,선거일투표,8548,3794,1433,645,1471,3549,245,4754
4100,경기도,광명시나선거구,6411402,4114,광명시,잘못 투입·구분된 투표지,,0,64,22,7,24,53,11,-64
4100,경기도,광명시다선거구,6411403,4114,광명시,합계,,62684,36137,12584,5545,16455,34584,1553,26547
4100,경기도,광명시다선거구,6411403,4114,광명시,거소투표,,102,95,37,11,43,91,4,7
4100,경기도,광명시다선거구,6411403,4114,광명시,관외사전투표,,3103,3101,1122,481,1387,2990,111,2
4100,경기도,광명시다선거구,6411403,4114,광명시,하안1동,계,19759,11124,3802,1797,5124,10723,401,8635
4100,경기도,광명시다선거구,6411403,4114,광명시,하안1동,관내사전투표,3195,3188,1104,575,1426,3105,83,7
4100,경기도,광명시다선거구,6411403,4114,광명시,하안1동,선거일투표,16564,7936,2698,1222,3698,7618,318,8628
4100,경기도,광명시다선거구,6411403,4114,광명시,하안2동,계,11472,6072,2141,934,2672,5747,325,5400
4100,경기도,광명시다선거구,6411403,4114,광명시,하안2동,관내사전투표,2525,2525,917,429,1111,2457,68,0
4100,경기도,광명시다선거구,6411403,4114,광명시,하안2동,선거일투표,8947,3547,1224,505,1561,3290,257,5400
4100,경기도,광명시다선거구,6411403,4114,광명시,하안3동,계,16393,9065,3240,1325,4039,8604,461,7328
4100,경기도,광명시다선거구,6411403,4114,광명시,하안3동,관내사전투표,3015,3003,1118,471,1320,2909,94,12
4100,경기도,광명시다선거구,6411403,4114,광명시,하안3동,선거일투표,13378,6062,2122,854,2719,5695,367,7316
4100,경기도,광명시다선거구,6411403,4114,광명시,하안4동,계,10053,5606,2009,902,2502,5413,193,4447
4100,경기도,광명시다선거구,6411403,4114,광명시,하안4동,관내사전투표,2312,2307,848,397,1008,2253,54,5
4100,경기도,광명시다선거구,6411403,4114,광명시,하안4동,선거일투표,7741,3299,1161,505,1494,3160,139,4442
4100,경기도,광명시다선거구,6411403,4114,광명시,학온동,계,1802,1022,220,87,667,974,48,780
4100,경기도,광명시다선거구,6411403,4114,광명시,학온동,관내사전투표,351,349,76,31,234,341,8,2
4100,경기도,광명시다선거구,6411403,4114,광명시,학온동,선거일투표,1451,673,144,56,433,633,40,778
4100,경기도,광명시다선거구,6411403,4114,광명시,잘못 투입·구분된 투표지,,0,52,13,8,21,42,10,-52
4100,경기도,광명시라선거구,6411404,4114,광명시,합계,,67103,37317,10222,8860,10384,3366,2266,35098,2219,29786
4100,경기도,광명시라선거구,6411404,4114,광명시,거소투표,,69,68,23,18,13,5,3,62,6,1
4100,경기도,광명시라선거구,6411404,4114,광명시,관외사전투표,,3598,3594,1055,774,1043,311,195,3378,216,4
4100,경기도,광명시라선거구,6411404,4114,광명시,소하1동,계,24012,13199,4052,3018,3615,1122,610,12417,782,10813
4100,경기도,광명시라선거구,6411404,4114,광명시,소하1동,관내사전투표,3905,3905,1198,966,1071,302,188,3725,180,0
4100,경기도,광명시라선거구,6411404,4114,광명시,소하1동,선거일투표,20107,9294,2854,2052,2544,820,422,8692,602,10813
4100,경기도,광명시라선거구,6411404,4114,광명시,소하2동,계,23122,11974,3305,2485,3359,971,1055,11175,799,11148
4100,경기도,광명시라선거구,6411404,4114,광명시,소하2동,관내사전투표,3808,3796,1023,823,1037,269,381,3533,263,12
4100,경기도,광명시라선거구,6411404,4114,광명시,소하2동,선거일투표,19314,8178,2282,1662,2322,702,674,7642,536,11136
4100,경기도,광명시라선거구,6411404,4114,광명시,일직동,계,16302,8449,1780,2557,2345,954,399,8035,414,7853
4100,경기도,광명시라선거구,6411404,4114,광명시,일직동,관내사전투표,2771,2767,558,861,767,286,130,2602,165,4
4100,경기도,광명시라선거구,6411404,4114,광명시,일직동,선거일투표,13531,5682,1222,1696,1578,668,269,5433,249,7849
4100,경기도,광명시라선거구,6411404,4114,광명시,잘못 투입·구분된 투표지,,0,33,7,8,9,3,4,31,2,-33
4100,경기도,평택시가선거구,6411501,4115,평택시,검색된 결과가 없습니다.
4100,경기도,평택시나선거구,6411502,4115,평택시,합계,,61095,25878,7733,3582,10903,2399,24617,1261,35217
4100,경기도,평택시나선거구,6411502,4115,평택시,거소투표,,81,69,27,11,26,2,66,3,12
4100,경기도,평택시나선거구,6411502,4115,평택시,관외사전투표,,3000,2996,1022,419,1235,214,2890,106,4
4100,경기도,평택시나선거구,6411502,4115,평택시,중앙동,계,36338,15052,4366,2124,6262,1649,14401,651,21286
4100,경기도,평택시나선거구,6411502,4115,평택시,중앙동,관내사전투표,3312,3310,1058,501,1387,286,3232,78,2
4100,경기도,평택시나선거구,6411502,4115,평택시,중앙동,선거일투표,33026,11742,3308,1623,4875,1363,11169,573,21284
4100,경기도,평택시나선거구,6411502,4115,평택시,서정동,계,21676,7721,2308,1022,3368,533,7231,490,13955
4100,경기도,평택시나선거구,6411502,4115,평택시,서정동,관내사전투표,2360,2351,736,299,1053,164,2252,99,9
4100,경기도,평택시나선거구,6411502,4115,평택시,서정동,선거일투표,19316,5370,1572,723,2315,369,4979,391,13946
4100,경기도,평택시나선거구,6411502,4115,평택시,잘못 투입·구분된 투표지,,0,40,10,6,12,1,29,11,-40
4100,경기도,평택시다선거구,6411503,4115,평택시,검색된 결과가 없습니다.
4100,경기도,평택시라선거구,6411504,4115,평택시,합계,,70332,31538,12189,4228,14098,30515,1023,38794
4100,경기도,평택시라선거구,6411504,4115,평택시,거소투표,,73,70,17,11,33,61,9,3
4100,경기도,평택시라선거구,6411504,4115,평택시,관외사전투표,,4490,4481,1567,685,2118,4370,111,9
4100,경기도,평택시라선거구,6411504,4115,평택시,비전1동,계,38440,16444,6467,2140,7318,15925,519,21996
4100,경기도,평택시라선거구,6411504,4115,평택시,비전1동,관내사전투표,3635,3629,1550,525,1486,3561,68,6
4100,경기도,평택시라선거구,6411504,4115,평택시,비전1동,선거일투표,34805,12815,4917,1615,5832,12364,451,21990
4100,경기도,평택시라선거구,6411504,4115,평택시,동삭동,계,27329,10516,4127,1391,4619,10137,379,16813
4100,경기도,평택시라선거구,6411504,4115,평택시,동삭동,관내사전투표,2666,2664,1132,367,1102,2601,63,2
4100,경기도,평택시라선거구,6411504,4115,평택시,동삭동,선거일투표,24663,7852,2995,1024,3517,7536,316,16811
4100,경기도,평택시라선거구,6411504,4115,평택시,잘못 투입·구분된 투표지,,0,27,11,1,10,22,5,-27
4100,경기도,평택시마선거구,6411505,4115,평택시,검색된 결과가 없습니다.
4100,경기도,평택시바선거구,6411506,4115,평택시,합계,,89000,37530,10699,6042,12631,3868,33240,4290,51470
4100,경기도,평택시바선거구,6411506,4115,평택시,거소투표,,720,683,170,98,267,50,585,98,37
4100,경기도,평택시바선거구,6411506,4115,평택시,관외사전투표,,3630,3619,1108,523,1284,335,3250,369,11
4100,경기도,평택시바선거구,6411506,4115,평택시,안중읍,계,33978,13386,4035,2164,4145,1545,11889,1497,20592
4100,경기도,평택시바선거구,6411506,4115,평택시,안중읍,관내사전투표,3765,3758,1189,574,1135,408,3306,452,7
4100,경기도,평택시바선거구,6411506,4115,평택시,안중읍,선거일투표,30213,9628,2846,1590,3010,1137,8583,1045,20585
4100,경기도,평택시바선거구,6411506,4115,평택시,포승읍,계,20334,7011,2002,1016,2556,620,6194,817,13323
4100,경기도,평택시바선거구,6411506,4115,평택시,포승읍,관내사전투표,2449,2447,801,349,778,226,2154,293,2
4100,경기도,평택시바선거구,6411506,4115,평택시,포승읍,선거일투표,17885,4564,1201,667,1778,394,4040,524,13321
4100,경기도,평택시바선거구,6411506,4115,평택시,청북읍,계,19504,7330,2148,1464,2138,777,6527,803,12174
4100,경기도,평택시바선거구,6411506,4115,평택시,청북읍,관내사전투표,1759,1757,517,371,524,167,1579,178,2
4100,경기도,평택시바선거구,6411506,4115,평택시,청북읍,선거일투표,17745,5573,1631,1093,1614,610,4948,625,12172
4100,경기도,평택시바선거구,6411506,4115,평택시,오성면,계,5797,2628,600,429,1031,265,2325,303,3169
4100,경기도,평택시바선거구,6411506,4115,평택시,오성면,관내사전투표,974,972,251,158,361,81,851,121,2
4100,경기도,평택시바선거구,6411506,4115,평택시,오성면,선거일투표,4823,1656,349,271,670,184,1474,182,3167
4100,경기도,평택시바선거구,6411506,4115,평택시,현덕면,계,5037,2819,617,345,1193,270,2425,394,2218
4100,경기도,평택시바선거구,6411506,4115,평택시,현덕면,관내사전투표,1374,1372,360,186,529,146,1221,151,2
4100,경기도,평택시바선거구,6411506,4115,평택시,현덕면,선거일투표,3663,1447,257,159,664,124,1204,243,2216
4100,경기도,평택시바선거구,6411506,4115,평택시,잘못 투입·구분된 투표지,,0,54,19,3,17,6,45,9,-54
4100,경기도,평택시사선거구,6411507,4115,평택시,합계,,88916,37204,10558,5326,13168,4159,33211,3993,51712
4100,경기도,평택시사선거구,6411507,4115,평택시,거소투표,,98,92,28,11,31,7,77,15,6
4100,경기도,평택시사선거구,6411507,4115,평택시,관외사전투표,,5343,5336,1655,795,1881,442,4773,563,7
4100,경기도,평택시사선거구,6411507,4115,평택시,팽성읍,계,24734,9658,2247,1383,3195,1834,8659,999,15076
4100,경기도,평택시사선거구,6411507,4115,평택시,팽성읍,관내사전투표,2752,2748,712,435,794,519,2460,288,4
4100,경기도,평택시사선거구,6411507,4115,평택시,팽성읍,선거일투표,21982,6910,1535,948,2401,1315,6199,711,15072
4100,경기도,평택시사선거구,6411507,4115,평택시,고덕면,계,10892,4107,1343,494,1489,311,3637,470,6785
4100,경기도,평택시사선거구,6411507,4115,평택시,고덕면,관내사전투표,984,983,333,114,345,72,864,119,1
4100,경기도,평택시사선거구,6411507,4115,평택시,고덕면,선거일투표,9908,3124,1010,380,1144,239,2773,351,6784
4100,경기도,평택시사선거구,6411507,4115,평택시,신평동,계,19418,7180,2007,1011,2653,642,6313,867,12238
4100,경기도,평택시사선거구,6411507,4115,평택시,신평동,관내사전투표,1926,1925,567,284,686,167,1704,221,1
4100,경기도,평택시사선거구,6411507,4115,평택시,신평동,선거일투표,17492,5255,1440,727,1967,475,4609,646,12237
4100,경기도,평택시사선거구,6411507,4115,평택시,원평동,계,11609,4807,1382,729,1722,449,4282,525,6802
4100,경기도,평택시사선거구,6411507,4115,평택시,원평동,관내사전투표,1799,1798,571,294,610,154,1629,169,1
4100,경기도,평택시사선거구,6411507,4115,평택시,원평동,선거일투표,9810,3009,811,435,1112,295,2653,356,6801
4100,경기도,평택시사선거구,6411507,4115,평택시,고덕동,계,16822,5984,1885,898,2186,471,5440,544,10838
4100,경기도,평택시사선거구,6411507,4115,평택시,고덕동,관내사전투표,1237,1236,432,201,388,82,1103,133,1
4100,경기도,평택시사선거구,6411507,4115,평택시,고덕동,선거일투표,15585,4748,1453,697,1798,389,4337,411,10837
4100,경기도,평택시사선거구,6411507,4115,평택시,잘못 투입·구분된 투표지,,0,40,11,5,11,3,30,10,-40
4100,경기도,양주시가선거구,6411601,4116,양주시,합계,,43859,22288,6285,2972,6193,4173,19623,2665,21571
4100,경기도,양주시가선거구,6411601,4116,양주시,거소투표,,297,244,83,42,53,35,213,31,53
4100,경기도,양주시가선거구,6411601,4116,양주시,관외사전투표,,2254,2240,800,275,695,270,2040,200,14
4100,경기도,양주시가선거구,6411601,4116,양주시,백석읍,계,21719,10410,2668,1786,2814,1861,9129,1281,11309
4100,경기도,양주시가선거구,6411601,4116,양주시,백석읍,관내사전투표,3272,3268,850,609,923,623,3005,263,4
4100,경기도,양주시가선거구,6411601,4116,양주시,백석읍,선거일투표,18447,7142,1818,1177,1891,1238,6124,1018,11305
4100,경기도,양주시가선거구,6411601,4116,양주시,광적면,계,10245,4999,1474,537,1288,1089,4388,611,5246
4100,경기도,양주시가선거구,6411601,4116,양주시,광적면,관내사전투표,2583,2579,825,306,660,572,2363,216,4
4100,경기도,양주시가선거구,6411601,4116,양주시,광적면,선거일투표,7662,2420,649,231,628,517,2025,395,5242
4100,경기도,양주시가선거구,6411601,4116,양주시,장흥면,계,9344,4355,1244,331,1334,913,3822,533,4989
4100,경기도,양주시가선거구,6411601,4116,양주시,장흥면,관내사전투표,1557,1557,486,127,488,294,1395,162,0
4100,경기도,양주시가선거구,6411601,4116,양주시,장흥면,선거일투표,7787,2798,758,204,846,619,2427,371,4989
4100,경기도,양주시가선거구,6411601,4116,양주시,잘못 투입·구분된 투표지,,0,40,16,1,9,5,31,9,-40
4100,경기도,양주시나선거구,6411602,4116,양주시,합계,,44863,21913,6628,3835,5941,3717,307,20428,1485,22950
4100,경기도,양주시나선거구,6411602,4116,양주시,거소투표,,78,76,24,11,22,9,5,71,5,2
4100,경기도,양주시나선거구,6411602,4116,양주시,관외사전투표,,2250,2245,799,345,667,269,34,2114,131,5
4100,경기도,양주시나선거구,6411602,4116,양주시,양주1동,계,4487,2295,579,331,831,338,19,2098,197,2192
4100,경기도,양주시나선거구,6411602,4116,양주시,양주1동,관내사전투표,549,547,133,121,158,90,5,507,40,2
4100,경기도,양주시나선거구,6411602,4116,양주시,양주1동,선거일투표,3938,1748,446,210,673,248,14,1591,157,2190
4100,경기도,양주시나선거구,6411602,4116,양주시,양주2동,계,38048,17267,5217,3141,4415,3095,249,16117,1150,20781
4100,경기도,양주시나선거구,6411602,4116,양주시,양주2동,관내사전투표,4516,4495,1391,874,1140,790,57,4252,243,21
4100,경기도,양주시나선거구,6411602,4116,양주시,양주2동,선거일투표,33532,12772,3826,2267,3275,2305,192,11865,907,20760
4100,경기도,양주시나선거구,6411602,4116,양주시,잘못 투입·구분된 투표지,,0,30,9,7,6,6,0,28,2,-30
4100,경기도,양주시다선거구,6411603,4116,양주시,합계,,109029,50942,16208,6801,14588,6233,892,1901,782,47405,3537,58087
4100,경기도,양주시다선거구,6411603,4116,양주시,거소투표,,188,176,52,16,64,13,5,4,3,157,19,12
4100,경기도,양주시다선거구,6411603,4116,양주시,관외사전투표,,5022,5019,1754,629,1530,488,97,108,69,4675,344,3
4100,경기도,양주시다선거구,6411603,4116,양주시,은현면,계,5155,2491,532,269,859,407,17,167,55,2306,185,2664
4100,경기도,양주시다선거구,6411603,4116,양주시,은현면,관내사전투표,940,940,212,110,312,155,4,66,17,876,64,0
4100,경기도,양주시다선거구,6411603,4116,양주시,은현면,선거일투표,4215,1551,320,159,547,252,13,101,38,1430,121,2664
4100,경기도,양주시다선거구,6411603,4116,양주시,남면,계,5932,2775,641,327,894,500,30,153,54,2599,176,3157
4100,경기도,양주시다선거구,6411603,4116,양주시,남면,관내사전투표,1031,1029,240,130,310,182,11,62,29,964,65,2
4100,경기도,양주시다선거구,6411603,4116,양주시,남면,선거일투표,4901,1746,401,197,584,318,19,91,25,1635,111,3155
4100,경기도,양주시다선거구,6411603,4116,양주시,회천1동,계,8391,4015,1088,575,1234,521,46,180,78,3722,293,4376
4100,경기도,양주시다선거구,6411603,4116,양주시,회천1동,관내사전투표,1721,1720,516,261,477,222,19,83,31,1609,111,1
4100,경기도,양주시다선거구,6411603,4116,양주시,회천1동,선거일투표,6670,2295,572,314,757,299,27,97,47,2113,182,4375
4100,경기도,양주시다선거구,6411603,4116,양주시,회천2동,계,22382,9671,3071,1152,2654,1174,131,527,221,8930,741,12711
4100,경기도,양주시다선거구,6411603,4116,양주시,회천2동,관내사전투표,3258,3255,1057,421,823,403,39,169,71,2983,272,3
4100,경기도,양주시다선거구,6411603,4116,양주시,회천2동,선거일투표,19124,6416,2014,731,1831,771,92,358,150,5947,469,12708
4100,경기도,양주시다선거구,6411603,4116,양주시,회천3동,계,21731,10079,3140,1375,2862,1249,191,379,162,9358,721,11652
4100,경기도,양주시다선거구,6411603,4116,양주시,회천3동,관내사전투표,3727,3705,1167,555,985,455,75,123,39,3399,306,22
4100,경기도,양주시다선거구,6411603,4116,양주시,회천3동,선거일투표,18004,6374,1973,820,1877,794,116,256,123,5959,415,11630
4100,경기도,양주시다선거구,6411603,4116,양주시,회천4동,계,40228,16679,5917,2453,4481,1876,375,381,140,15623,1056,23549
4100,경기도,양주시다선거구,6411603,4116,양주시,회천4동,관내사전투표,4201,4196,1529,595,1109,457,73,82,45,3890,306,5
4100,경기도,양주시다선거구,6411603,4116,양주시,회천4동,선거일투표,36027,12483,4388,1858,3372,1419,302,299,95,11733,750,23544
4100,경기도,양주시다선거구,6411603,4116,양주시,잘못 투입·구분된 투표지,,0,37,13,5,10,5,0,2,0,35,2,-37
4100,경기도,동두천시가선거구,6411701,4117,동두천시,합계,,36487,18072,4662,2484,3796,3635,1493,889,16959,1113,18415
4100,경기도,동두천시가선거구,6411701,4117,동두천시,거소투표,,91,81,21,11,14,12,8,2,68,13,10
4100,경기도,동두천시가선거구,6411701,4117,동두천시,관외사전투표,,1796,1795,468,251,417,323,130,81,1670,125,1
4100,경기도,동두천시가선거구,6411701,4117,동두천시,생연2동,계,9654,4792,1152,631,956,1135,358,250,4482,310,4862
4100,경기도,동두천시가선거구,6411701,4117,동두천시,생연2동,관내사전투표,2011,2010,504,272,401,472,132,98,1879,131,1
4100,경기도,동두천시가선거구,6411701,4117,동두천시,생연2동,선거일투표,7643,2782,648,359,555,663,226,152,2603,179,4861
4100,경기도,동두천시가선거구,6411701,4117,동두천시,송내동,계,20277,9181,2479,1286,1923,1735,780,471,8674,507,11096
4100,경기도,동두천시가선거구,6411701,4117,동두천시,송내동,관내사전투표,3564,3549,1025,539,749,637,249,178,3377,172,15
4100,경기도,동두천시가선거구,6411701,4117,동두천시,송내동,선거일투표,16713,5632,1454,747,1174,1098,531,293,5297,335,11081
4100,경기도,동두천시가선거구,6411701,4117,동두천시,상패동,계,4669,2198,537,298,479,427,214,85,2040,158,2471
4100,경기도,동두천시가선거구,6411701,4117,동두천시,상패동,관내사전투표,982,980,272,143,202,165,83,54,919,61,2
4100,경기도,동두천시가선거구,6411701,4117,동두천시,상패동,선거일투표,3687,1218,265,155,277,262,131,31,1121,97,2469
4100,경기도,동두천시가선거구,6411701,4117,동두천시,잘못 투입·구분된 투표지,,0,25,5,7,7,3,3,0,25,0,-25
4100,경기도,동두천시나선거구,6411702,4117,동두천시,합계,,44587,21669,4769,5385,5707,3462,19323,2346,22918
4100,경기도,동두천시나선거구,6411702,4117,동두천시,거소투표,,78,69,21,18,15,9,63,6,9
4100,경기도,동두천시나선거구,6411702,4117,동두천시,관외사전투표,,2436,2426,643,635,661,274,2213,213,10
4100,경기도,동두천시나선거구,6411702,4117,동두천시,생연1동,계,5766,2623,527,642,688,453,2310,313,3143
4100,경기도,동두천시나선거구,6411702,4117,동두천시,생연1동,관내사전투표,1136,1135,235,306,293,202,1036,99,1
4100,경기도,동두천시나선거구,6411702,4117,동두천시,생연1동,선거일투표,4630,1488,292,336,395,251,1274,214,3142
4100,경기도,동두천시나선거구,6411702,4117,동두천시,중앙동,계,4679,2273,430,622,594,374,2020,253,2406
4100,경기도,동두천시나선거구,6411702,4117,동두천시,중앙동,관내사전투표,1165,1164,229,339,296,178,1042,122,1
4100,경기도,동두천시나선거구,6411702,4117,동두천시,중앙동,선거일투표,3514,1109,201,283,298,196,978,131,2405
4100,경기도,동두천시나선거구,6411702,4117,동두천시,보산동,계,2645,1229,266,288,327,197,1078,151,1416
4100,경기도,동두천시나선거구,6411702,4117,동두천시,보산동,관내사전투표,610,609,139,166,147,96,548,61,1
4100,경기도,동두천시나선거구,6411702,4117,동두천시,보산동,선거일투표,2035,620,127,122,180,101,530,90,1415
4100,경기도,동두천시나선거구,6411702,4117,동두천시,불현동,계,21228,9241,1999,2340,2313,1644,8296,945,11987
4100,경기도,동두천시나선거구,6411702,4117,동두천시,불현동,관내사전투표,3265,3265,732,885,792,609,3018,247,0
4100,경기도,동두천시나선거구,6411702,4117,동두천시,불현동,선거일투표,17963,5976,1267,1455,1521,1035,5278,698,11987
4100,경기도,동두천시나선거구,6411702,4117,동두천시,소요동,계,7755,3791,877,839,1103,510,3329,462,3964
4100,경기도,동두천시나선거구,6411702,4117,동두천시,소요동,관내사전투표,1262,1262,317,286,340,189,1132,130,0
4100,경기도,동두천시나선거구,6411702,4117,동두천시,소요동,선거일투표,6493,2529,560,553,763,321,2197,332,3964
4100,경기도,동두천시나선거구,6411702,4117,동두천시,잘못 투입·구분된 투표지,,0,17,6,1,6,1,14,3,-17
4100,경기도,안산시가선거구,6411801,4118,안산시상록구,합계,,107690,50845,17208,8723,13986,6093,1974,47984,2861,56845
4100,경기도,안산시가선거구,6411801,4118,안산시상록구,거소투표,,134,131,43,15,46,15,1,120,11,3
4100,경기도,안산시가선거구,6411801,4118,안산시상록구,관외사전투표,,5153,5149,1728,947,1403,572,186,4836,313,4
4100,경기도,안산시가선거구,6411801,4118,안산시상록구,사동,계,28426,11579,4393,1789,3038,1281,449,10950,629,16847
4100,경기도,안산시가선거구,6411801,4118,안산시상록구,사동,관내사전투표,3403,3400,1294,536,907,343,120,3200,200,3
4100,경기도,안산시가선거구,6411801,4118,안산시상록구,사동,선거일투표,25023,8179,3099,1253,2131,938,329,7750,429,16844
4100,경기도,안산시가선거구,6411801,4118,안산시상록구,사이동,계,26347,11342,4130,1742,3046,1320,489,10727,615,15005
4100,경기도,안산시가선거구,6411801,4118,안산시상록구,사이동,관내사전투표,3249,3248,1161,537,916,380,98,3092,156,1
4100,경기도,안산시가선거구,6411801,4118,안산시상록구,사이동,선거일투표,23098,8094,2969,1205,2130,940,391,7635,459,15004
4100,경기도,안산시가선거구,6411801,4118,안산시상록구,해양동,계,30694,15031,4199,3168,4260,2137,481,14245,786,15663
4100,경기도,안산시가선거구,6411801,4118,안산시상록구,해양동,관내사전투표,3400,3395,941,741,1035,416,82,3215,180,5
4100,경기도,안산시가선거구,6411801,4118,안산시상록구,해양동,선거일투표,27294,11636,3258,2427,3225,1721,399,11030,606,15658
4100,경기도,안산시가선거구,6411801,4118,안산시상록구,본오3동,계,16936,7593,2712,1057,2189,763,367,7088,505,9343
4100,경기도,안산시가선거구,6411801,4118,안산시상록구,본오3동,관내사전투표,2335,2332,859,363,622,228,107,2179,153,3
4100,경기도,안산시가선거구,6411801,4118,안산시상록구,본오3동,선거일투표,14601,5261,1853,694,1567,535,260,4909,352,9340
4100,경기도,안산시가선거구,6411801,4118,안산시상록구,잘못 투입·구분된 투표지,,0,20,3,5,4,5,1,18,2,-20
4100,경기도,안산시나선거구,6411802,4118,안산시상록구,합계,,70816,31716,14985,12389,596,2679,30649,1067,39100
4100,경기도,안산시나선거구,6411802,4118,안산시상록구,거소투표,,89,87,31,41,3,6,81,6,2
4100,경기도,안산시나선거구,6411802,4118,안산시상록구,관외사전투표,,3368,3367,1732,1268,72,218,3290,77,1
4100,경기도,안산시나선거구,6411802,4118,안산시상록구,본오1동,계,30680,10768,5301,4184,222,777,10484,284,19912
4100,경기도,안산시나선거구,6411802,4118,안산시상록구,본오1동,관내사전투표,3146,3143,1637,1141,57,261,3096,47,3
4100,경기도,안산시나선거구,6411802,4118,안산시상록구,본오1동,선거일투표,27534,7625,3664,3043,165,516,7388,237,19909
4100,경기도,안산시나선거구,6411802,4118,안산시상록구,본오2동,계,21836,9609,4678,3818,188,597,9281,328,12227
4100,경기도,안산시나선거구,6411802,4118,안산시상록구,본오2동,관내사전투표,2547,2545,1290,996,50,154,2490,55,2
4100,경기도,안산시나선거구,6411802,4118,안산시상록구,본오2동,선거일투표,19289,7064,3388,2822,138,443,6791,273,12225
4100,경기도,안산시나선거구,6411802,4118,안산시상록구,반월동,계,14843,7864,3235,3070,111,1079,7495,369,6979
4100,경기도,안산시나선거구,6411802,4118,안산시상록구,반월동,관내사전투표,2825,2825,1277,1073,27,367,2744,81,0
4100,경기도,안산시나선거구,6411802,4118,안산시상록구,반월동,선거일투표,12018,5039,1958,1997,84,712,4751,288,6979
4100,경기도,안산시나선거구,6411802,4118,안산시상록구,잘못 투입·구분된 투표지,,0,21,8,8,0,2,18,3,-21
4100,경기도,안산시다선거구,6411803,4118,안산시상록구,합계,,66386,30140,12400,3732,12926,29058,1082,36246
4100,경기도,안산시다선거구,6411803,4118,안산시상록구,거소투표,,91,86,38,8,34,80,6,5
4100,경기도,안산시다선거구,6411803,4118,안산시상록구,관외사전투표,,3086,3085,1359,400,1245,3004,81,1
4100,경기도,안산시다선거구,6411803,4118,안산시상록구,일동,계,20769,8053,3643,962,3092,7697,356,12716
4100,경기도,안산시다선거구,6411803,4118,안산시상록구,일동,관내사전투표,2717,2716,1249,334,1033,2616,100,1
4100,경기도,안산시다선거구,6411803,4118,안산시상록구,일동,선거일투표,18052,5337,2394,628,2059,5081,256,12715
4100,경기도,안산시다선거구,6411803,4118,안산시상록구,이동,계,20960,7575,3117,944,3254,7315,260,13385
4100,경기도,안산시다선거구,6411803,4118,안산시상록구,이동,관내사전투표,1890,1889,803,266,761,1830,59,1
4100,경기도,안산시다선거구,6411803,4118,안산시상록구,이동,선거일투표,19070,5686,2314,678,2493,5485,201,13384
4100,경기도,안산시다선거구,6411803,4118,안산시상록구,성포동,계,21480,11322,4233,1417,5294,10944,378,10158
4100,경기도,안산시다선거구,6411803,4118,안산시상록구,성포동,관내사전투표,3484,3479,1352,443,1626,3421,58,5
4100,경기도,안산시다선거구,6411803,4118,안산시상록구,성포동,선거일투표,17996,7843,2881,974,3668,7523,320,10153
4100,경기도,안산시다선거구,6411803,4118,안산시상록구,잘못 투입·구분된 투표지,,0,19,10,1,7,18,1,-19
4100,경기도,안산시라선거구,6411804,4118,안산시상록구,합계,,60498,26218,13236,8244,3475,24955,1263,34280
4100,경기도,안산시라선거구,6411804,4118,안산시상록구,거소투표,,98,97,43,29,21,93,4,1
4100,경기도,안산시라선거구,6411804,4118,안산시상록구,관외사전투표,,2534,2531,1411,781,259,2451,80,3
4100,경기도,안산시라선거구,6411804,4118,안산시상록구,부곡동,계,18210,7132,3664,2172,1016,6852,280,11078
4100,경기도,안산시라선거구,6411804,4118,안산시상록구,부곡동,관내사전투표,2418,2418,1282,705,367,2354,64,0
4100,경기도,안산시라선거구,6411804,4118,안산시상록구,부곡동,선거일투표,15792,4714,2382,1467,649,4498,216,11078
4100,경기도,안산시라선거구,6411804,4118,안산시상록구,월피동,계,31883,12848,6424,4032,1654,12110,738,19035
4100,경기도,안산시라선거구,6411804,4118,안산시상록구,월피동,관내사전투표,2989,2987,1563,960,355,2878,109,2
4100,경기도,안산시라선거구,6411804,4118,안산시상록구,월피동,선거일투표,28894,9861,4861,3072,1299,9232,629,19033
4100,경기도,안산시라선거구,6411804,4118,안산시상록구,안산동,계,7773,3600,1690,1226,524,3440,160,4173
4100,경기도,안산시라선거구,6411804,4118,안산시상록구,안산동,관내사전투표,1385,1385,684,451,194,1329,56,0
4100,경기도,안산시라선거구,6411804,4118,안산시상록구,안산동,선거일투표,6388,2215,1006,775,330,2111,104,4173
4100,경기도,안산시라선거구,6411804,4118,안산시상록구,잘못 투입·구분된 투표지,,0,10,4,4,1,9,1,-10
4100,경기도,안산시마선거구,6411901,4119,안산시단원구,검색된 결과가 없습니다.
4100,경기도,안산시바선거구,6411902,4119,안산시단원구,합계,,77037,33019,9075,6891,8156,4380,1370,892,30764,2255,44018
4100,경기도,안산시바선거구,6411902,4119,안산시단원구,거소투표,,82,78,22,19,18,6,3,4,72,6,4
4100,경기도,안산시바선거구,6411902,4119,안산시단원구,관외사전투표,,2649,2637,917,491,639,309,64,63,2483,154,12
4100,경기도,안산시바선거구,6411902,4119,안산시단원구,원곡동,계,7961,1863,567,304,557,191,57,38,1714,149,6098
4100,경기도,안산시바선거구,6411902,4119,안산시단원구,원곡동,관내사전투표,720,720,231,136,185,70,25,12,659,61,0
4100,경기도,안산시바선거구,6411902,4119,안산시단원구,원곡동,선거일투표,7241,1143,336,168,372,121,32,26,1055,88,6098
4100,경기도,안산시바선거구,6411902,4119,안산시단원구,백운동,계,18290,8304,1885,1915,2189,999,489,357,7834,470,9986
4100,경기도,안산시바선거구,6411902,4119,안산시단원구,백운동,관내사전투표,2861,2857,678,635,822,294,152,116,2697,160,4
4100,경기도,안산시바선거구,6411902,4119,안산시단원구,백운동,선거일투표,15429,5447,1207,1280,1367,705,337,241,5137,310,9982
4100,경기도,안산시바선거구,6411902,4119,안산시단원구,신길동,계,18741,7964,2298,1734,1834,1129,234,147,7376,588,10777
4100,경기도,안산시바선거구,6411902,4119,안산시단원구,신길동,관내사전투표,2160,2157,647,450,496,297,54,43,1987,170,3
4100,경기도,안산시바선거구,6411902,4119,안산시단원구,신길동,선거일투표,16581,5807,1651,1284,1338,832,180,104,5389,418,10774
4100,경기도,안산시바선거구,6411902,4119,안산시단원구,선부1동,계,15141,7159,1922,1406,1717,1086,335,167,6633,526,7982
4100,경기도,안산시바선거구,6411902,4119,안산시단원구,선부1동,관내사전투표,2057,2053,598,415,468,289,84,51,1905,148,4
4100,경기도,안산시바선거구,6411902,4119,안산시단원구,선부1동,선거일투표,13084,5106,1324,991,1249,797,251,116,4728,378,7978
4100,경기도,안산시바선거구,6411902,4119,안산시단원구,선부2동,계,14173,4986,1457,1018,1193,658,186,115,4627,359,9187
4100,경기도,안산시바선거구,6411902,4119,안산시단원구,선부2동,관내사전투표,1552,1552,457,354,357,177,54,41,1440,112,0
4100,경기도,안산시바선거구,6411902,4119,안산시단원구,선부2동,선거일투표,12621,3434,1000,664,836,481,132,74,3187,247,9187
4100,경기도,안산시바선거구,6411902,4119,안산시단원구,잘못 투입·구분된 투표지,,0,28,7,4,9,2,2,1,25,3,-28
4100,경기도,안산시사선거구,6411903,4119,안산시단원구,합계,,59162,28340,11285,3145,6731,4637,25798,2542,30822
4100,경기도,안산시사선거구,6411903,4119,안산시단원구,거소투표,,84,81,32,13,15,12,72,9,3
4100,경기도,안산시사선거구,6411903,4119,안산시단원구,관외사전투표,,3152,3151,1252,420,689,516,2877,274,1
4100,경기도,안산시사선거구,6411903,4119,안산시단원구,고잔동,계,18214,7657,2959,976,1759,1172,6866,791,10557
4100,경기도,안산시사선거구,6411903,4119,안산시단원구,고잔동,관내사전투표,2553,2553,1027,321,589,381,2318,235,0
4100,경기도,안산시사선거구,6411903,4119,안산시단원구,고잔동,선거일투표,15661,5104,1932,655,1170,791,4548,556,10557
4100,경기도,안산시사선거구,6411903,4119,안산시단원구,초지동,계,37712,17441,7040,1734,4266,2934,15974,1467,20271
4100,경기도,안산시사선거구,6411903,4119,안산시단원구,초지동,관내사전투표,4451,4451,1878,456,1035,637,4006,445,0
4100,경기도,안산시사선거구,6411903,4119,안산시단원구,초지동,선거일투표,33261,12990,5162,1278,3231,2297,11968,1022,20271
4100,경기도,안산시사선거구,6411903,4119,안산시단원구,잘못 투입·구분된 투표지,,0,10,2,2,2,3,9,1,-10
4100,경기도,안산시아선거구,6411904,4119,안산시단원구,합계,,66697,34645,10368,5484,11496,3790,1473,32611,2034,32052
4100,경기도,안산시아선거구,6411904,4119,안산시단원구,거소투표,,194,183,40,15,82,25,10,172,11,11
4100,경기도,안산시아선거구,6411904,4119,안산시단원구,관외사전투표,,3848,3842,1243,578,1255,376,169,3621,221,6
4100,경기도,안산시아선거구,6411904,4119,안산시단원구,중앙동,계,20463,8856,2669,1415,2901,976,370,8331,525,11607
4100,경기도,안산시아선거구,6411904,4119,안산시단원구,중앙동,관내사전투표,3310,3309,1035,569,1088,335,128,3155,154,1
4100,경기도,안산시아선거구,6411904,4119,안산시단원구,중앙동,선거일투표,17153,5547,1634,846,1813,641,242,5176,371,11606
4100,경기도,안산시아선거구,6411904,4119,안산시단원구,호수동,계,34376,17974,5577,3078,5445,2014,860,16974,1000,16402
4100,경기도,안산시아선거구,6411904,4119,안산시단원구,호수동,관내사전투표,3950,3945,1262,768,1119,426,160,3735,210,5
4100,경기도,안산시아선거구,6411904,4119,안산시단원구,호수동,선거일투표,30426,14029,4315,2310,4326,1588,700,13239,790,16397
4100,경기도,안산시아선거구,6411904,4119,안산시단원구,대부동,계,7816,3768,832,394,1804,398,64,3492,276,4048
4100,경기도,안산시아선거구,6411904,4119,안산시단원구,대부동,관내사전투표,1510,1503,381,164,667,147,23,1382,121,7
4100,경기도,안산시아선거구,6411904,4119,안산시단원구,대부동,선거일투표,6306,2265,451,230,1137,251,41,2110,155,4041
4100,경기도,안산시아선거구,6411904,4119,안산시단원구,잘못 투입·구분된 투표지,,0,22,7,4,9,1,0,21,1,-22
4100,경기도,고양시가선거구,6412001,4120,고양시덕양구,합계,,64870,33630,14118,13889,4184,32191,1439,31240
4100,경기도,고양시가선거구,6412001,4120,고양시덕양구,거소투표,,56,50,20,24,4,48,2,6
4100,경기도,고양시가선거구,6412001,4120,고양시덕양구,관외사전투표,,3966,3962,1937,1531,413,3881,81,4
4100,경기도,고양시가선거구,6412001,4120,고양시덕양구,주교동,계,11618,4754,2005,2207,321,4533,221,6864
4100,경기도,고양시가선거구,6412001,4120,고양시덕양구,주교동,관내사전투표,1738,1738,774,838,103,1715,23,0
4100,경기도,고양시가선거구,6412001,4120,고양시덕양구,주교동,선거일투표,9880,3016,1231,1369,218,2818,198,6864
4100,경기도,고양시가선거구,6412001,4120,고양시덕양구,흥도동,계,21228,10767,3985,3782,2522,10289,478,10461
4100,경기도,고양시가선거구,6412001,4120,고양시덕양구,흥도동,관내사전투표,1768,1765,680,749,307,1736,29,3
4100,경기도,고양시가선거구,6412001,4120,고양시덕양구,흥도동,선거일투표,19460,9002,3305,3033,2215,8553,449,10458
4100,경기도,고양시가선거구,6412001,4120,고양시덕양구,성사1동,계,18591,8965,3871,4044,615,8530,435,9626
4100,경기도,고양시가선거구,6412001,4120,고양시덕양구,성사1동,관내사전투표,3140,3134,1463,1399,169,3031,103,6
4100,경기도,고양시가선거구,6412001,4120,고양시덕양구,성사1동,선거일투표,15451,5831,2408,2645,446,5499,332,9620
4100,경기도,고양시가선거구,6412001,4120,고양시덕양구,성사2동,계,9411,5110,2291,2297,308,4896,214,4301
4100,경기도,고양시가선거구,6412001,4120,고양시덕양구,성사2동,관내사전투표,1771,1770,846,776,96,1718,52,1
4100,경기도,고양시가선거구,6412001,4120,고양시덕양구,성사2동,선거일투표,7640,3340,1445,1521,212,3178,162,4300
4100,경기도,고양시가선거구,6412001,4120,고양시덕양구,잘못 투입·구분된 투표지,,0,22,9,4,1,14,8,-22
4100,경기도,고양시나선거구,6412002,4120,고양시덕양구,합계,,76520,35567,12654,3321,10246,4208,3028,33457,2110,40953
4100,경기도,고양시나선거구,6412002,4120,고양시덕양구,거소투표,,158,148,46,12,35,12,10,115,33,10
4100,경기도,고양시나선거구,6412002,4120,고양시덕양구,관외사전투표,,4248,4238,1631,489,1049,514,301,3984,254,10
4100,경기도,고양시나선거구,6412002,4120,고양시덕양구,원신동,계,17336,8385,2738,741,2171,1067,1256,7973,412,8951
4100,경기도,고양시나선거구,6412002,4120,고양시덕양구,원신동,관내사전투표,1479,1475,478,135,409,165,209,1396,79,4
4100,경기도,고양시나선거구,6412002,4120,고양시덕양구,원신동,선거일투표,15857,6910,2260,606,1762,902,1047,6577,333,8947
4100,경기도,고양시나선거구,6412002,4120,고양시덕양구,고양동,계,24100,10604,3806,926,3150,1322,780,9984,620,13496
4100,경기도,고양시나선거구,6412002,4120,고양시덕양구,고양동,관내사전투표,4097,4091,1563,331,1184,477,307,3862,229,6
4100,경기도,고양시나선거구,6412002,4120,고양시덕양구,고양동,선거일투표,20003,6513,2243,595,1966,845,473,6122,391,13490
4100,경기도,고양시나선거구,6412002,4120,고양시덕양구,관산동,계,30678,12162,4425,1148,3835,1290,678,11376,786,18516
4100,경기도,고양시나선거구,6412002,4120,고양시덕양구,관산동,관내사전투표,3205,3200,1244,319,1008,278,173,3022,178,5
4100,경기도,고양시나선거구,6412002,4120,고양시덕양구,관산동,선거일투표,27473,8962,3181,829,2827,1012,505,8354,608,18511
4100,경기도,고양시나선거구,6412002,4120,고양시덕양구,잘못 투입·구분된 투표지,,0,30,8,5,6,3,3,25,5,-30
4100,경기도,고양시다선거구,6412003,4120,고양시덕양구,합계,,60246,33783,13755,14870,4444,253,33322,461,26463
4100,경기도,고양시다선거구,6412003,4120,고양시덕양구,거소투표,,43,39,17,17,4,0,38,1,4
4100,경기도,고양시다선거구,6412003,4120,고양시덕양구,관외사전투표,,3335,3333,1513,1381,362,28,3284,49,2
4100,경기도,고양시다선거구,6412003,4120,고양시덕양구,화정1동,계,31506,16800,6437,7772,2243,95,16547,253,14706
4100,경기도,고양시다선거구,6412003,4120,고양시덕양구,화정1동,관내사전투표,5761,5754,2399,2512,761,28,5700,54,7
4100,경기도,고양시다선거구,6412003,4120,고양시덕양구,화정1동,선거일투표,25745,11046,4038,5260,1482,67,10847,199,14699
4100,경기도,고양시다선거구,6412003,4120,고양시덕양구,화정2동,계,25362,13591,5782,5694,1828,130,13434,157,11771
4100,경기도,고양시다선거구,6412003,4120,고양시덕양구,화정2동,관내사전투표,3826,3817,1779,1502,458,43,3782,35,9
4100,경기도,고양시다선거구,6412003,4120,고양시덕양구,화정2동,선거일투표,21536,9774,4003,4192,1370,87,9652,122,11762
4100,경기도,고양시다선거구,6412003,4120,고양시덕양구,잘못 투입·구분된 투표지,,0,20,6,6,7,0,19,1,-20
4100,경기도,고양시라선거구,6412004,4120,고양시덕양구,합계,,96535,51024,18551,4480,11505,8626,5452,48614,2410,45511
4100,경기도,고양시라선거구,6412004,4120,고양시덕양구,거소투표,,96,92,35,9,19,15,4,82,10,4
4100,경기도,고양시라선거구,6412004,4120,고양시덕양구,관외사전투표,,6099,6086,2443,576,1332,930,485,5766,320,13
4100,경기도,고양시라선거구,6412004,4120,고양시덕양구,효자동,계,12941,6979,2332,687,1496,1164,953,6632,347,5962
4100,경기도,고양시라선거구,6412004,4120,고양시덕양구,효자동,관내사전투표,1966,1965,738,206,391,283,251,1869,96,1
4100,경기도,고양시라선거구,6412004,4120,고양시덕양구,효자동,선거일투표,10975,5014,1594,481,1105,881,702,4763,251,5961
4100,경기도,고양시라선거구,6412004,4120,고양시덕양구,삼송1동,계,16346,8551,3038,736,1870,1554,944,8142,409,7795
4100,경기도,고양시라선거구,6412004,4120,고양시덕양구,삼송1동,관내사전투표,2950,2950,1110,302,599,493,286,2790,160,0
4100,경기도,고양시라선거구,6412004,4120,고양시덕양구,삼송1동,선거일투표,13396,5601,1928,434,1271,1061,658,5352,249,7795
4100,경기도,고양시라선거구,6412004,4120,고양시덕양구,삼송2동,계,21966,10321,3698,838,2429,1736,1080,9781,540,11645
4100,경기도,고양시라선거구,6412004,4120,고양시덕양구,삼송2동,관내사전투표,2704,2703,1048,245,615,401,269,2578,125,1
4100,경기도,고양시라선거구,6412004,4120,고양시덕양구,삼송2동,선거일투표,19262,7618,2650,593,1814,1335,811,7203,415,11644
4100,경기도,고양시라선거구,6412004,4120,고양시덕양구,창릉동,계,18572,8971,3387,696,1888,1824,810,8605,366,9601
4100,경기도,고양시라선거구,6412004,4120,고양시덕양구,창릉동,관내사전투표,2519,2502,1001,202,550,432,205,2390,112,17
4100,경기도,고양시라선거구,6412004,4120,고양시덕양구,창릉동,선거일투표,16053,6469,2386,494,1338,1392,605,6215,254,9584
4100,경기도,고양시라선거구,6412004,4120,고양시덕양구,화전동,계,20515,9988,3604,937,2462,1396,1173,9572,416,10527
4100,경기도,고양시라선거구,6412004,4120,고양시덕양구,화전동,관내사전투표,1648,1647,569,166,489,197,137,1558,89,1
4100,경기도,고양시라선거구,6412004,4120,고양시덕양구,화전동,선거일투표,18867,8341,3035,771,1973,1199,1036,8014,327,10526
4100,경기도,고양시라선거구,6412004,4120,고양시덕양구,잘못 투입·구분된 투표지,,0,36,14,1,9,7,3,34,2,-36
4100,경기도,고양시마선거구,6412005,4120,고양시덕양구,합계,,104750,56490,17612,8993,15689,6081,3290,1193,52858,3632,48260
4100,경기도,고양시마선거구,6412005,4120,고양시덕양구,거소투표,,104,97,29,8,31,15,5,2,90,7,7
4100,경기도,고양시마선거구,6412005,4120,고양시덕양구,관외사전투표,,5828,5822,2018,862,1693,534,254,90,5451,371,6
4100,경기도,고양시마선거구,6412005,4120,고양시덕양구,행주동,계,15885,6720,1926,893,2270,713,182,228,6212,508,9165
4100,경기도,고양시마선거구,6412005,4120,고양시덕양구,행주동,관내사전투표,2193,2190,674,284,728,211,59,78,2034,156,3
4100,경기도,고양시마선거구,6412005,4120,고양시덕양구,행주동,선거일투표,13692,4530,1252,609,1542,502,123,150,4178,352,9162
4100,경기도,고양시마선거구,6412005,4120,고양시덕양구,행신1동,계,17606,9342,2772,1576,2631,987,691,150,8807,535,8264
4100,경기도,고양시마선거구,6412005,4120,고양시덕양구,행신1동,관내사전투표,2835,2833,859,591,787,246,164,36,2683,150,2
4100,경기도,고양시마선거구,6412005,4120,고양시덕양구,행신1동,선거일투표,14771,6509,1913,985,1844,741,527,114,6124,385,8262
4100,경기도,고양시마선거구,6412005,4120,고양시덕양구,행신2동,계,26405,14160,4294,2263,3659,1722,910,370,13218,942,12245
4100,경기도,고양시마선거구,6412005,4120,고양시덕양구,행신2동,관내사전투표,5040,5032,1595,837,1311,538,292,133,4706,326,8
4100,경기도,고양시마선거구,6412005,4120,고양시덕양구,행신2동,선거일투표,21365,9128,2699,1426,2348,1184,618,237,8512,616,12237
4100,경기도,고양시마선거구,6412005,4120,고양시덕양구,행신3동,계,19677,11062,3499,1891,2914,1187,751,177,10419,643,8615
4100,경기도,고양시마선거구,6412005,4120,고양시덕양구,행신3동,관내사전투표,3677,3663,1218,632,975,368,181,65,3439,224,14
4100,경기도,고양시마선거구,6412005,4120,고양시덕양구,행신3동,선거일투표,16000,7399,2281,1259,1939,819,570,112,6980,419,8601
4100,경기도,고양시마선거구,6412005,4120,고양시덕양구,행신4동,계,16996,8176,2757,1363,2102,790,460,165,7637,539,8820
4100,경기도,고양시마선거구,6412005,4120,고양시덕양구,행신4동,관내사전투표,2816,2799,961,493,696,234,164,62,2610,189,17
4100,경기도,고양시마선거구,6412005,4120,고양시덕양구,행신4동,선거일투표,14180,5377,1796,870,1406,556,296,103,5027,350,8803
4100,경기도,고양시마선거구,6412005,4120,고양시덕양구,대덕동,계,2249,1053,295,129,375,132,36,9,976,77,1196
4100,경기도,고양시마선거구,6412005,4120,고양시덕양구,대덕동,관내사전투표,436,434,129,50,151,52,17,6,405,29,2
4100,경기도,고양시마선거구,6412005,4120,고양시덕양구,대덕동,선거일투표,1813,619,166,79,224,80,19,3,571,48,1194
4100,경기도,고양시마선거구,6412005,4120,고양시덕양구,잘못 투입·구분된 투표지,,0,58,22,8,14,1,1,2,48,10,-58
4100,경기도,고양시바선거구,6412101,4120,고양시덕양구,합계,,58854,30500,11574,3489,13906,28969,1531,28354
4100,경기도,고양시바선거구,6412101,4120,고양시덕양구,거소투표,,59,54,23,10,19,52,2,5
4100,경기도,고양시바선거구,6412101,4120,고양시덕양구,관외사전투표,,3755,3752,1547,490,1625,3662,90,3
4100,경기도,고양시바선거구,6412101,4120,고양시덕양구,능곡동,계,12419,6351,2014,851,3086,5951,400,6068
4100,경기도,고양시바선거구,6412101,4120,고양시덕양구,능곡동,관내사전투표,2210,2209,719,331,1057,2107,102,1
4100,경기도,고양시바선거구,6412101,4120,고양시덕양구,능곡동,선거일투표,10209,4142,1295,520,2029,3844,298,6067
4100,경기도,고양시바선거구,6412101,4120,고양시덕양구,백석1동,계,24615,12438,4806,1269,5637,11712,726,12177
4100,경기도,고양시바선거구,6412101,4120,고양시덕양구,백석1동,관내사전투표,2882,2880,1179,356,1287,2822,58,2
4100,경기도,고양시바선거구,6412101,4120,고양시덕양구,백석1동,선거일투표,21733,9558,3627,913,4350,8890,668,12175
4100,경기도,고양시바선거구,6412101,4120,고양시덕양구,백석2동,계,18006,7889,3176,867,3534,7577,312,10117
4100,경기도,고양시바선거구,6412101,4120,고양시덕양구,백석2동,관내사전투표,2687,2687,1203,313,1099,2615,72,0
4100,경기도,고양시바선거구,6412101,4120,고양시덕양구,백석2동,선거일투표,15319,5202,1973,554,2435,4962,240,10117
4100,경기도,고양시바선거구,6412101,4120,고양시덕양구,잘못 투입·구분된 투표지,,0,16,8,2,5,15,1,-16
4100,경기도,고양시사선거구,6412102,4121,고양시일산동구,합계,,84583,41673,13216,4953,11012,7701,2635,39517,2156,42910
4100,경기도,고양시사선거구,6412102,4121,고양시일산동구,거소투표,,177,172,46,28,40,24,6,144,28,5
4100,경기도,고양시사선거구,6412102,4121,고양시일산동구,관외사전투표,,5457,5451,2005,638,1504,793,191,5131,320,6
4100,경기도,고양시사선거구,6412102,4121,고양시일산동구,식사동,계,30309,15141,3981,1489,4012,2793,2173,14448,693,15168
4100,경기도,고양시사선거구,6412102,4121,고양시일산동구,식사동,관내사전투표,3856,3855,1079,451,1036,628,443,3637,218,1
4100,경기도,고양시사선거구,6412102,4121,고양시일산동구,식사동,선거일투표,26453,11286,2902,1038,2976,2165,1730,10811,475,15167
4100,경기도,고양시사선거구,6412102,4121,고양시일산동구,풍산동,계,29935,14207,4931,2159,3291,2890,190,13461,746,15728
4100,경기도,고양시사선거구,6412102,4121,고양시일산동구,풍산동,관내사전투표,3499,3496,1217,609,784,663,33,3306,190,3
4100,경기도,고양시사선거구,6412102,4121,고양시일산동구,풍산동,선거일투표,26436,10711,3714,1550,2507,2227,157,10155,556,15725
4100,경기도,고양시사선거구,6412102,4121,고양시일산동구,고봉동,계,18705,6680,2246,638,2160,1197,73,6314,366,12025
4100,경기도,고양시사선거구,6412102,4121,고양시일산동구,고봉동,관내사전투표,1650,1645,549,175,551,256,22,1553,92,5
4100,경기도,고양시사선거구,6412102,4121,고양시일산동구,고봉동,선거일투표,17055,5035,1697,463,1609,941,51,4761,274,12020
4100,경기도,고양시사선거구,6412102,4121,고양시일산동구,잘못 투입·구분된 투표지,,0,22,7,1,5,4,2,19,3,-22
4100,경기도,고양시아선거구,6412103,4121,고양시일산동구,합계,,76911,39560,10742,8221,10222,6727,35912,3648,37351
4100,경기도,고양시아선거구,6412103,4121,고양시일산동구,거소투표,,108,100,24,18,23,13,78,22,8
4100,경기도,고양시아선거구,6412103,4121,고양시일산동구,관외사전투표,,4173,4168,1193,932,1110,589,3824,344,5
4100,경기도,고양시아선거구,6412103,4121,고양시일산동구,중산1동,계,18108,8811,2234,1769,2306,1741,8050,761,9297
4100,경기도,고양시아선거구,6412103,4121,고양시일산동구,중산1동,관내사전투표,3277,3274,903,653,826,626,3008,266,3
4100,경기도,고양시아선거구,6412103,4121,고양시일산동구,중산1동,선거일투표,14831,5537,1331,1116,1480,1115,5042,495,9294
4100,경기도,고양시아선거구,6412103,4121,고양시일산동구,중산2동,계,19122,9166,2666,1942,2111,1467,8186,980,9956
4100,경기도,고양시아선거구,6412103,4121,고양시일산동구,중산2동,관내사전투표,2451,2444,707,567,535,398,2207,237,7
4100,경기도,고양시아선거구,6412103,4121,고양시일산동구,중산2동,선거일투표,16671,6722,1959,1375,1576,1069,5979,743,9949
4100,경기도,고양시아선거구,6412103,4121,고양시일산동구,정발산동,계,19209,9161,2400,1856,2620,1506,8382,779,10048
4100,경기도,고양시아선거구,6412103,4121,고양시일산동구,정발산동,관내사전투표,2610,2600,736,561,692,415,2404,196,10
4100,경기도,고양시아선거구,6412103,4121,고양시일산동구,정발산동,선거일투표,16599,6561,1664,1295,1928,1091,5978,583,10038
4100,경기도,고양시아선거구,6412103,4121,고양시일산동구,일산2동,계,16191,8127,2218,1697,2047,1410,7372,755,8064
4100,경기도,고양시아선거구,6412103,4121,고양시일산동구,일산2동,관내사전투표,2776,2775,776,656,663,489,2584,191,1
4100,경기도,고양시아선거구,6412103,4121,고양시일산동구,일산2동,선거일투표,13415,5352,1442,1041,1384,921,4788,564,8063
4100,경기도,고양시아선거구,6412103,4121,고양시일산동구,잘못 투입·구분된 투표지,,0,27,7,7,5,1,20,7,-27
4100,경기도,고양시자선거구,6412201,4121,고양시일산동구,검색된 결과가 없습니다.
4100,경기도,고양시차선거구,6412202,4122,고양시일산서구,검색된 결과가 없습니다.
4100,경기도,고양시카선거구,6412203,4122,고양시일산서구,합계,,47820,27493,10095,3465,12901,26461,1032,20327
4100,경기도,고양시카선거구,6412203,4122,고양시일산서구,거소투표,,64,59,21,8,29,58,1,5
4100,경기도,고양시카선거구,6412203,4122,고양시일산서구,관외사전투표,,2549,2548,1045,325,1108,2478,70,1
4100,경기도,고양시카선거구,6412203,4122,고양시일산서구,주엽1동,계,22230,12410,4346,1664,5911,11921,489,9820
4100,경기도,고양시카선거구,6412203,4122,고양시일산서구,주엽1동,관내사전투표,3360,3358,1201,568,1499,3268,90,2
4100,경기도,고양시카선거구,6412203,4122,고양시일산서구,주엽1동,선거일투표,18870,9052,3145,1096,4412,8653,399,9818
4100,경기도,고양시카선거구,6412203,4122,고양시일산서구,주엽2동,계,22977,12465,4679,1467,5848,11994,471,10512
4100,경기도,고양시카선거구,6412203,4122,고양시일산서구,주엽2동,관내사전투표,3287,3286,1327,469,1428,3224,62,1
4100,경기도,고양시카선거구,6412203,4122,고양시일산서구,주엽2동,선거일투표,19690,9179,3352,998,4420,8770,409,10511
4100,경기도,고양시카선거구,6412203,4122,고양시일산서구,잘못 투입·구분된 투표지,,0,11,4,1,5,10,1,-11
4100,경기도,고양시타선거구,6412204,4122,고양시일산서구,합계,,59731,32510,15154,13375,2600,31129,1381,27221
4100,경기도,고양시타선거구,6412204,4122,고양시일산서구,거소투표,,61,61,30,20,10,60,1,0
4100,경기도,고양시타선거구,6412204,4122,고양시일산서구,관외사전투표,,3790,3788,1959,1485,258,3702,86,2
4100,경기도,고양시타선거구,6412204,4122,고양시일산서구,일산3동,계,26159,14617,6867,5968,1203,14038,579,11542
4100,경기도,고양시타선거구,6412204,4122,고양시일산서구,일산3동,관내사전투표,3505,3503,1822,1386,232,3440,63,2
4100,경기도,고양시타선거구,6412204,4122,고양시일산서구,일산3동,선거일투표,22654,11114,5045,4582,971,10598,516,11540
4100,경기도,고양시타선거구,6412204,4122,고양시일산서구,대화동,계,29721,14019,6288,5892,1127,13307,712,15702
4100,경기도,고양시타선거구,6412204,4122,고양시일산서구,대화동,관내사전투표,3053,3051,1563,1215,209,2987,64,2
4100,경기도,고양시타선거구,6412204,4122,고양시일산서구,대화동,선거일투표,26668,10968,4725,4677,918,10320,648,15700
4100,경기도,고양시타선거구,6412204,4122,고양시일산서구,잘못 투입·구분된 투표지,,0,25,10,10,2,22,3,-25
4100,경기도,고양시파선거구,6412205,4122,고양시일산서구,합계,,60480,31548,10339,4942,15244,30525,1023,28932
4100,경기도,고양시파선거구,6412205,4122,고양시일산서구,거소투표,,90,87,32,9,37,78,9,3
4100,경기도,고양시파선거구,6412205,4122,고양시일산서구,관외사전투표,,3489,3487,1345,498,1555,3398,89,2
4100,경기도,고양시파선거구,6412205,4122,고양시일산서구,송포동,계,17032,9023,2863,1385,4459,8707,316,8009
4100,경기도,고양시파선거구,6412205,4122,고양시일산서구,송포동,관내사전투표,2797,2797,927,490,1325,2742,55,0
4100,경기도,고양시파선거구,6412205,4122,고양시일산서구,송포동,선거일투표,14235,6226,1936,895,3134,5965,261,8009
4100,경기도,고양시파선거구,6412205,4122,고양시일산서구,덕이동,계,24387,10893,3323,1760,5431,10514,379,13494
4100,경기도,고양시파선거구,6412205,4122,고양시일산서구,덕이동,관내사전투표,2612,2611,875,451,1221,2547,64,1
4100,경기도,고양시파선거구,6412205,4122,고양시일산서구,덕이동,선거일투표,21775,8282,2448,1309,4210,7967,315,13493
4100,경기도,고양시파선거구,6412205,4122,고양시일산서구,가좌동,계,15482,8041,2771,1288,3755,7814,227,7441
4100,경기도,고양시파선거구,6412205,4122,고양시일산서구,가좌동,관내사전투표,2855,2854,1030,435,1338,2803,51,1
4100,경기도,고양시파선거구,6412205,4122,고양시일산서구,가좌동,선거일투표,12627,5187,1741,853,2417,5011,176,7440
4100,경기도,고양시파선거구,6412205,4122,고양시일산서구,잘못 투입·구분된 투표지,,0,17,5,2,7,14,3,-17
4100,경기도,과천시가선거구,6412301,4123,과천시,합계,,31260,20140,5213,1875,6034,3883,595,1359,18959,1181,11120
4100,경기도,과천시가선거구,6412301,4123,과천시,거소투표,,46,45,11,7,9,6,3,4,40,5,1
4100,경기도,과천시가선거구,6412301,4123,과천시,관외사전투표,,2531,2530,755,267,761,387,69,125,2364,166,1
4100,경기도,과천시가선거구,6412301,4123,과천시,중앙동,계,8784,5873,1426,478,1839,1139,137,533,5552,321,2911
4100,경기도,과천시가선거구,6412301,4123,과천시,중앙동,관내사전투표,2194,2188,579,180,668,430,45,156,2058,130,6
4100,경기도,과천시가선거구,6412301,4123,과천시,중앙동,선거일투표,6590,3685,847,298,1171,709,92,377,3494,191,2905
4100,경기도,과천시가선거구,6412301,4123,과천시,별양동,계,12564,7903,2005,737,2311,1630,192,595,7470,433,4661
4100,경기도,과천시가선거구,6412301,4123,과천시,별양동,관내사전투표,2224,2206,588,237,597,456,46,123,2047,159,18
4100,경기도,과천시가선거구,6412301,4123,과천시,별양동,선거일투표,10340,5697,1417,500,1714,1174,146,472,5423,274,4643
4100,경기도,과천시가선거구,6412301,4123,과천시,과천동,계,7335,3761,1011,383,1108,713,193,99,3507,254,3574
4100,경기도,과천시가선거구,6412301,4123,과천시,과천동,관내사전투표,933,932,252,101,262,170,44,24,853,79,1
4100,경기도,과천시가선거구,6412301,4123,과천시,과천동,선거일투표,6402,2829,759,282,846,543,149,75,2654,175,3573
4100,경기도,과천시가선거구,6412301,4123,과천시,잘못 투입·구분된 투표지,,0,28,5,3,6,8,1,3,26,2,-28
4100,경기도,과천시나선거구,6412302,4123,과천시,합계,,33960,22517,4101,3728,5072,5875,2650,21426,1091,11443
4100,경기도,과천시나선거구,6412302,4123,과천시,거소투표,,36,36,10,5,9,9,1,34,2,0
4100,경기도,과천시나선거구,6412302,4123,과천시,관외사전투표,,2760,2756,643,439,638,643,249,2612,144,4
4100,경기도,과천시나선거구,6412302,4123,과천시,갈현동,계,13729,8778,1439,1510,1876,2643,923,8391,387,4951
4100,경기도,과천시나선거구,6412302,4123,과천시,갈현동,관내사전투표,2127,2123,381,430,416,602,177,2006,117,4
4100,경기도,과천시나선거구,6412302,4123,과천시,갈현동,선거일투표,11602,6655,1058,1080,1460,2041,746,6385,270,4947
4100,경기도,과천시나선거구,6412302,4123,과천시,부림동,계,11665,7432,1326,973,1941,1797,1031,7068,364,4233
4100,경기도,과천시나선거구,6412302,4123,과천시,부림동,관내사전투표,2942,2940,550,444,735,665,371,2765,175,2
4100,경기도,과천시나선거구,6412302,4123,과천시,부림동,선거일투표,8723,4492,776,529,1206,1132,660,4303,189,4231
4100,경기도,과천시나선거구,6412302,4123,과천시,문원동,계,5770,3501,676,799,604,783,446,3308,193,2269
4100,경기도,과천시나선거구,6412302,4123,과천시,문원동,관내사전투표,1227,1223,241,280,201,284,142,1148,75,4
4100,경기도,과천시나선거구,6412302,4123,과천시,문원동,선거일투표,4543,2278,435,519,403,499,304,2160,118,2265
4100,경기도,과천시나선거구,6412302,4123,과천시,잘못 투입·구분된 투표지,,0,14,7,2,4,0,0,13,1,-14
4100,경기도,의왕시가선거구,6412401,4124,의왕시,합계,,70928,39942,10931,8939,9117,6215,2477,37679,2263,30986
4100,경기도,의왕시가선거구,6412401,4124,의왕시,거소투표,,101,94,29,14,27,9,10,89,5,7
4100,경기도,의왕시가선거구,6412401,4124,의왕시,관외사전투표,,3973,3971,1281,813,1063,420,179,3756,215,2
4100,경기도,의왕시가선거구,6412401,4124,의왕시,고천동,계,12187,6959,1744,1460,1475,1351,569,6599,360,5228
4100,경기도,의왕시가선거구,6412401,4124,의왕시,고천동,관내사전투표,3108,3103,771,712,591,630,247,2951,152,5
4100,경기도,의왕시가선거구,6412401,4124,의왕시,고천동,선거일투표,9079,3856,973,748,884,721,322,3648,208,5223
4100,경기도,의왕시가선거구,6412401,4124,의왕시,부곡동,계,23767,12229,3924,1946,2945,1787,818,11420,809,11538
4100,경기도,의왕시가선거구,6412401,4124,의왕시,부곡동,관내사전투표,3990,3985,1246,720,963,555,241,3725,260,5
4100,경기도,의왕시가선거구,6412401,4124,의왕시,부곡동,선거일투표,19777,8244,2678,1226,1982,1232,577,7695,549,11533
4100,경기도,의왕시가선거구,6412401,4124,의왕시,오전동,계,30900,16647,3939,4699,3602,2640,900,15780,867,14253
4100,경기도,의왕시가선거구,6412401,4124,의왕시,오전동,관내사전투표,4295,4264,1022,1217,821,751,251,4062,202,31
4100,경기도,의왕시가선거구,6412401,4124,의왕시,오전동,선거일투표,26605,12383,2917,3482,2781,1889,649,11718,665,14222
4100,경기도,의왕시가선거구,6412401,4124,의왕시,잘못 투입·구분된 투표지,,0,42,14,7,5,8,1,35,7,-42
4100,경기도,의왕시나선거구,6412402,4124,의왕시,합계,,68000,40597,11626,6646,10134,9091,619,38116,2481,27403
4100,경기도,의왕시나선거구,6412402,4124,의왕시,거소투표,,63,62,19,11,14,12,0,56,6,1
4100,경기도,의왕시나선거구,6412402,4124,의왕시,관외사전투표,,4814,4809,1586,823,1157,888,94,4548,261,5
4100,경기도,의왕시나선거구,6412402,4124,의왕시,내손1동,계,16368,9134,2603,1453,2417,2040,123,8636,498,7234
4100,경기도,의왕시나선거구,6412402,4124,의왕시,내손1동,관내사전투표,2677,2667,777,460,700,540,36,2513,154,10
4100,경기도,의왕시나선거구,6412402,4124,의왕시,내손1동,선거일투표,13691,6467,1826,993,1717,1500,87,6123,344,7224
4100,경기도,의왕시나선거구,6412402,4124,의왕시,내손2동,계,17564,10089,2862,1804,2494,2158,158,9476,613,7475
4100,경기도,의왕시나선거구,6412402,4124,의왕시,내손2동,관내사전투표,3313,3311,918,643,833,690,44,3128,183,2
4100,경기도,의왕시나선거구,6412402,4124,의왕시,내손2동,선거일투표,14251,6778,1944,1161,1661,1468,114,6348,430,7473
4100,경기도,의왕시나선거구,6412402,4124,의왕시,청계동,계,29191,16477,4548,2549,4048,3990,244,15379,1098,12714
4100,경기도,의왕시나선거구,6412402,4124,의왕시,청계동,관내사전투표,4037,4034,1158,644,960,930,44,3736,298,3
4100,경기도,의왕시나선거구,6412402,4124,의왕시,청계동,선거일투표,25154,12443,3390,1905,3088,3060,200,11643,800,12711
4100,경기도,의왕시나선거구,6412402,4124,의왕시,잘못 투입·구분된 투표지,,0,26,8,6,4,3,0,21,5,-26
4100,경기도,구리시가선거구,6412501,4125,구리시,합계,,90340,48517,10457,5559,8256,13210,5050,2128,750,45410,3107,41823
4100,경기도,구리시가선거구,6412501,4125,구리시,거소투표,,104,99,30,7,13,26,7,7,4,94,5,5
4100,경기도,구리시가선거구,6412501,4125,구리시,관외사전투표,,4480,4476,1243,512,610,1268,325,142,79,4179,297,4
4100,경기도,구리시가선거구,6412501,4125,구리시,갈매동,계,22849,11689,2479,1124,1878,4262,856,310,117,11026,663,11160
4100,경기도,구리시가선거구,6412501,4125,구리시,갈매동,관내사전투표,4003,4000,907,398,680,1312,319,102,25,3743,257,3
4100,경기도,구리시가선거구,6412501,4125,구리시,갈매동,선거일투표,18846,7689,1572,726,1198,2950,537,208,92,7283,406,11157
4100,경기도,구리시가선거구,6412501,4125,구리시,동구동,계,30045,16549,3222,2048,3340,3793,1918,914,325,15560,989,13496
4100,경기도,구리시가선거구,6412501,4125,구리시,동구동,관내사전투표,3677,3676,765,476,763,775,400,193,61,3433,243,1
4100,경기도,구리시가선거구,6412501,4125,구리시,동구동,선거일투표,26368,12873,2457,1572,2577,3018,1518,721,264,12127,746,13495
4100,경기도,구리시가선거구,6412501,4125,구리시,인창동,계,18864,9664,2096,1172,1689,2185,1213,497,147,8999,665,9200
4100,경기도,구리시가선거구,6412501,4125,구리시,인창동,관내사전투표,2969,2965,682,403,557,604,331,137,39,2753,212,4
4100,경기도,구리시가선거구,6412501,4125,구리시,인창동,선거일투표,15895,6699,1414,769,1132,1581,882,360,108,6246,453,9196
4100,경기도,구리시가선거구,6412501,4125,구리시,교문1동,계,13998,6028,1382,695,725,1674,730,256,78,5540,488,7970
4100,경기도,구리시가선거구,6412501,4125,구리시,교문1동,관내사전투표,1531,1529,324,201,227,389,198,63,12,1414,115,2
4100,경기도,구리시가선거구,6412501,4125,구리시,교문1동,선거일투표,12467,4499,1058,494,498,1285,532,193,66,4126,373,7968
4100,경기도,구리시가선거구,6412501,4125,구리시,잘못 투입·구분된 투표지,,0,12,5,1,1,2,1,2,0,12,0,-12
4100,경기도,구리시나선거구,6412502,4125,구리시,합계,,73705,39641,12269,6512,11954,4981,35716,3925,34064
4100,경기도,구리시나선거구,6412502,4125,구리시,거소투표,,99,87,32,13,26,6,77,10,12
4100,경기도,구리시나선거구,6412502,4125,구리시,관외사전투표,,3570,3520,1199,592,1120,323,3234,286,50
4100,경기도,구리시나선거구,6412502,4125,구리시,교문2동,계,16502,9425,2802,1468,3067,1126,8463,962,7077
4100,경기도,구리시나선거구,6412502,4125,구리시,교문2동,관내사전투표,2367,2364,698,415,726,287,2126,238,3
4100,경기도,구리시나선거구,6412502,4125,구리시,교문2동,선거일투표,14135,7061,2104,1053,2341,839,6337,724,7074
4100,경기도,구리시나선거구,6412502,4125,구리시,수택1동,계,13828,6520,1978,1080,1827,917,5802,718,7308
4100,경기도,구리시나선거구,6412502,4125,구리시,수택1동,관내사전투표,2280,2280,694,447,629,318,2088,192,0
4100,경기도,구리시나선거구,6412502,4125,구리시,수택1동,선거일투표,11548,4240,1284,633,1198,599,3714,526,7308
4100,경기도,구리시나선거구,6412502,4125,구리시,수택2동,계,21133,9829,3013,1635,2746,1337,8731,1098,11304
4100,경기도,구리시나선거구,6412502,4125,구리시,수택2동,관내사전투표,2643,2643,840,444,756,345,2385,258,0
4100,경기도,구리시나선거구,6412502,4125,구리시,수택2동,선거일투표,18490,7186,2173,1191,1990,992,6346,840,11304
4100,경기도,구리시나선거구,6412502,4125,구리시,수택3동,계,18573,10192,3226,1715,3146,1261,9348,844,8381
4100,경기도,구리시나선거구,6412502,4125,구리시,수택3동,관내사전투표,3802,3797,1222,704,1129,434,3489,308,5
4100,경기도,구리시나선거구,6412502,4125,구리시,수택3동,선거일투표,14771,6395,2004,1011,2017,827,5859,536,8376
4100,경기도,구리시나선거구,6412502,4125,구리시,잘못 투입·구분된 투표지,,0,68,19,9,22,11,61,7,-68
4100,경기도,남양주시가선거구,6412601,4126,남양주시,합계,,106863,46915,14135,7227,13504,7647,958,43471,3444,59948
4100,경기도,남양주시가선거구,6412601,4126,남양주시,거소투표,,179,166,43,30,30,20,12,135,31,13
4100,경기도,남양주시가선거구,6412601,4126,남양주시,관외사전투표,,4843,4835,1600,733,1519,549,119,4520,315,8
4100,경기도,남양주시가선거구,6412601,4126,남양주시,화도읍,계,93720,37597,11328,5965,10670,6237,754,34954,2643,56123
4100,경기도,남양주시가선거구,6412601,4126,남양주시,화도읍,관내사전투표,8954,8941,2941,1550,2395,1427,149,8462,479,13
4100,경기도,남양주시가선거구,6412601,4126,남양주시,화도읍,선거일투표,84766,28656,8387,4415,8275,4810,605,26492,2164,56110
4100,경기도,남양주시가선거구,6412601,4126,남양주시,수동면,계,8121,4284,1152,496,1276,834,72,3830,454,3837
4100,경기도,남양주시가선거구,6412601,4126,남양주시,수동면,관내사전투표,2091,2090,608,261,570,372,29,1840,250,1
4100,경기도,남양주시가선거구,6412601,4126,남양주시,수동면,선거일투표,6030,2194,544,235,706,462,43,1990,204,3836
4100,경기도,남양주시가선거구,6412601,4126,남양주시,잘못 투입·구분된 투표지,,0,33,12,3,9,7,1,32,1,-33
4100,경기도,남양주시나선거구,6412602,4126,남양주시,합계,,75314,37696,18812,16287,1141,36240,1456,37618
4100,경기도,남양주시나선거구,6412602,4126,남양주시,거소투표,,107,103,37,50,8,95,8,4
4100,경기도,남양주시나선거구,6412602,4126,남양주시,관외사전투표,,3561,3561,1801,1553,134,3488,73,0
4100,경기도,남양주시나선거구,6412602,4126,남양주시,호평동,계,43522,20457,10101,9071,425,19597,860,23065
4100,경기도,남양주시나선거구,6412602,4126,남양주시,호평동,관내사전투표,6149,6146,3149,2741,118,6008,138,3
4100,경기도,남양주시나선거구,6412602,4126,남양주시,호평동,선거일투표,37373,14311,6952,6330,307,13589,722,23062
4100,경기도,남양주시나선거구,6412602,4126,남양주시,평내동,계,28124,13542,6862,5599,574,13035,507,14582
4100,경기도,남양주시나선거구,6412602,4126,남양주시,평내동,관내사전투표,3726,3722,1949,1502,185,3636,86,4
4100,경기도,남양주시나선거구,6412602,4126,남양주시,평내동,선거일투표,24398,9820,4913,4097,389,9399,421,14578
4100,경기도,남양주시나선거구,6412602,4126,남양주시,잘못 투입·구분된 투표지,,0,33,11,14,0,25,8,-33
4100,경기도,남양주시다선거구,6412603,4126,남양주시,검색된 결과가 없습니다.
4100,경기도,남양주시라선거구,6412604,4126,남양주시,합계,,44613,19658,8116,7624,2904,18644,1014,24955
4100,경기도,남양주시라선거구,6412604,4126,남양주시,거소투표,,76,73,29,33,5,67,6,3
4100,경기도,남양주시라선거구,6412604,4126,남양주시,관외사전투표,,1979,1978,937,750,237,1924,54,1
4100,경기도,남양주시라선거구,6412604,4126,남양주시,오남읍,계,42558,17579,7142,6830,2660,16632,947,24979
4100,경기도,남양주시라선거구,6412604,4126,남양주시,오남읍,관내사전투표,5351,5349,2375,2120,794,5289,60,2
4100,경기도,남양주시라선거구,6412604,4126,남양주시,오남읍,선거일투표,37207,12230,4767,4710,1866,11343,887,24977
4100,경기도,남양주시라선거구,6412604,4126,남양주시,잘못 투입·구분된 투표지,,0,28,8,11,2,21,7,-28
4100,경기도,남양주시마선거구,6412605,4126,남양주시,합계,,82073,41159,18696,15458,4278,667,39099,2060,40914
4100,경기도,남양주시마선거구,6412605,4126,남양주시,거소투표,,97,95,37,40,7,2,86,9,2
4100,경기도,남양주시마선거구,6412605,4126,남양주시,관외사전투표,,4267,4265,2190,1587,288,85,4150,115,2
4100,경기도,남양주시마선거구,6412605,4126,남양주시,별내면,계,16228,8167,3624,2482,1475,92,7673,494,8061
4100,경기도,남양주시마선거구,6412605,4126,남양주시,별내면,관내사전투표,2661,2660,1268,783,510,28,2589,71,1
4100,경기도,남양주시마선거구,6412605,4126,남양주시,별내면,선거일투표,13567,5507,2356,1699,965,64,5084,423,8060
4100,경기도,남양주시마선거구,6412605,4126,남양주시,별내동,계,61481,28584,12834,11330,2508,487,27159,1425,32897
4100,경기도,남양주시마선거구,6412605,4126,남양주시,별내동,관내사전투표,7126,7118,3375,2793,630,83,6881,237,8
4100,경기도,남양주시마선거구,6412605,4126,남양주시,별내동,선거일투표,54355,21466,9459,8537,1878,404,20278,1188,32889
4100,경기도,남양주시마선거구,6412605,4126,남양주시,잘못 투입·구분된 투표지,,0,48,11,19,0,1,31,17,-48
4100,경기도,남양주시바선거구,6412606,4126,남양주시,합계,,105023,55755,14726,11482,16259,6702,3388,52557,3198,49268
4100,경기도,남양주시바선거구,6412606,4126,남양주시,거소투표,,91,87,19,14,31,11,6,81,6,4
4100,경기도,남양주시바선거구,6412606,4126,남양주시,관외사전투표,,6040,6034,1700,1221,1839,616,282,5658,376,6
4100,경기도,남양주시바선거구,6412606,4126,남양주시,양정동,계,3497,1721,412,186,718,226,47,1589,132,1776
4100,경기도,남양주시바선거구,6412606,4126,남양주시,양정동,관내사전투표,724,724,177,95,297,93,22,684,40,0
4100,경기도,남양주시바선거구,6412606,4126,남양주시,양정동,선거일투표,2773,997,235,91,421,133,25,905,92,1776
4100,경기도,남양주시바선거구,6412606,4126,남양주시,다산1동,계,68745,33965,8637,7373,9549,4228,2265,32052,1913,34780
4100,경기도,남양주시바선거구,6412606,4126,남양주시,다산1동,관내사전투표,7004,6991,1931,1504,1939,863,392,6629,362,13
4100,경기도,남양주시바선거구,6412606,4126,남양주시,다산1동,선거일투표,61741,26974,6706,5869,7610,3365,1873,25423,1551,34767
4100,경기도,남양주시바선거구,6412606,4126,남양주시,다산2동,계,26650,13907,3947,2683,4111,1615,784,13140,767,12743
4100,경기도,남양주시바선거구,6412606,4126,남양주시,다산2동,관내사전투표,4010,4003,1121,805,1184,462,194,3766,237,7
4100,경기도,남양주시바선거구,6412606,4126,남양주시,다산2동,선거일투표,22640,9904,2826,1878,2927,1153,590,9374,530,12736
4100,경기도,남양주시바선거구,6412606,4126,남양주시,잘못 투입·구분된 투표지,,0,41,11,5,11,6,4,37,4,-41
4100,경기도,남양주시사선거구,6412607,4126,남양주시,합계,,117132,63098,14609,5497,4019,2890,13869,9138,5083,268,917,1880,58170,4928,54034
4100,경기도,남양주시사선거구,6412607,4126,남양주시,거소투표,,149,137,21,6,17,7,34,19,10,3,3,3,123,14,12
4100,경기도,남양주시사선거구,6412607,4126,남양주시,관외사전투표,,5719,5711,1571,576,325,237,1468,593,290,18,68,103,5249,462,8
4100,경기도,남양주시사선거구,6412607,4126,남양주시,와부읍,계,47997,26633,6055,2793,906,1179,4806,6061,885,110,394,1637,24826,1807,21364
4100,경기도,남양주시사선거구,6412607,4126,남양주시,와부읍,관내사전투표,6426,6426,1585,780,242,293,1055,1514,199,10,110,299,6087,339,0
4100,경기도,남양주시사선거구,6412607,4126,남양주시,와부읍,선거일투표,41571,20207,4470,2013,664,886,3751,4547,686,100,284,1338,18739,1468,21364
4100,경기도,남양주시사선거구,6412607,4126,남양주시,진건읍,계,19801,9253,2138,604,635,242,2484,454,1785,29,108,38,8517,736,10548
4100,경기도,남양주시사선거구,6412607,4126,남양주시,진건읍,관내사전투표,2936,2935,730,209,258,92,777,108,541,2,22,14,2753,182,1
4100,경기도,남양주시사선거구,6412607,4126,남양주시,진건읍,선거일투표,16865,6318,1408,395,377,150,1707,346,1244,27,86,24,5764,554,10547
4100,경기도,남양주시사선거구,6412607,4126,남양주시,퇴계원읍,계,24116,11988,2772,797,1842,338,2900,735,1294,48,149,50,10925,1063,12128
4100,경기도,남양주시사선거구,6412607,4126,남양주시,퇴계원읍,관내사전투표,3822,3822,889,217,595,86,940,221,409,7,50,17,3431,391,0
4100,경기도,남양주시사선거구,6412607,4126,남양주시,퇴계원읍,선거일투표,20294,8166,1883,580,1247,252,1960,514,885,41,99,33,7494,672,12128
4100,경기도,남양주시사선거구,6412607,4126,남양주시,조안면,계,3309,1825,434,159,43,80,387,436,76,22,21,18,1676,149,1484
4100,경기도,남양주시사선거구,6412607,4126,남양주시,조안면,관내사전투표,634,634,170,45,14,26,125,146,27,7,11,8,579,55,0
4100,경기도,남양주시사선거구,6412607,4126,남양주시,조안면,선거일투표,2675,1191,264,114,29,54,262,290,49,15,10,10,1097,94,1484
4100,경기도,남양주시사선거구,6412607,4126,남양주시,금곡동,계,16041,7537,1611,561,251,806,1786,840,743,38,174,31,6841,696,8504
4100,경기도,남양주시사선거구,6412607,4126,남양주시,금곡동,관내사전투표,2014,2014,454,140,82,195,466,252,187,7,44,10,1837,177,0
4100,경기도,남양주시사선거구,6412607,4126,남양주시,금곡동,선거일투표,14027,5523,1157,421,169,611,1320,588,556,31,130,21,5004,519,8504
4100,경기도,남양주시사선거구,6412607,4126,남양주시,잘못 투입·구분된 투표지,,0,14,7,1,0,1,4,0,0,0,0,0,13,1,-14
4100,경기도,오산시가선거구,6412701,4127,오산시,합계,,103264,48098,18345,6344,15306,3793,43788,4310,55166
4100,경기도,오산시가선거구,6412701,4127,오산시,거소투표,,101,98,36,15,30,5,86,12,3
4100,경기도,오산시가선거구,6412701,4127,오산시,관외사전투표,,4793,4790,1872,593,1585,339,4389,401,3
4100,경기도,오산시가선거구,6412701,4127,오산시,중앙동,계,28093,13001,4947,1446,4149,1249,11791,1210,15092
4100,경기도,오산시가선거구,6412701,4127,오산시,중앙동,관내사전투표,4150,4143,1478,520,1357,423,3778,365,7
4100,경기도,오산시가선거구,6412701,4127,오산시,중앙동,선거일투표,23943,8858,3469,926,2792,826,8013,845,15085
4100,경기도,오산시가선거구,6412701,4127,오산시,신장동,계,45667,18826,7161,2833,5743,1463,17200,1626,26841
4100,경기도,오산시가선거구,6412701,4127,오산시,신장동,관내사전투표,4004,4001,1602,657,1106,279,3644,357,3
4100,경기도,오산시가선거구,6412701,4127,오산시,신장동,선거일투표,41663,14825,5559,2176,4637,1184,13556,1269,26838
4100,경기도,오산시가선거구,6412701,4127,오산시,세마동,계,24610,11363,4324,1456,3793,734,10307,1056,13247
4100,경기도,오산시가선거구,6412701,4127,오산시,세마동,관내사전투표,3201,3196,1099,469,1140,198,2906,290,5
4100,경기도,오산시가선거구,6412701,4127,오산시,세마동,선거일투표,21409,8167,3225,987,2653,536,7401,766,13242
4100,경기도,오산시가선거구,6412701,4127,오산시,잘못 투입·구분된 투표지,,0,20,5,1,6,3,15,5,-20
4100,경기도,오산시나선거구,6412702,4127,오산시,합계,,87111,35062,10055,6953,8244,6441,1200,32893,2169,52049
4100,경기도,오산시나선거구,6412702,4127,오산시,거소투표,,107,103,42,17,20,14,2,95,8,4
4100,경기도,오산시나선거구,6412702,4127,오산시,관외사전투표,,3732,3727,1226,679,844,655,118,3522,205,5
4100,경기도,오산시나선거구,6412702,4127,오산시,대원동,계,51044,20775,5915,4082,4747,3916,845,19505,1270,30269
4100,경기도,오산시나선거구,6412702,4127,오산시,대원동,관내사전투표,5054,5036,1469,1055,1125,928,178,4755,281,18
4100,경기도,오산시나선거구,6412702,4127,오산시,대원동,선거일투표,45990,15739,4446,3027,3622,2988,667,14750,989,30251
4100,경기도,오산시나선거구,6412702,4127,오산시,남촌동,계,18836,4881,1409,814,1357,863,111,4554,327,13955
4100,경기도,오산시나선거구,6412702,4127,오산시,남촌동,관내사전투표,1368,1368,436,263,345,206,22,1272,96,0
4100,경기도,오산시나선거구,6412702,4127,오산시,남촌동,선거일투표,17468,3513,973,551,1012,657,89,3282,231,13955
4100,경기도,오산시나선거구,6412702,4127,오산시,초평동,계,13392,5567,1461,1358,1272,993,124,5208,359,7825
4100,경기도,오산시나선거구,6412702,4127,오산시,초평동,관내사전투표,2207,2205,587,525,502,382,45,2041,164,2
4100,경기도,오산시나선거구,6412702,4127,오산시,초평동,선거일투표,11185,3362,874,833,770,611,79,3167,195,7823
4100,경기도,오산시나선거구,6412702,4127,오산시,잘못 투입·구분된 투표지,,0,9,2,3,4,0,0,9,0,-9
4100,경기도,화성시가선거구,6412801,4128,화성시,합계,,100088,42066,12936,6437,12259,7031,535,39198,2868,58022
4100,경기도,화성시가선거구,6412801,4128,화성시,거소투표,,103,100,32,14,26,16,3,91,9,3
4100,경기도,화성시가선거구,6412801,4128,화성시,관외사전투표,,6064,6050,1817,899,1861,917,138,5632,418,14
4100,경기도,화성시가선거구,6412801,4128,화성시,봉담읍,계,5332,2263,608,256,858,340,23,2085,178,3069
4100,경기도,화성시가선거구,6412801,4128,화성시,봉담읍,관내사전투표,514,512,146,70,173,71,4,464,48,2
4100,경기도,화성시가선거구,6412801,4128,화성시,봉담읍,선거일투표,4818,1751,462,186,685,269,19,1621,130,3067
4100,경기도,화성시가선거구,6412801,4128,화성시,향남읍,계,66471,24465,8119,4316,6112,4150,277,22974,1491,42006
4100,경기도,화성시가선거구,6412801,4128,화성시,향남읍,관내사전투표,6129,6120,2166,1201,1404,940,58,5769,351,9
4100,경기도,화성시가선거구,6412801,4128,화성시,향남읍,선거일투표,60342,18345,5953,3115,4708,3210,219,17205,1140,41997
4100,경기도,화성시가선거구,6412801,4128,화성시,팔탄면,계,8843,3576,994,352,1329,585,36,3296,280,5267
4100,경기도,화성시가선거구,6412801,4128,화성시,팔탄면,관내사전투표,1355,1355,395,153,508,194,14,1264,91,0
4100,경기도,화성시가선거구,6412801,4128,화성시,팔탄면,선거일투표,7488,2221,599,199,821,391,22,2032,189,5267
4100,경기도,화성시가선거구,6412801,4128,화성시,양감면,계,3560,1574,376,156,585,323,18,1458,116,1986
4100,경기도,화성시가선거구,6412801,4128,화성시,양감면,관내사전투표,499,497,122,64,188,82,8,464,33,2
4100,경기도,화성시가선거구,6412801,4128,화성시,양감면,선거일투표,3061,1077,254,92,397,241,10,994,83,1984
4100,경기도,화성시가선거구,6412801,4128,화성시,정남면,계,9715,4005,983,437,1474,697,40,3631,374,5710
4100,경기도,화성시가선거구,6412801,4128,화성시,정남면,관내사전투표,1162,1162,269,140,413,223,13,1058,104,0
4100,경기도,화성시가선거구,6412801,4128,화성시,정남면,선거일투표,8553,2843,714,297,1061,474,27,2573,270,5710
4100,경기도,화성시가선거구,6412801,4128,화성시,잘못 투입·구분된 투표지,,0,33,7,7,14,3,0,31,2,-33
4100,경기도,화성시나선거구,6412802,4128,화성시,합계,,116730,53875,16001,5412,13363,5245,6334,3829,50184,3691,62855
4100,경기도,화성시나선거구,6412802,4128,화성시,거소투표,,112,106,30,17,22,12,9,4,94,12,6
4100,경기도,화성시나선거구,6412802,4128,화성시,관외사전투표,,6042,6016,1843,646,1735,708,415,250,5597,419,26
4100,경기도,화성시나선거구,6412802,4128,화성시,우정읍,계,14946,6797,1467,649,2108,343,150,1614,6331,466,8149
4100,경기도,화성시나선거구,6412802,4128,화성시,우정읍,관내사전투표,2680,2670,636,270,831,135,47,586,2505,165,10
4100,경기도,화성시나선거구,6412802,4128,화성시,우정읍,선거일투표,12266,4127,831,379,1277,208,103,1028,3826,301,8139
4100,경기도,화성시나선거구,6412802,4128,화성시,남양읍,계,34591,13783,4682,1266,2285,1459,2647,482,12821,962,20808
4100,경기도,화성시나선거구,6412802,4128,화성시,남양읍,관내사전투표,4955,4941,1717,467,831,487,989,171,4662,279,14
4100,경기도,화성시나선거구,6412802,4128,화성시,남양읍,선거일투표,29636,8842,2965,799,1454,972,1658,311,8159,683,20794
4100,경기도,화성시나선거구,6412802,4128,화성시,매송면,계,6017,2885,820,290,830,262,395,74,2671,214,3132
4100,경기도,화성시나선거구,6412802,4128,화성시,매송면,관내사전투표,939,925,257,102,266,76,125,23,849,76,14
4100,경기도,화성시나선거구,6412802,4128,화성시,매송면,선거일투표,5078,1960,563,188,564,186,270,51,1822,138,3118
4100,경기도,화성시나선거구,6412802,4128,화성시,비봉면,계,5867,2812,683,260,775,291,375,106,2490,322,3055
4100,경기도,화성시나선거구,6412802,4128,화성시,비봉면,관내사전투표,1110,1105,315,118,304,113,130,32,1012,93,5
4100,경기도,화성시나선거구,6412802,4128,화성시,비봉면,선거일투표,4757,1707,368,142,471,178,245,74,1478,229,3050
4100,경기도,화성시나선거구,6412802,4128,화성시,마도면,계,6490,2827,761,269,712,266,502,107,2617,210,3663
4100,경기도,화성시나선거구,6412802,4128,화성시,마도면,관내사전투표,1243,1240,363,125,294,105,221,43,1151,89,3
4100,경기도,화성시나선거구,6412802,4128,화성시,마도면,선거일투표,5247,1587,398,144,418,161,281,64,1466,121,3660
4100,경기도,화성시나선거구,6412802,4128,화성시,송산면,계,9681,4147,1024,381,1287,488,526,132,3838,309,5534
4100,경기도,화성시나선거구,6412802,4128,화성시,송산면,관내사전투표,1723,1687,452,161,469,190,226,53,1551,136,36
4100,경기도,화성시나선거구,6412802,4128,화성시,송산면,선거일투표,7958,2460,572,220,818,298,300,79,2287,173,5498
4100,경기도,화성시나선거구,6412802,4128,화성시,서신면,계,6518,2910,717,275,873,274,411,152,2702,208,3608
4100,경기도,화성시나선거구,6412802,4128,화성시,서신면,관내사전투표,1123,1118,305,114,305,106,158,53,1041,77,5
4100,경기도,화성시나선거구,6412802,4128,화성시,서신면,선거일투표,5395,1792,412,161,568,168,253,99,1661,131,3603
4100,경기도,화성시나선거구,6412802,4128,화성시,장안면,계,8764,3495,671,513,1200,213,79,552,3228,267,5269
4100,경기도,화성시나선거구,6412802,4128,화성시,장안면,관내사전투표,1044,1029,225,162,321,55,22,164,949,80,15
4100,경기도,화성시나선거구,6412802,4128,화성시,장안면,선거일투표,7720,2466,446,351,879,158,57,388,2279,187,5254
4100,경기도,화성시나선거구,6412802,4128,화성시,새솔동,계,17702,7942,3265,832,1486,917,806,350,7656,286,9760
4100,경기도,화성시나선거구,6412802,4128,화성시,새솔동,관내사전투표,2589,2583,1061,293,469,245,323,113,2504,79,6
4100,경기도,화성시나선거구,6412802,4128,화성시,새솔동,선거일투표,15113,5359,2204,539,1017,672,483,237,5152,207,9754
4100,경기도,화성시나선거구,6412802,4128,화성시,잘못 투입·구분된 투표지,,0,155,38,14,50,12,19,6,139,16,-155
4100,경기도,화성시다선거구,6412803,4128,화성시,검색된 결과가 없습니다.
4100,경기도,화성시라선거구,6412804,4128,화성시,합계,,103757,52779,17006,10113,15924,5964,812,49819,2960,50978
4100,경기도,화성시라선거구,6412804,4128,화성시,거소투표,,81,78,17,13,19,21,1,71,7,3
4100,경기도,화성시라선거구,6412804,4128,화성시,관외사전투표,,5783,5763,1856,950,1914,601,100,5421,342,20
4100,경기도,화성시라선거구,6412804,4128,화성시,동탄4동,계,35257,19387,6105,4098,5621,2194,242,18260,1127,15870
4100,경기도,화성시라선거구,6412804,4128,화성시,동탄4동,관내사전투표,5521,5514,1743,1163,1660,546,52,5164,350,7
4100,경기도,화성시라선거구,6412804,4128,화성시,동탄4동,선거일투표,29736,13873,4362,2935,3961,1648,190,13096,777,15863
4100,경기도,화성시라선거구,6412804,4128,화성시,동탄5동,계,33968,15583,5219,2839,4523,1808,294,14683,900,18385
4100,경기도,화성시라선거구,6412804,4128,화성시,동탄5동,관내사전투표,4239,4229,1437,850,1194,457,60,3998,231,10
4100,경기도,화성시라선거구,6412804,4128,화성시,동탄5동,선거일투표,29729,11354,3782,1989,3329,1351,234,10685,669,18375
4100,경기도,화성시라선거구,6412804,4128,화성시,동탄6동,계,28668,11912,3791,2202,3826,1337,174,11330,582,16756
4100,경기도,화성시라선거구,6412804,4128,화성시,동탄6동,관내사전투표,3195,3185,1008,686,1008,329,46,3077,108,10
4100,경기도,화성시라선거구,6412804,4128,화성시,동탄6동,선거일투표,25473,8727,2783,1516,2818,1008,128,8253,474,16746
4100,경기도,화성시라선거구,6412804,4128,화성시,잘못 투입·구분된 투표지,,0,56,18,11,21,3,1,54,2,-56
4100,경기도,화성시마선거구,6412805,4128,화성시,합계,,88026,43090,14414,9738,11748,3446,39346,3744,44936
4100,경기도,화성시마선거구,6412805,4128,화성시,거소투표,,72,69,25,17,11,4,57,12,3
4100,경기도,화성시마선거구,6412805,4128,화성시,관외사전투표,,5454,5440,1867,1008,1696,383,4954,486,14
4100,경기도,화성시마선거구,6412805,4128,화성시,동탄7동,계,59425,26738,8763,6159,7322,2198,24442,2296,32687
4100,경기도,화성시마선거구,6412805,4128,화성시,동탄7동,관내사전투표,6453,6437,2031,1585,1743,507,5866,571,16
4100,경기도,화성시마선거구,6412805,4128,화성시,동탄7동,선거일투표,52972,20301,6732,4574,5579,1691,18576,1725,32671
4100,경기도,화성시마선거구,6412805,4128,화성시,동탄8동,계,23075,10773,3739,2543,2694,858,9834,939,12302
4100,경기도,화성시마선거구,6412805,4128,화성시,동탄8동,관내사전투표,3325,3316,1093,854,795,220,2962,354,9
4100,경기도,화성시마선거구,6412805,4128,화성시,동탄8동,선거일투표,19750,7457,2646,1689,1899,638,6872,585,12293
4100,경기도,화성시마선거구,6412805,4128,화성시,잘못 투입·구분된 투표지,,0,70,20,11,25,3,59,11,-70
4100,경기도,화성시바선거구,6412806,4128,화성시,합계,,94759,43675,14571,8064,11616,5177,1668,41096,2579,51084
4100,경기도,화성시바선거구,6412806,4128,화성시,거소투표,,96,93,23,22,22,12,7,86,7,3
4100,경기도,화성시바선거구,6412806,4128,화성시,관외사전투표,,5009,4998,1772,855,1399,463,176,4665,333,11
4100,경기도,화성시바선거구,6412806,4128,화성시,봉담읍,계,59946,25666,8795,4480,6237,3486,1150,24148,1518,34280
4100,경기도,화성시바선거구,6412806,4128,화성시,봉담읍,관내사전투표,6930,6925,2428,1258,1615,979,227,6507,418,5
4100,경기도,화성시바선거구,6412806,4128,화성시,봉담읍,선거일투표,53016,18741,6367,3222,4622,2507,923,17641,1100,34275
4100,경기도,화성시바선거구,6412806,4128,화성시,기배동,계,10900,4870,1698,823,1317,565,219,4622,248,6030
4100,경기도,화성시바선거구,6412806,4128,화성시,기배동,관내사전투표,1712,1710,602,297,453,191,75,1618,92,2
4100,경기도,화성시바선거구,6412806,4128,화성시,기배동,선거일투표,9188,3160,1096,526,864,374,144,3004,156,6028
4100,경기도,화성시바선거구,6412806,4128,화성시,화산동,계,18808,8013,2274,1880,2633,645,113,7545,468,10795
4100,경기도,화성시바선거구,6412806,4128,화성시,화산동,관내사전투표,2967,2963,806,773,952,203,36,2770,193,4
4100,경기도,화성시바선거구,6412806,4128,화성시,화산동,선거일투표,15841,5050,1468,1107,1681,442,77,4775,275,10791
4100,경기도,화성시바선거구,6412806,4128,화성시,잘못 투입·구분된 투표지,,0,35,9,4,8,6,3,30,5,-35
4100,경기도,화성시사선거구,6412807,4128,화성시,합계,,85587,38753,13309,6307,8240,7454,35310,3443,46834
4100,경기도,화성시사선거구,6412807,4128,화성시,거소투표,,92,87,29,13,13,21,76,11,5
4100,경기도,화성시사선거구,6412807,4128,화성시,관외사전투표,,4596,4580,1712,669,1066,724,4171,409,16
4100,경기도,화성시사선거구,6412807,4128,화성시,진안동,계,33997,12699,4413,1816,2845,2526,11600,1099,21298
4100,경기도,화성시사선거구,6412807,4128,화성시,진안동,관내사전투표,2578,2568,848,377,624,501,2350,218,10
4100,경기도,화성시사선거구,6412807,4128,화성시,진안동,선거일투표,31419,10131,3565,1439,2221,2025,9250,881,21288
4100,경기도,화성시사선거구,6412807,4128,화성시,병점1동,계,28771,12800,4219,2128,2678,2613,11638,1162,15971
4100,경기도,화성시사선거구,6412807,4128,화성시,병점1동,관내사전투표,4060,4050,1311,745,818,800,3674,376,10
4100,경기도,화성시사선거구,6412807,4128,화성시,병점1동,선거일투표,24711,8750,2908,1383,1860,1813,7964,786,15961
4100,경기도,화성시사선거구,6412807,4128,화성시,병점2동,계,18131,8531,2917,1671,1630,1560,7778,753,9600
4100,경기도,화성시사선거구,6412807,4128,화성시,병점2동,관내사전투표,3108,3104,1065,662,580,566,2873,231,4
4100,경기도,화성시사선거구,6412807,4128,화성시,병점2동,선거일투표,15023,5427,1852,1009,1050,994,4905,522,9596
4100,경기도,화성시사선거구,6412807,4128,화성시,잘못 투입·구분된 투표지,,0,56,19,10,8,10,47,9,-56
4100,경기도,화성시아선거구,6412808,4128,화성시,검색된 결과가 없습니다.
4100,경기도,시흥시가선거구,6412901,4129,시흥시,합계,,115271,56342,18124,9575,15577,6877,2515,52668,3674,58929
4100,경기도,시흥시가선거구,6412901,4129,시흥시,거소투표,,124,120,30,26,38,9,5,108,12,4
4100,경기도,시흥시가선거구,6412901,4129,시흥시,관외사전투표,,5196,5195,1769,980,1393,522,210,4874,321,1
4100,경기도,시흥시가선거구,6412901,4129,시흥시,대야동,계,37027,17884,5610,2746,5223,2308,764,16651,1233,19143
4100,경기도,시흥시가선거구,6412901,4129,시흥시,대야동,관내사전투표,4883,4869,1692,658,1335,598,198,4481,388,14
4100,경기도,시흥시가선거구,6412901,4129,시흥시,대야동,선거일투표,32144,13015,3918,2088,3888,1710,566,12170,845,19129
4100,경기도,시흥시가선거구,6412901,4129,시흥시,신천동,계,30640,12310,3983,1799,3713,1388,558,11441,869,18330
4100,경기도,시흥시가선거구,6412901,4129,시흥시,신천동,관내사전투표,3250,3241,1107,483,931,336,132,2989,252,9
4100,경기도,시흥시가선거구,6412901,4129,시흥시,신천동,선거일투표,27390,9069,2876,1316,2782,1052,426,8452,617,18321
4100,경기도,시흥시가선거구,6412901,4129,시흥시,은행동,계,42284,20801,6720,4021,5201,2645,978,19565,1236,21483
4100,경기도,시흥시가선거구,6412901,4129,시흥시,은행동,관내사전투표,5527,5521,1908,1034,1375,657,205,5179,342,6
4100,경기도,시흥시가선거구,6412901,4129,시흥시,은행동,선거일투표,36757,15280,4812,2987,3826,1988,773,14386,894,21477
4100,경기도,시흥시가선거구,6412901,4129,시흥시,잘못 투입·구분된 투표지,,0,32,12,3,9,5,0,29,3,-32
4100,경기도,시흥시나선거구,6412902,4129,시흥시,합계,,66708,33492,16324,13339,2574,32237,1255,33216
4100,경기도,시흥시나선거구,6412902,4129,시흥시,거소투표,,82,77,36,31,4,71,6,5
4100,경기도,시흥시나선거구,6412902,4129,시흥시,관외사전투표,,3511,3508,1796,1384,238,3418,90,3
4100,경기도,시흥시나선거구,6412902,4129,시흥시,매화동,계,10167,4481,2160,1859,324,4343,138,5686
4100,경기도,시흥시나선거구,6412902,4129,시흥시,매화동,관내사전투표,1722,1715,853,665,132,1650,65,7
4100,경기도,시흥시나선거구,6412902,4129,시흥시,매화동,선거일투표,8445,2766,1307,1194,192,2693,73,5679
4100,경기도,시흥시나선거구,6412902,4129,시흥시,목감동,계,31949,15308,7705,6096,944,14745,563,16641
4100,경기도,시흥시나선거구,6412902,4129,시흥시,목감동,관내사전투표,4475,4472,2380,1726,255,4361,111,3
4100,경기도,시흥시나선거구,6412902,4129,시흥시,목감동,선거일투표,27474,10836,5325,4370,689,10384,452,16638
4100,경기도,시흥시나선거구,6412902,4129,시흥시,과림동,계,1668,903,254,514,83,851,52,765
4100,경기도,시흥시나선거구,6412902,4129,시흥시,과림동,관내사전투표,390,390,119,223,40,382,8,0
4100,경기도,시흥시나선거구,6412902,4129,시흥시,과림동,선거일투표,1278,513,135,291,43,469,44,765
4100,경기도,시흥시나선거구,6412902,4129,시흥시,능곡동,계,19331,9191,4367,3446,980,8793,398,10140
4100,경기도,시흥시나선거구,6412902,4129,시흥시,능곡동,관내사전투표,2819,2818,1448,1019,277,2744,74,1
4100,경기도,시흥시나선거구,6412902,4129,시흥시,능곡동,선거일투표,16512,6373,2919,2427,703,6049,324,10139
4100,경기도,시흥시나선거구,6412902,4129,시흥시,잘못 투입·구분된 투표지,,0,24,6,9,1,16,8,-24
4100,경기도,시흥시다선거구,6412903,4129,시흥시,검색된 결과가 없습니다.
4100,경기도,시흥시라선거구,6412904,4129,시흥시,합계,,102657,37381,14108,5418,11632,2502,33660,3721,65276
4100,경기도,시흥시라선거구,6412904,4129,시흥시,거소투표,,96,88,35,9,20,10,74,14,8
4100,경기도,시흥시라선거구,6412904,4129,시흥시,관외사전투표,,3815,3809,1414,541,1232,274,3461,348,6
4100,경기도,시흥시라선거구,6412904,4129,시흥시,군자동,계,18025,7180,2444,980,2650,358,6432,748,10845
4100,경기도,시흥시라선거구,6412904,4129,시흥시,군자동,관내사전투표,2199,2196,762,350,807,88,2007,189,3
4100,경기도,시흥시라선거구,6412904,4129,시흥시,군자동,선거일투표,15826,4984,1682,630,1843,270,4425,559,10842
4100,경기도,시흥시라선거구,6412904,4129,시흥시,정왕본동,계,19719,5306,1786,914,1654,344,4698,608,14413
4100,경기도,시흥시라선거구,6412904,4129,시흥시,정왕본동,관내사전투표,1649,1647,612,273,437,120,1442,205,2
4100,경기도,시흥시라선거구,6412904,4129,시흥시,정왕본동,선거일투표,18070,3659,1174,641,1217,224,3256,403,14411
4100,경기도,시흥시라선거구,6412904,4129,시흥시,정왕1동,계,21201,6113,2535,747,1708,471,5461,652,15088
4100,경기도,시흥시라선거구,6412904,4129,시흥시,정왕1동,관내사전투표,2032,2032,880,297,507,132,1816,216,0
4100,경기도,시흥시라선거구,6412904,4129,시흥시,정왕1동,선거일투표,19169,4081,1655,450,1201,339,3645,436,15088
4100,경기도,시흥시라선거구,6412904,4129,시흥시,정왕2동,계,26229,9312,3962,1252,2633,630,8477,835,16917
4100,경기도,시흥시라선거구,6412904,4129,시흥시,정왕2동,관내사전투표,2673,2668,1195,358,736,170,2459,209,5
4100,경기도,시흥시라선거구,6412904,4129,시흥시,정왕2동,선거일투표,23556,6644,2767,894,1897,460,6018,626,16912
4100,경기도,시흥시라선거구,6412904,4129,시흥시,월곶동,계,13572,5548,1920,974,1730,414,5038,510,8024
4100,경기도,시흥시라선거구,6412904,4129,시흥시,월곶동,관내사전투표,2113,2112,745,407,621,148,1921,191,1
4100,경기도,시흥시라선거구,6412904,4129,시흥시,월곶동,선거일투표,11459,3436,1175,567,1109,266,3117,319,8023
4100,경기도,시흥시라선거구,6412904,4129,시흥시,잘못 투입·구분된 투표지,,0,25,12,1,5,1,19,6,-25
4100,경기도,시흥시마선거구,6412905,4129,시흥시,합계,,91092,40328,14506,6693,10014,5504,36717,3611,50764
4100,경기도,시흥시마선거구,6412905,4129,시흥시,거소투표,,105,99,31,22,26,8,87,12,6
4100,경기도,시흥시마선거구,6412905,4129,시흥시,관외사전투표,,3376,3372,1291,505,1024,294,3114,258,4
4100,경기도,시흥시마선거구,6412905,4129,시흥시,정왕3동,계,19760,7488,2890,1119,2066,660,6735,753,12272
4100,경기도,시흥시마선거구,6412905,4129,시흥시,정왕3동,관내사전투표,2659,2652,1042,457,718,198,2415,237,7
4100,경기도,시흥시마선거구,6412905,4129,시흥시,정왕3동,선거일투표,17101,4836,1848,662,1348,462,4320,516,12265
4100,경기도,시흥시마선거구,6412905,4129,시흥시,정왕4동,계,16464,7454,2640,1434,1894,803,6771,683,9010
4100,경기도,시흥시마선거구,6412905,4129,시흥시,정왕4동,관내사전투표,2599,2597,951,538,633,253,2375,222,2
4100,경기도,시흥시마선거구,6412905,4129,시흥시,정왕4동,선거일투표,13865,4857,1689,896,1261,550,4396,461,9008
4100,경기도,시흥시마선거구,6412905,4129,시흥시,배곧1동,계,25129,11235,3921,1809,2487,2071,10288,947,13894
4100,경기도,시흥시마선거구,6412905,4129,시흥시,배곧1동,관내사전투표,3321,3317,1124,629,674,541,2968,349,4
4100,경기도,시흥시마선거구,6412905,4129,시흥시,배곧1동,선거일투표,21808,7918,2797,1180,1813,1530,7320,598,13890
4100,경기도,시흥시마선거구,6412905,4129,시흥시,배곧2동,계,26258,10652,3724,1796,2513,1663,9696,956,15606
4100,경기도,시흥시마선거구,6412905,4129,시흥시,배곧2동,관내사전투표,2379,2377,848,495,532,300,2175,202,2
4100,경기도,시흥시마선거구,6412905,4129,시흥시,배곧2동,선거일투표,23879,8275,2876,1301,1981,1363,7521,754,15604
4100,경기도,시흥시마선거구,6412905,4129,시흥시,잘못 투입·구분된 투표지,,0,28,9,8,4,5,26,2,-28
4100,경기도,군포시가선거구,6413001,4130,군포시,검색된 결과가 없습니다.
4100,경기도,군포시나선거구,6413002,4130,군포시,합계,,61132,34440,9768,8556,8339,4218,30881,3559,26692
4100,경기도,군포시나선거구,6413002,4130,군포시,거소투표,,63,58,9,8,17,11,45,13,5
4100,경기도,군포시나선거구,6413002,4130,군포시,관외사전투표,,3217,3217,846,907,825,312,2890,327,0
4100,경기도,군포시나선거구,6413002,4130,군포시,군포2동,계,34403,18487,5151,4479,4554,2311,16495,1992,15916
4100,경기도,군포시나선거구,6413002,4130,군포시,군포2동,관내사전투표,5238,5231,1510,1330,1220,579,4639,592,7
4100,경기도,군포시나선거구,6413002,4130,군포시,군포2동,선거일투표,29165,13256,3641,3149,3334,1732,11856,1400,15909
4100,경기도,군포시나선거구,6413002,4130,군포시,대야동,계,7957,4553,1300,1192,1102,507,4101,452,3404
4100,경기도,군포시나선거구,6413002,4130,군포시,대야동,관내사전투표,1932,1929,544,514,466,175,1699,230,3
4100,경기도,군포시나선거구,6413002,4130,군포시,대야동,선거일투표,6025,2624,756,678,636,332,2402,222,3401
4100,경기도,군포시나선거구,6413002,4130,군포시,송부동,계,15492,8098,2455,1962,1836,1074,7327,771,7394
4100,경기도,군포시나선거구,6413002,4130,군포시,송부동,관내사전투표,2192,2192,704,552,487,253,1996,196,0
4100,경기도,군포시나선거구,6413002,4130,군포시,송부동,선거일투표,13300,5906,1751,1410,1349,821,5331,575,7394
4100,경기도,군포시나선거구,6413002,4130,군포시,잘못 투입·구분된 투표지,,0,27,7,8,5,3,23,4,-27
4100,경기도,군포시다선거구,6413003,4130,군포시,합계,,59669,35955,12485,4020,12377,3130,32012,3943,23714
4100,경기도,군포시다선거구,6413003,4130,군포시,거소투표,,72,69,25,7,20,6,58,11,3
4100,경기도,군포시다선거구,6413003,4130,군포시,관외사전투표,,4161,4160,1581,476,1394,277,3728,432,1
4100,경기도,군포시다선거구,6413003,4130,군포시,산본2동,계,20774,11999,4051,1187,4104,1373,10715,1284,8775
4100,경기도,군포시다선거구,6413003,4130,군포시,산본2동,관내사전투표,3242,3238,1143,351,1015,336,2845,393,4
4100,경기도,군포시다선거구,6413003,4130,군포시,산본2동,선거일투표,17532,8761,2908,836,3089,1037,7870,891,8771
4100,경기도,군포시다선거구,6413003,4130,군포시,궁내동,계,15170,8884,2976,1123,3105,631,7835,1049,6286
4100,경기도,군포시다선거구,6413003,4130,군포시,궁내동,관내사전투표,2849,2843,1021,388,877,187,2473,370,6
4100,경기도,군포시다선거구,6413003,4130,군포시,궁내동,선거일투표,12321,6041,1955,735,2228,444,5362,679,6280
4100,경기도,군포시다선거구,6413003,4130,군포시,광정동,계,19492,10816,3841,1223,3750,842,9656,1160,8676
4100,경기도,군포시다선거구,6413003,4130,군포시,광정동,관내사전투표,2764,2759,1091,356,876,168,2491,268,5
4100,경기도,군포시다선거구,6413003,4130,군포시,광정동,선거일투표,16728,8057,2750,867,2874,674,7165,892,8671
4100,경기도,군포시다선거구,6413003,4130,군포시,잘못 투입·구분된 투표지,,0,27,11,4,4,1,20,7,-27
4100,경기도,군포시라선거구,6413004,4130,군포시,합계,,48553,27878,12783,10756,2154,1162,26855,1023,20675
4100,경기도,군포시라선거구,6413004,4130,군포시,거소투표,,52,50,26,12,2,5,45,5,2
4100,경기도,군포시라선거구,6413004,4130,군포시,관외사전투표,,2771,2770,1438,997,171,90,2696,74,1
4100,경기도,군포시라선거구,6413004,4130,군포시,재궁동,계,15571,7883,3430,3235,502,372,7539,344,7688
4100,경기도,군포시라선거구,6413004,4130,군포시,재궁동,관내사전투표,2107,2106,1026,839,107,83,2055,51,1
4100,경기도,군포시라선거구,6413004,4130,군포시,재궁동,선거일투표,13464,5777,2404,2396,395,289,5484,293,7687
4100,경기도,군포시라선거구,6413004,4130,군포시,오금동,계,16983,9610,4408,3479,949,510,9346,264,7373
4100,경기도,군포시라선거구,6413004,4130,군포시,오금동,관내사전투표,2723,2701,1347,990,181,147,2665,36,22
4100,경기도,군포시라선거구,6413004,4130,군포시,오금동,선거일투표,14260,6909,3061,2489,768,363,6681,228,7351
4100,경기도,군포시라선거구,6413004,4130,군포시,수리동,계,13176,7529,3461,3024,527,183,7195,334,5647
4100,경기도,군포시라선거구,6413004,4130,군포시,수리동,관내사전투표,2186,2179,1085,853,137,46,2121,58,7
4100,경기도,군포시라선거구,6413004,4130,군포시,수리동,선거일투표,10990,5350,2376,2171,390,137,5074,276,5640
4100,경기도,군포시라선거구,6413004,4130,군포시,잘못 투입·구분된 투표지,,0,36,20,9,3,2,34,2,-36
4100,경기도,하남시가선거구,6413101,4131,하남시,합계,,109446,59444,14700,7289,3193,14688,6951,4760,4054,55635,3809,50002
4100,경기도,하남시가선거구,6413101,4131,하남시,거소투표,,123,114,23,22,7,21,13,9,5,100,14,9
4100,경기도,하남시가선거구,6413101,4131,하남시,관외사전투표,,7761,7749,2393,832,463,2038,706,485,296,7213,536,12
4100,경기도,하남시가선거구,6413101,4131,하남시,천현동,계,6097,2790,530,344,106,817,316,242,239,2594,196,3307
4100,경기도,하남시가선거구,6413101,4131,하남시,천현동,관내사전투표,924,924,189,128,32,264,106,69,78,866,58,0
4100,경기도,하남시가선거구,6413101,4131,하남시,천현동,선거일투표,5173,1866,341,216,74,553,210,173,161,1728,138,3307
4100,경기도,하남시가선거구,6413101,4131,하남시,신장1동,계,6559,3096,686,430,200,747,336,197,281,2877,219,3463
4100,경기도,하남시가선거구,6413101,4131,하남시,신장1동,관내사전투표,1719,1719,370,261,105,407,207,105,159,1614,105,0
4100,경기도,하남시가선거구,6413101,4131,하남시,신장1동,선거일투표,4840,1377,316,169,95,340,129,92,122,1263,114,3463
4100,경기도,하남시가선거구,6413101,4131,하남시,신장2동,계,36734,18917,4178,2620,857,4720,2247,1330,1659,17611,1306,17817
4100,경기도,하남시가선거구,6413101,4131,하남시,신장2동,관내사전투표,5199,5184,1200,810,246,1211,578,315,423,4783,401,15
4100,경기도,하남시가선거구,6413101,4131,하남시,신장2동,선거일투표,31535,13733,2978,1810,611,3509,1669,1015,1236,12828,905,17802
4100,경기도,하남시가선거구,6413101,4131,하남시,감북동,계,2468,1221,245,125,68,332,117,120,114,1121,100,1247
4100,경기도,하남시가선거구,6413101,4131,하남시,감북동,관내사전투표,509,509,112,75,32,139,49,33,41,481,28,0
4100,경기도,하남시가선거구,6413101,4131,하남시,감북동,선거일투표,1959,712,133,50,36,193,68,87,73,640,72,1247
4100,경기도,하남시가선거구,6413101,4131,하남시,감일동,계,22460,11396,3431,1488,741,2349,1276,1006,508,10799,597,11064
4100,경기도,하남시가선거구,6413101,4131,하남시,감일동,관내사전투표,3778,3778,1163,551,254,720,464,289,154,3595,183,0
4100,경기도,하남시가선거구,6413101,4131,하남시,감일동,선거일투표,18682,7618,2268,937,487,1629,812,717,354,7204,414,11064
4100,경기도,하남시가선거구,6413101,4131,하남시,위례동,계,21010,11078,2592,1131,620,2823,1654,1006,676,10502,576,9932
4100,경기도,하남시가선거구,6413101,4131,하남시,위례동,관내사전투표,3039,3039,676,335,164,707,493,250,217,2842,197,0
4100,경기도,하남시가선거구,6413101,4131,하남시,위례동,선거일투표,17971,8039,1916,796,456,2116,1161,756,459,7660,379,9932
4100,경기도,하남시가선거구,6413101,4131,하남시,춘궁동,계,3321,1739,306,184,68,480,172,151,220,1581,158,1582
4100,경기도,하남시가선거구,6413101,4131,하남시,춘궁동,관내사전투표,790,790,141,105,36,219,59,53,88,701,89,0
4100,경기도,하남시가선거구,6413101,4131,하남시,춘궁동,선거일투표,2531,949,165,79,32,261,113,98,132,880,69,1582
4100,경기도,하남시가선거구,6413101,4131,하남시,초이동,계,2913,1317,310,108,60,357,112,211,53,1211,106,1596
4100,경기도,하남시가선거구,6413101,4131,하남시,초이동,관내사전투표,467,467,116,33,18,126,39,70,21,423,44,0
4100,경기도,하남시가선거구,6413101,4131,하남시,초이동,선거일투표,2446,850,194,75,42,231,73,141,32,788,62,1596
4100,경기도,하남시가선거구,6413101,4131,하남시,잘못 투입·구분된 투표지,,0,27,6,5,3,4,2,3,3,26,1,-27
4100,경기도,하남시나선거구,6413102,4131,하남시,합계,,75608,39159,17912,14716,4846,37474,1685,36449
4100,경기도,하남시나선거구,6413102,4131,하남시,거소투표,,138,130,45,41,21,107,23,8
4100,경기도,하남시나선거구,6413102,4131,하남시,관외사전투표,,5978,5977,2994,2115,710,5819,158,1
4100,경기도,하남시나선거구,6413102,4131,하남시,덕풍1동,계,12963,6378,2731,2562,756,6049,329,6585
4100,경기도,하남시나선거구,6413102,4131,하남시,덕풍1동,관내사전투표,2538,2536,1166,1011,286,2463,73,2
4100,경기도,하남시나선거구,6413102,4131,하남시,덕풍1동,선거일투표,10425,3842,1565,1551,470,3586,256,6583
4100,경기도,하남시나선거구,6413102,4131,하남시,덕풍2동,계,16239,7504,3213,3035,849,7097,407,8735
4100,경기도,하남시나선거구,6413102,4131,하남시,덕풍2동,관내사전투표,2922,2921,1289,1178,316,2783,138,1
4100,경기도,하남시나선거구,6413102,4131,하남시,덕풍2동,선거일투표,13317,4583,1924,1857,533,4314,269,8734
4100,경기도,하남시나선거구,6413102,4131,하남시,덕풍3동,계,20269,9793,4421,3734,1194,9349,444,10476
4100,경기도,하남시나선거구,6413102,4131,하남시,덕풍3동,관내사전투표,3070,3068,1494,1117,382,2993,75,2
4100,경기도,하남시나선거구,6413102,4131,하남시,덕풍3동,선거일투표,17199,6725,2927,2617,812,6356,369,10474
4100,경기도,하남시나선거구,6413102,4131,하남시,풍산동,계,20021,9348,4494,3218,1314,9026,322,10673
4100,경기도,하남시나선거구,6413102,4131,하남시,풍산동,관내사전투표,2120,2119,1079,701,276,2056,63,1
4100,경기도,하남시나선거구,6413102,4131,하남시,풍산동,선거일투표,17901,7229,3415,2517,1038,6970,259,10672
4100,경기도,하남시나선거구,6413102,4131,하남시,잘못 투입·구분된 투표지,,0,29,14,11,2,27,2,-29
4100,경기도,하남시다선거구,6413103,4131,하남시,합계,,81802,41073,13763,6678,12818,5034,277,38570,2503,40729
4100,경기도,하남시다선거구,6413103,4131,하남시,거소투표,,58,52,18,6,16,6,2,48,4,6
4100,경기도,하남시다선거구,6413103,4131,하남시,관외사전투표,,5929,5922,2180,913,1876,576,56,5601,321,7
4100,경기도,하남시다선거구,6413103,4131,하남시,미사1동,계,40658,16539,5667,2600,5029,2101,109,15506,1033,24119
4100,경기도,하남시다선거구,6413103,4131,하남시,미사1동,관내사전투표,4200,4189,1494,758,1161,540,22,3975,214,11
4100,경기도,하남시다선거구,6413103,4131,하남시,미사1동,선거일투표,36458,12350,4173,1842,3868,1561,87,11531,819,24108
4100,경기도,하남시다선거구,6413103,4131,하남시,미사2동,계,35157,18505,5882,3150,5873,2349,110,17364,1141,16652
4100,경기도,하남시다선거구,6413103,4131,하남시,미사2동,관내사전투표,6344,6320,2010,1197,1904,738,44,5893,427,24
4100,경기도,하남시다선거구,6413103,4131,하남시,미사2동,선거일투표,28813,12185,3872,1953,3969,1611,66,11471,714,16628
4100,경기도,하남시다선거구,6413103,4131,하남시,잘못 투입·구분된 투표지,,0,55,16,9,24,2,0,51,4,-55
4100,경기도,파주시가선거구,6413201,4132,파주시,합계,,78367,37353,15827,13626,5053,1222,35728,1625,41014
4100,경기도,파주시가선거구,6413201,4132,파주시,거소투표,,130,121,46,33,29,2,110,11,9
4100,경기도,파주시가선거구,6413201,4132,파주시,관외사전투표,,3828,3821,1855,1341,363,154,3713,108,7
4100,경기도,파주시가선거구,6413201,4132,파주시,조리읍,계,24689,11326,4325,4021,2199,266,10811,515,13363
4100,경기도,파주시가선거구,6413201,4132,파주시,조리읍,관내사전투표,2793,2776,1154,924,546,63,2687,89,17
4100,경기도,파주시가선거구,6413201,4132,파주시,조리읍,선거일투표,21896,8550,3171,3097,1653,203,8124,426,13346
4100,경기도,파주시가선거구,6413201,4132,파주시,광탄면,계,9832,4369,1327,1902,848,68,4145,224,5463
4100,경기도,파주시가선거구,6413201,4132,파주시,광탄면,관내사전투표,1583,1579,530,639,324,22,1515,64,4
4100,경기도,파주시가선거구,6413201,4132,파주시,광탄면,선거일투표,8249,2790,797,1263,524,46,2630,160,5459
4100,경기도,파주시가선거구,6413201,4132,파주시,운정1동,계,39888,17653,8251,6305,1604,730,16890,763,22235
4100,경기도,파주시가선거구,6413201,4132,파주시,운정1동,관내사전투표,4201,4196,2078,1474,370,164,4086,110,5
4100,경기도,파주시가선거구,6413201,4132,파주시,운정1동,선거일투표,35687,13457,6173,4831,1234,566,12804,653,22230
4100,경기도,파주시가선거구,6413201,4132,파주시,잘못 투입·구분된 투표지,,0,63,23,24,10,2,59,4,-63
4100,경기도,파주시나선거구,6413202,4132,파주시,합계,,103491,49532,17327,7983,13211,5750,1399,506,46176,3356,53959
4100,경기도,파주시나선거구,6413202,4132,파주시,거소투표,,155,143,49,18,49,10,3,1,130,13,12
4100,경기도,파주시나선거구,6413202,4132,파주시,관외사전투표,,6867,6855,2427,1101,1858,722,148,62,6318,537,12
4100,경기도,파주시나선거구,6413202,4132,파주시,탄현면,계,11479,5124,1557,680,1623,652,147,35,4694,430,6355
4100,경기도,파주시나선거구,6413202,4132,파주시,탄현면,관내사전투표,1318,1311,440,180,371,169,31,6,1197,114,7
4100,경기도,파주시나선거구,6413202,4132,파주시,탄현면,선거일투표,10161,3813,1117,500,1252,483,116,29,3497,316,6348
4100,경기도,파주시나선거구,6413202,4132,파주시,교하동,계,40332,17445,6012,2628,4881,1921,665,202,16309,1136,22887
4100,경기도,파주시나선거구,6413202,4132,파주시,교하동,관내사전투표,3314,3300,1102,535,829,365,122,40,2993,307,14
4100,경기도,파주시나선거구,6413202,4132,파주시,교하동,선거일투표,37018,14145,4910,2093,4052,1556,543,162,13316,829,22873
4100,경기도,파주시나선거구,6413202,4132,파주시,운정2동,계,44658,19918,7269,3543,4790,2441,434,205,18682,1236,24740
4100,경기도,파주시나선거구,6413202,4132,파주시,운정2동,관내사전투표,3257,3247,1226,583,692,394,79,30,3004,243,10
4100,경기도,파주시나선거구,6413202,4132,파주시,운정2동,선거일투표,41401,16671,6043,2960,4098,2047,355,175,15678,993,24730
4100,경기도,파주시나선거구,6413202,4132,파주시,잘못 투입·구분된 투표지,,0,47,13,13,10,4,2,1,43,4,-47
4100,경기도,파주시다선거구,6413203,4132,파주시,검색된 결과가 없습니다.
4100,경기도,파주시라선거구,6413204,4132,파주시,합계,,60416,27591,8059,3914,8870,3436,1249,25528,2063,32825
4100,경기도,파주시라선거구,6413204,4132,파주시,거소투표,,460,422,110,62,135,21,30,358,64,38
4100,경기도,파주시라선거구,6413204,4132,파주시,관외사전투표,,2535,2533,838,304,930,211,85,2368,165,2
4100,경기도,파주시라선거구,6413204,4132,파주시,문산읍,계,37966,15390,5028,1854,4716,1792,896,14286,1104,22576
4100,경기도,파주시라선거구,6413204,4132,파주시,문산읍,관내사전투표,4418,4414,1496,601,1269,440,283,4089,325,4
4100,경기도,파주시라선거구,6413204,4132,파주시,문산읍,선거일투표,33548,10976,3532,1253,3447,1352,613,10197,779,22572
4100,경기도,파주시라선거구,6413204,4132,파주시,법원읍,계,9191,4184,813,1098,1314,551,93,3869,315,5007
4100,경기도,파주시라선거구,6413204,4132,파주시,법원읍,관내사전투표,1344,1339,258,357,429,167,24,1235,104,5
4100,경기도,파주시라선거구,6413204,4132,파주시,법원읍,선거일투표,7847,2845,555,741,885,384,69,2634,211,5002
4100,경기도,파주시라선거구,6413204,4132,파주시,적성면,계,6044,2753,657,325,1045,458,59,2544,209,3291
4100,경기도,파주시라선거구,6413204,4132,파주시,적성면,관내사전투표,929,924,233,102,349,154,21,859,65,5
4100,경기도,파주시라선거구,6413204,4132,파주시,적성면,선거일투표,5115,1829,424,223,696,304,38,1685,144,3286
4100,경기도,파주시라선거구,6413204,4132,파주시,파평면,계,3550,1849,475,230,582,339,65,1691,158,1701
4100,경기도,파주시라선거구,6413204,4132,파주시,파평면,관내사전투표,502,499,128,64,143,100,25,460,39,3
4100,경기도,파주시라선거구,6413204,4132,파주시,파평면,선거일투표,3048,1350,347,166,439,239,40,1231,119,1698
4100,경기도,파주시라선거구,6413204,4132,파주시,장단면,계,670,438,133,36,141,63,20,393,45,232
4100,경기도,파주시라선거구,6413204,4132,파주시,장단면,관내사전투표,157,157,53,12,52,17,8,142,15,0
4100,경기도,파주시라선거구,6413204,4132,파주시,장단면,선거일투표,513,281,80,24,89,46,12,251,30,232
4100,경기도,파주시라선거구,6413204,4132,파주시,잘못 투입·구분된 투표지,,0,22,5,5,7,1,1,19,3,-22
4100,경기도,파주시마선거구,6413205,4132,파주시,합계,,92088,41140,13583,5632,10915,6815,36945,4195,50948
4100,경기도,파주시마선거구,6413205,4132,파주시,거소투표,,229,218,82,22,54,31,189,29,11
4100,경기도,파주시마선거구,6413205,4132,파주시,관외사전투표,,3802,3797,1222,607,1183,439,3451,346,5
4100,경기도,파주시마선거구,6413205,4132,파주시,파주읍,계,11707,4894,1380,543,1355,1063,4341,553,6813
4100,경기도,파주시마선거구,6413205,4132,파주시,파주읍,관내사전투표,1417,1407,395,148,394,297,1234,173,10
4100,경기도,파주시마선거구,6413205,4132,파주시,파주읍,선거일투표,10290,3487,985,395,961,766,3107,380,6803
4100,경기도,파주시마선거구,6413205,4132,파주시,월롱면,계,8825,3015,802,383,944,518,2647,368,5810
4100,경기도,파주시마선거구,6413205,4132,파주시,월롱면,관내사전투표,868,868,253,112,224,161,750,118,0
4100,경기도,파주시마선거구,6413205,4132,파주시,월롱면,선거일투표,7957,2147,549,271,720,357,1897,250,5810
4100,경기도,파주시마선거구,6413205,4132,파주시,금촌1동,계,19451,7438,2220,935,2143,1435,6733,705,12013
4100,경기도,파주시마선거구,6413205,4132,파주시,금촌1동,관내사전투표,2412,2412,742,350,668,424,2184,228,0
4100,경기도,파주시마선거구,6413205,4132,파주시,금촌1동,선거일투표,17039,5026,1478,585,1475,1011,4549,477,12013
4100,경기도,파주시마선거구,6413205,4132,파주시,금촌2동,계,25824,12281,4506,1910,2815,1814,11045,1236,13543
4100,경기도,파주시마선거구,6413205,4132,파주시,금촌2동,관내사전투표,3847,3842,1462,632,826,548,3468,374,5
4100,경기도,파주시마선거구,6413205,4132,파주시,금촌2동,선거일투표,21977,8439,3044,1278,1989,1266,7577,862,13538
4100,경기도,파주시마선거구,6413205,4132,파주시,금촌3동,계,22250,9437,3359,1228,2403,1506,8496,941,12813
4100,경기도,파주시마선거구,6413205,4132,파주시,금촌3동,관내사전투표,3141,3134,1127,431,753,481,2792,342,7
4100,경기도,파주시마선거구,6413205,4132,파주시,금촌3동,선거일투표,19109,6303,2232,797,1650,1025,5704,599,12806
4100,경기도,파주시마선거구,6413205,4132,파주시,잘못 투입·구분된 투표지,,0,60,12,4,18,9,43,17,-60
4100,경기도,여주시가선거구,6413301,4133,여주시,합계,,50428,25840,4747,5547,8551,3961,22806,3034,24588
4100,경기도,여주시가선거구,6413301,4133,여주시,거소투표,,52,49,10,13,14,8,45,4,3
4100,경기도,여주시가선거구,6413301,4133,여주시,관외사전투표,,2845,2843,738,501,987,324,2550,293,2
4100,경기도,여주시가선거구,6413301,4133,여주시,가남읍,계,12621,5727,798,1886,925,1514,5123,604,6894
4100,경기도,여주시가선거구,6413301,4133,여주시,가남읍,관내사전투표,1759,1758,269,546,283,505,1603,155,1
4100,경기도,여주시가선거구,6413301,4133,여주시,가남읍,선거일투표,10862,3969,529,1340,642,1009,3520,449,6893
4100,경기도,여주시가선거구,6413301,4133,여주시,점동면,계,4391,2521,399,476,900,356,2131,390,1870
4100,경기도,여주시가선거구,6413301,4133,여주시,점동면,관내사전투표,1046,1046,179,194,381,153,907,139,0
4100,경기도,여주시가선거구,6413301,4133,여주시,점동면,선거일투표,3345,1475,220,282,519,203,1224,251,1870
4100,경기도,여주시가선거구,6413301,4133,여주시,세종대왕면,계,5187,2744,438,618,895,375,2326,418,2443
4100,경기도,여주시가선거구,6413301,4133,여주시,세종대왕면,관내사전투표,864,864,124,231,305,129,789,75,0
4100,경기도,여주시가선거구,6413301,4133,여주시,세종대왕면,선거일투표,4323,1880,314,387,590,246,1537,343,2443
4100,경기도,여주시가선거구,6413301,4133,여주시,북내면,계,4206,2288,441,367,945,281,2034,254,1918
4100,경기도,여주시가선거구,6413301,4133,여주시,북내면,관내사전투표,805,805,165,135,335,115,750,55,0
4100,경기도,여주시가선거구,6413301,4133,여주시,북내면,선거일투표,3401,1483,276,232,610,166,1284,199,1918
4100,경기도,여주시가선거구,6413301,4133,여주시,강천면,계,3695,2046,413,308,902,190,1813,233,1649
4100,경기도,여주시가선거구,6413301,4133,여주시,강천면,관내사전투표,736,736,150,116,321,64,651,85,0
4100,경기도,여주시가선거구,6413301,4133,여주시,강천면,선거일투표,2959,1310,263,192,581,126,1162,148,1649
4100,경기도,여주시가선거구,6413301,4133,여주시,여흥동,계,17431,7610,1509,1375,2981,913,6778,832,9821
4100,경기도,여주시가선거구,6413301,4133,여주시,여흥동,관내사전투표,2353,2350,498,471,848,266,2083,267,3
4100,경기도,여주시가선거구,6413301,4133,여주시,여흥동,선거일투표,15078,5260,1011,904,2133,647,4695,565,9818
4100,경기도,여주시가선거구,6413301,4133,여주시,잘못 투입·구분된 투표지,,0,12,1,3,2,0,6,6,-12
4100,경기도,여주시나선거구,6413302,4133,여주시,합계,,47905,24811,6916,2069,7669,4249,2271,23174,1637,23094
4100,경기도,여주시나선거구,6413302,4133,여주시,거소투표,,64,57,21,5,16,3,2,47,10,7
4100,경기도,여주시나선거구,6413302,4133,여주시,관외사전투표,,3128,3123,1036,274,986,415,233,2944,179,5
4100,경기도,여주시나선거구,6413302,4133,여주시,흥천면,계,4293,2289,481,170,607,754,98,2110,179,2004
4100,경기도,여주시나선거구,6413302,4133,여주시,흥천면,관내사전투표,803,803,175,58,176,311,30,750,53,0
4100,경기도,여주시나선거구,6413302,4133,여주시,흥천면,선거일투표,3490,1486,306,112,431,443,68,1360,126,2004
4100,경기도,여주시나선거구,6413302,4133,여주시,금사면,계,2604,1502,294,107,605,301,97,1404,98,1102
4100,경기도,여주시나선거구,6413302,4133,여주시,금사면,관내사전투표,737,734,149,61,298,128,46,682,52,3
4100,경기도,여주시나선거구,6413302,4133,여주시,금사면,선거일투표,1867,768,145,46,307,173,51,722,46,1099
4100,경기도,여주시나선거구,6413302,4133,여주시,산북면,계,2201,1246,326,98,473,151,87,1135,111,955
4100,경기도,여주시나선거구,6413302,4133,여주시,산북면,관내사전투표,559,558,164,43,204,65,39,515,43,1
4100,경기도,여주시나선거구,6413302,4133,여주시,산북면,선거일투표,1642,688,162,55,269,86,48,620,68,954
4100,경기도,여주시나선거구,6413302,4133,여주시,대신면,계,5984,3217,642,245,1074,617,379,2957,260,2767
4100,경기도,여주시나선거구,6413302,4133,여주시,대신면,관내사전투표,1120,1118,235,87,348,234,135,1039,79,2
4100,경기도,여주시나선거구,6413302,4133,여주시,대신면,선거일투표,4864,2099,407,158,726,383,244,1918,181,2765
4100,경기도,여주시나선거구,6413302,4133,여주시,중앙동,계,15137,6895,2081,547,1928,1104,798,6458,437,8242
4100,경기도,여주시나선거구,6413302,4133,여주시,중앙동,관내사전투표,2508,2508,728,198,696,439,284,2345,163,0
4100,경기도,여주시나선거구,6413302,4133,여주시,중앙동,선거일투표,12629,4387,1353,349,1232,665,514,4113,274,8242
4100,경기도,여주시나선거구,6413302,4133,여주시,오학동,계,14494,6472,2033,623,1976,901,576,6109,363,8022
4100,경기도,여주시나선거구,6413302,4133,여주시,오학동,관내사전투표,2997,2996,933,296,919,427,254,2829,167,1
4100,경기도,여주시나선거구,6413302,4133,여주시,오학동,선거일투표,11497,3476,1100,327,1057,474,322,3280,196,8021
4100,경기도,여주시나선거구,6413302,4133,여주시,잘못 투입·구분된 투표지,,0,10,2,0,4,3,1,10,0,-10
4100,경기도,이천시가선거구,6413401,4134,이천시,합계,,75892,36489,13747,3014,10943,5272,1420,34396,2093,39403
4100,경기도,이천시가선거구,6413401,4134,이천시,거소투표,,102,93,32,7,23,18,7,87,6,9
4100,경기도,이천시가선거구,6413401,4134,이천시,관외사전투표,,5215,5211,2076,491,1497,628,227,4919,292,4
4100,경기도,이천시가선거구,6413401,4134,이천시,신둔면,계,11811,5557,2257,385,1759,639,165,5205,352,6254
4100,경기도,이천시가선거구,6413401,4134,이천시,신둔면,관내사전투표,1959,1954,833,153,566,192,63,1807,147,5
4100,경기도,이천시가선거구,6413401,4134,이천시,신둔면,선거일투표,9852,3603,1424,232,1193,447,102,3398,205,6249
4100,경기도,이천시가선거구,6413401,4134,이천시,백사면,계,9278,4299,1201,317,1217,1120,173,4028,271,4979
4100,경기도,이천시가선거구,6413401,4134,이천시,백사면,관내사전투표,1557,1556,437,123,417,407,64,1448,108,1
4100,경기도,이천시가선거구,6413401,4134,이천시,백사면,선거일투표,7721,2743,764,194,800,713,109,2580,163,4978
4100,경기도,이천시가선거구,6413401,4134,이천시,증포동,계,40379,17187,6854,1476,5045,2222,670,16267,920,23192
4100,경기도,이천시가선거구,6413401,4134,이천시,증포동,관내사전투표,5198,5183,2071,481,1555,598,176,4881,302,15
4100,경기도,이천시가선거구,6413401,4134,이천시,증포동,선거일투표,35181,12004,4783,995,3490,1624,494,11386,618,23177
4100,경기도,이천시가선거구,6413401,4134,이천시,관고동,계,9107,4115,1317,337,1392,640,177,3863,252,4992
4100,경기도,이천시가선거구,6413401,4134,이천시,관고동,관내사전투표,1912,1910,673,168,591,285,77,1794,116,2
4100,경기도,이천시가선거구,6413401,4134,이천시,관고동,선거일투표,7195,2205,644,169,801,355,100,2069,136,4990
4100,경기도,이천시가선거구,6413401,4134,이천시,잘못 투입·구분된 투표지,,0,27,10,1,10,5,1,27,0,-27
4100,경기도,이천시나선거구,6413402,4134,이천시,합계,,41515,18400,5858,7580,3807,544,17789,611,23115
4100,경기도,이천시나선거구,6413402,4134,이천시,거소투표,,42,36,13,12,10,0,35,1,6
4100,경기도,이천시나선거구,6413402,4134,이천시,관외사전투표,,2702,2700,1057,1066,379,91,2593,107,2
4100,경기도,이천시나선거구,6413402,4134,이천시,마장면,계,12354,5102,1676,2089,1078,113,4956,146,7252
4100,경기도,이천시나선거구,6413402,4134,이천시,마장면,관내사전투표,2080,2075,710,847,395,53,2005,70,5
4100,경기도,이천시나선거구,6413402,4134,이천시,마장면,선거일투표,10274,3027,966,1242,683,60,2951,76,7247
4100,경기도,이천시나선거구,6413402,4134,이천시,창전동,계,13958,5537,1660,2276,1206,193,5335,202,8421
4100,경기도,이천시나선거구,6413402,4134,이천시,창전동,관내사전투표,1608,1606,509,648,331,69,1557,49,2
4100,경기도,이천시나선거구,6413402,4134,이천시,창전동,선거일투표,12350,3931,1151,1628,875,124,3778,153,8419
4100,경기도,이천시나선거구,6413402,4134,이천시,중리동,계,12459,4995,1445,2128,1122,146,4841,154,7464
4100,경기도,이천시나선거구,6413402,4134,이천시,중리동,관내사전투표,1656,1646,487,692,360,50,1589,57,10
4100,경기도,이천시나선거구,6413402,4134,이천시,중리동,선거일투표,10803,3349,958,1436,762,96,3252,97,7454
4100,경기도,이천시나선거구,6413402,4134,이천시,잘못 투입·구분된 투표지,,0,30,7,9,12,1,29,1,-30
4100,경기도,이천시다선거구,6413403,4134,이천시,합계,,71156,33825,7653,4037,9224,8057,672,1839,31482,2343,37331
4100,경기도,이천시다선거구,6413403,4134,이천시,거소투표,,309,293,73,38,82,25,7,16,241,52,16
4100,경기도,이천시다선거구,6413403,4134,이천시,관외사전투표,,3872,3869,1121,481,1163,623,59,145,3592,277,3
4100,경기도,이천시다선거구,6413403,4134,이천시,장호원읍,계,11973,5726,1230,485,2595,827,91,59,5287,439,6247
4100,경기도,이천시다선거구,6413403,4134,이천시,장호원읍,관내사전투표,1921,1916,491,163,810,254,39,17,1774,142,5
4100,경기도,이천시다선거구,6413403,4134,이천시,장호원읍,선거일투표,10052,3810,739,322,1785,573,52,42,3513,297,6242
4100,경기도,이천시다선거구,6413403,4134,이천시,부발읍,계,27740,11445,2549,1633,2104,3128,300,1090,10804,641,16295
4100,경기도,이천시다선거구,6413403,4134,이천시,부발읍,관내사전투표,2929,2921,634,406,528,882,72,225,2747,174,8
4100,경기도,이천시다선거구,6413403,4134,이천시,부발읍,선거일투표,24811,8524,1915,1227,1576,2246,228,865,8057,467,16287
4100,경기도,이천시다선거구,6413403,4134,이천시,호법면,계,5000,2368,452,216,773,653,38,46,2178,190,2632
4100,경기도,이천시다선거구,6413403,4134,이천시,호법면,관내사전투표,997,994,188,87,335,277,15,16,918,76,3
4100,경기도,이천시다선거구,6413403,4134,이천시,호법면,선거일투표,4003,1374,264,129,438,376,23,30,1260,114,2629
4100,경기도,이천시다선거구,6413403,4134,이천시,대월면,계,11966,4532,1083,580,978,1152,70,374,4237,295,7434
4100,경기도,이천시다선거구,6413403,4134,이천시,대월면,관내사전투표,1640,1637,417,241,299,403,29,146,1535,102,3
4100,경기도,이천시다선거구,6413403,4134,이천시,대월면,선거일투표,10326,2895,666,339,679,749,41,228,2702,193,7431
4100,경기도,이천시다선거구,6413403,4134,이천시,모가면,계,3880,2157,362,342,529,647,35,55,1970,187,1723
4100,경기도,이천시다선거구,6413403,4134,이천시,모가면,관내사전투표,919,918,176,107,224,274,18,34,833,85,1
4100,경기도,이천시다선거구,6413403,4134,이천시,모가면,선거일투표,2961,1239,186,235,305,373,17,21,1137,102,1722
4100,경기도,이천시다선거구,6413403,4134,이천시,설성면,계,3983,2026,380,164,634,629,43,39,1889,137,1957
4100,경기도,이천시다선거구,6413403,4134,이천시,설성면,관내사전투표,734,731,135,77,220,221,16,18,687,44,3
4100,경기도,이천시다선거구,6413403,4134,이천시,설성면,선거일투표,3249,1295,245,87,414,408,27,21,1202,93,1954
4100,경기도,이천시다선거구,6413403,4134,이천시,율면,계,2433,1390,399,98,361,367,29,12,1266,124,1043
4100,경기도,이천시다선거구,6413403,4134,이천시,율면,관내사전투표,708,707,196,52,181,192,15,10,646,61,1
4100,경기도,이천시다선거구,6413403,4134,이천시,율면,선거일투표,1725,683,203,46,180,175,14,2,620,63,1042
4100,경기도,이천시다선거구,6413403,4134,이천시,잘못 투입·구분된 투표지,,0,19,4,0,5,6,0,3,18,1,-19
4100,경기도,용인시가선거구,6413501,4135,용인시처인구,합계,,119068,55054,15743,8894,20041,4808,49486,5568,64014
4100,경기도,용인시가선거구,6413501,4135,용인시처인구,거소투표,,133,125,38,21,39,11,109,16,8
4100,경기도,용인시가선거구,6413501,4135,용인시처인구,관외사전투표,,6186,6184,1852,1151,2211,438,5652,532,2
4100,경기도,용인시가선거구,6413501,4135,용인시처인구,포곡읍,계,27680,11812,3268,1869,4598,901,10636,1176,15868
4100,경기도,용인시가선거구,6413501,4135,용인시처인구,포곡읍,관내사전투표,3480,3480,974,614,1297,283,3168,312,0
4100,경기도,용인시가선거구,6413501,4135,용인시처인구,포곡읍,선거일투표,24200,8332,2294,1255,3301,618,7468,864,15868
4100,경기도,용인시가선거구,6413501,4135,용인시처인구,모현읍,계,21938,9341,2837,1246,3549,735,8367,974,12597
4100,경기도,용인시가선거구,6413501,4135,용인시처인구,모현읍,관내사전투표,2479,2479,750,377,921,195,2243,236,0
4100,경기도,용인시가선거구,6413501,4135,용인시처인구,모현읍,선거일투표,19459,6862,2087,869,2628,540,6124,738,12597
4100,경기도,용인시가선거구,6413501,4135,용인시처인구,역북동,계,24714,10768,3002,1825,3841,1055,9723,1045,13946
4100,경기도,용인시가선거구,6413501,4135,용인시처인구,역북동,관내사전투표,3939,3935,1098,722,1383,366,3569,366,4
4100,경기도,용인시가선거구,6413501,4135,용인시처인구,역북동,선거일투표,20775,6833,1904,1103,2458,689,6154,679,13942
4100,경기도,용인시가선거구,6413501,4135,용인시처인구,삼가동,계,9899,5016,1405,735,1689,656,4485,531,4883
4100,경기도,용인시가선거구,6413501,4135,용인시처인구,삼가동,관내사전투표,1383,1383,384,215,475,177,1251,132,0
4100,경기도,용인시가선거구,6413501,4135,용인시처인구,삼가동,선거일투표,8516,3633,1021,520,1214,479,3234,399,4883
4100,경기도,용인시가선거구,6413501,4135,용인시처인구,유림동,계,28518,11775,3331,2043,4101,1008,10483,1292,16743
4100,경기도,용인시가선거구,6413501,4135,용인시처인구,유림동,관내사전투표,2888,2888,820,521,1037,239,2617,271,0
4100,경기도,용인시가선거구,6413501,4135,용인시처인구,유림동,선거일투표,25630,8887,2511,1522,3064,769,7866,1021,16743
4100,경기도,용인시가선거구,6413501,4135,용인시처인구,잘못 투입·구분된 투표지,,0,33,10,4,13,4,31,2,-33
4100,경기도,용인시나선거구,6413502,4135,용인시처인구,합계,,58979,28369,7662,5277,9359,3793,391,26482,1887,30610
4100,경기도,용인시나선거구,6413502,4135,용인시처인구,거소투표,,170,164,47,19,29,19,8,122,42,6
4100,경기도,용인시나선거구,6413502,4135,용인시처인구,관외사전투표,,4085,4083,1265,711,1401,374,59,3810,273,2
4100,경기도,용인시나선거구,6413502,4135,용인시처인구,이동읍,계,16703,7188,1828,1279,2761,732,79,6679,509,9515
4100,경기도,용인시나선거구,6413502,4135,용인시처인구,이동읍,관내사전투표,2348,2346,605,460,819,262,28,2174,172,2
4100,경기도,용인시나선거구,6413502,4135,용인시처인구,이동읍,선거일투표,14355,4842,1223,819,1942,470,51,4505,337,9513
4100,경기도,용인시나선거구,6413502,4135,용인시처인구,남사읍,계,17487,8455,2114,1849,2128,1758,116,7965,490,9032
4100,경기도,용인시나선거구,6413502,4135,용인시처인구,남사읍,관내사전투표,1839,1833,484,453,411,376,22,1746,87,6
4100,경기도,용인시나선거구,6413502,4135,용인시처인구,남사읍,선거일투표,15648,6622,1630,1396,1717,1382,94,6219,403,9026
4100,경기도,용인시나선거구,6413502,4135,용인시처인구,중앙동,계,20534,8460,2404,1418,3035,907,128,7892,568,12074
4100,경기도,용인시나선거구,6413502,4135,용인시처인구,중앙동,관내사전투표,2404,2402,724,453,813,228,41,2259,143,2
4100,경기도,용인시나선거구,6413502,4135,용인시처인구,중앙동,선거일투표,18130,6058,1680,965,2222,679,87,5633,425,12072
4100,경기도,용인시나선거구,6413502,4135,용인시처인구,잘못 투입·구분된 투표지,,0,19,4,1,5,3,1,14,5,-19
4100,경기도,용인시다선거구,6413503,4135,용인시처인구,검색된 결과가 없습니다.
4100,경기도,용인시사선거구,6413704,4136,용인시수지구,검색된 결과가 없습니다.
4100,경기도,용인시아선거구,6413601,4136,용인시수지구,검색된 결과가 없습니다.
4100,경기도,용인시자선거구,6413602,4136,용인시수지구,합계,,114663,68128,18623,8910,25069,8978,61580,6548,46535
4100,경기도,용인시자선거구,6413602,4136,용인시수지구,거소투표,,115,110,23,16,43,17,99,11,5
4100,경기도,용인시자선거구,6413602,4136,용인시수지구,관외사전투표,,6064,6062,1792,990,2060,693,5535,527,2
4100,경기도,용인시자선거구,6413602,4136,용인시수지구,신봉동,계,29079,16731,4643,2217,5693,2247,14800,1931,12348
4100,경기도,용인시자선거구,6413602,4136,용인시수지구,신봉동,관내사전투표,4595,4593,1382,686,1533,528,4129,464,2
4100,경기도,용인시자선거구,6413602,4136,용인시수지구,신봉동,선거일투표,24484,12138,3261,1531,4160,1719,10671,1467,12346
4100,경기도,용인시자선거구,6413602,4136,용인시수지구,동천동,계,38047,21349,6287,3223,7058,2670,19238,2111,16698
4100,경기도,용인시자선거구,6413602,4136,용인시수지구,동천동,관내사전투표,7072,7068,2140,1110,2265,758,6273,795,4
4100,경기도,용인시자선거구,6413602,4136,용인시수지구,동천동,선거일투표,30975,14281,4147,2113,4793,1912,12965,1316,16694
4100,경기도,용인시자선거구,6413602,4136,용인시수지구,성복동,계,41358,23846,5872,2458,10201,3350,21881,1965,17512
4100,경기도,용인시자선거구,6413602,4136,용인시수지구,성복동,관내사전투표,6132,6122,1600,612,2584,792,5588,534,10
4100,경기도,용인시자선거구,6413602,4136,용인시수지구,성복동,선거일투표,35226,17724,4272,1846,7617,2558,16293,1431,17502
4100,경기도,용인시자선거구,6413602,4136,용인시수지구,잘못 투입·구분된 투표지,,0,30,6,6,14,1,27,3,-30
4100,경기도,용인시라선거구,6413701,4137,용인시기흥구,합계,,111040,58385,17972,11193,16061,7802,53028,5357,52655
4100,경기도,용인시라선거구,6413701,4137,용인시기흥구,거소투표,,128,123,43,12,32,23,110,13,5
4100,경기도,용인시라선거구,6413701,4137,용인시기흥구,관외사전투표,,7254,7241,2557,1265,2068,706,6596,645,13
4100,경기도,용인시라선거구,6413701,4137,용인시기흥구,신갈동,계,30512,15311,4822,2783,4103,2255,13963,1348,15201
4100,경기도,용인시라선거구,6413701,4137,용인시기흥구,신갈동,관내사전투표,3556,3553,1139,614,955,557,3265,288,3
4100,경기도,용인시라선거구,6413701,4137,용인시기흥구,신갈동,선거일투표,26956,11758,3683,2169,3148,1698,10698,1060,15198
4100,경기도,용인시라선거구,6413701,4137,용인시기흥구,영덕1동,계,22721,11751,3384,2703,2928,1624,10639,1112,10970
4100,경기도,용인시라선거구,6413701,4137,용인시기흥구,영덕1동,관내사전투표,3505,3502,1035,876,800,481,3192,310,3
4100,경기도,용인시라선거구,6413701,4137,용인시기흥구,영덕1동,선거일투표,19216,8249,2349,1827,2128,1143,7447,802,10967
4100,경기도,용인시라선거구,6413701,4137,용인시기흥구,영덕2동,계,13844,6956,2066,1396,1888,946,6296,660,6888
4100,경기도,용인시라선거구,6413701,4137,용인시기흥구,영덕2동,관내사전투표,2135,2130,633,468,514,322,1937,193,5
4100,경기도,용인시라선거구,6413701,4137,용인시기흥구,영덕2동,선거일투표,11709,4826,1433,928,1374,624,4359,467,6883
4100,경기도,용인시라선거구,6413701,4137,용인시기흥구,기흥동,계,16599,7313,2052,1049,2291,1150,6542,771,9286
4100,경기도,용인시라선거구,6413701,4137,용인시기흥구,기흥동,관내사전투표,2081,2078,591,329,616,341,1877,201,3
4100,경기도,용인시라선거구,6413701,4137,용인시기흥구,기흥동,선거일투표,14518,5235,1461,720,1675,809,4665,570,9283
4100,경기도,용인시라선거구,6413701,4137,용인시기흥구,서농동,계,19982,9629,3030,1974,2737,1089,8830,799,10353
4100,경기도,용인시라선거구,6413701,4137,용인시기흥구,서농동,관내사전투표,3188,3184,1029,713,840,345,2927,257,4
4100,경기도,용인시라선거구,6413701,4137,용인시기흥구,서농동,선거일투표,16794,6445,2001,1261,1897,744,5903,542,10349
4100,경기도,용인시라선거구,6413701,4137,용인시기흥구,잘못 투입·구분된 투표지,,0,61,18,11,14,9,52,9,-61
4100,경기도,용인시마선거구,6413702,4137,용인시기흥구,합계,,46600,24898,12059,11746,489,24294,604,21702
4100,경기도,용인시마선거구,6413702,4137,용인시기흥구,거소투표,,46,43,16,25,1,42,1,3
4100,경기도,용인시마선거구,6413702,4137,용인시기흥구,관외사전투표,,3684,3683,1839,1692,71,3602,81,1
4100,경기도,용인시마선거구,6413702,4137,용인시기흥구,구갈동,계,31961,15419,7307,7430,310,15047,372,16542
4100,경기도,용인시마선거구,6413702,4137,용인시기흥구,구갈동,관내사전투표,3424,3424,1824,1492,67,3383,41,0
4100,경기도,용인시마선거구,6413702,4137,용인시기흥구,구갈동,선거일투표,28537,11995,5483,5938,243,11664,331,16542
4100,경기도,용인시마선거구,6413702,4137,용인시기흥구,상갈동,계,10909,5742,2891,2595,107,5593,149,5167
4100,경기도,용인시마선거구,6413702,4137,용인시기흥구,상갈동,관내사전투표,2247,2246,1201,967,43,2211,35,1
4100,경기도,용인시마선거구,6413702,4137,용인시기흥구,상갈동,선거일투표,8662,3496,1690,1628,64,3382,114,5166
4100,경기도,용인시마선거구,6413702,4137,용인시기흥구,잘못 투입·구분된 투표지,,0,11,6,4,0,10,1,-11
4100,경기도,용인시바선거구,6413703,4137,용인시기흥구,합계,,68373,37254,13086,5214,17786,36086,1168,31119
4100,경기도,용인시바선거구,6413703,4137,용인시기흥구,거소투표,,85,84,26,15,38,79,5,1
4100,경기도,용인시바선거구,6413703,4137,용인시기흥구,관외사전투표,,4605,4603,1756,625,2096,4477,126,2
4100,경기도,용인시바선거구,6413703,4137,용인시기흥구,보라동,계,25475,13089,4466,2185,6019,12670,419,12386
4100,경기도,용인시바선거구,6413703,4137,용인시기흥구,보라동,관내사전투표,3255,3219,1203,587,1372,3162,57,36
4100,경기도,용인시바선거구,6413703,4137,용인시기흥구,보라동,선거일투표,22220,9870,3263,1598,4647,9508,362,12350
4100,경기도,용인시바선거구,6413703,4137,용인시기흥구,동백3동,계,19010,9807,3369,1185,5011,9565,242,9203
4100,경기도,용인시바선거구,6413703,4137,용인시기흥구,동백3동,관내사전투표,2601,2601,968,340,1245,2553,48,0
4100,경기도,용인시바선거구,6413703,4137,용인시기흥구,동백3동,선거일투표,16409,7206,2401,845,3766,7012,194,9203
4100,경기도,용인시바선거구,6413703,4137,용인시기흥구,상하동,계,19198,9617,3445,1195,4602,9242,375,9581
4100,경기도,용인시바선거구,6413703,4137,용인시기흥구,상하동,관내사전투표,2934,2930,1041,365,1466,2872,58,4
4100,경기도,용인시바선거구,6413703,4137,용인시기흥구,상하동,선거일투표,16264,6687,2404,830,3136,6370,317,9577
4100,경기도,용인시바선거구,6413703,4137,용인시기흥구,잘못 투입·구분된 투표지,,0,54,24,9,20,53,1,-54
4100,경기도,용인시차선거구,6413603,4137,용인시기흥구,합계,,106593,60931,18009,10648,17612,10247,1029,57545,3386,45662
4100,경기도,용인시차선거구,6413603,4137,용인시기흥구,거소투표,,133,128,51,9,37,14,2,113,15,5
4100,경기도,용인시차선거구,6413603,4137,용인시기흥구,관외사전투표,,5804,5799,2009,825,1936,611,88,5469,330,5
4100,경기도,용인시차선거구,6413603,4137,용인시기흥구,구성동,계,31762,17427,5111,2198,4823,4066,214,16412,1015,14335
4100,경기도,용인시차선거구,6413603,4137,용인시기흥구,구성동,관내사전투표,5152,5145,1562,685,1427,1060,52,4786,359,7
4100,경기도,용인시차선거구,6413603,4137,용인시기흥구,구성동,선거일투표,26610,12282,3549,1513,3396,3006,162,11626,656,14328
4100,경기도,용인시차선거구,6413603,4137,용인시기흥구,마북동,계,25125,13897,4089,1665,4590,2664,115,13123,774,11228
4100,경기도,용인시차선거구,6413603,4137,용인시기흥구,마북동,관내사전투표,4011,4009,1263,535,1241,723,41,3803,206,2
4100,경기도,용인시차선거구,6413603,4137,용인시기흥구,마북동,선거일투표,21114,9888,2826,1130,3349,1941,74,9320,568,11226
4100,경기도,용인시차선거구,6413603,4137,용인시기흥구,동백1동,계,23495,12298,3508,3372,2993,1429,325,11627,671,11197
4100,경기도,용인시차선거구,6413603,4137,용인시기흥구,동백1동,관내사전투표,3417,3411,1067,930,742,386,76,3201,210,6
4100,경기도,용인시차선거구,6413603,4137,용인시기흥구,동백1동,선거일투표,20078,8887,2441,2442,2251,1043,249,8426,461,11191
4100,경기도,용인시차선거구,6413603,4137,용인시기흥구,동백2동,계,20274,11348,3233,2567,3223,1460,285,10768,580,8926
4100,경기도,용인시차선거구,6413603,4137,용인시기흥구,동백2동,관내사전투표,4053,4045,1181,973,1138,461,95,3848,197,8
4100,경기도,용인시차선거구,6413603,4137,용인시기흥구,동백2동,선거일투표,16221,7303,2052,1594,2085,999,190,6920,383,8918
4100,경기도,용인시차선거구,6413603,4137,용인시기흥구,잘못 투입·구분된 투표지,,0,34,8,12,10,3,0,33,1,-34
4100,경기도,용인시카선거구,6413604,4137,용인시기흥구,합계,,102213,59704,17428,8097,18104,6336,4722,1371,189,318,56565,3139,42509
4100,경기도,용인시카선거구,6413604,4137,용인시기흥구,거소투표,,121,111,21,21,35,13,9,2,0,0,101,10,10
4100,경기도,용인시카선거구,6413604,4137,용인시기흥구,관외사전투표,,6791,6790,2357,880,2019,627,276,155,32,38,6384,406,1
4100,경기도,용인시카선거구,6413604,4137,용인시기흥구,보정동,계,28322,16218,4049,2565,4963,1787,1554,319,37,85,15359,859,12104
4100,경기도,용인시카선거구,6413604,4137,용인시기흥구,보정동,관내사전투표,5054,5053,1349,1037,1396,446,387,108,12,19,4754,299,1
4100,경기도,용인시카선거구,6413604,4137,용인시기흥구,보정동,선거일투표,23268,11165,2700,1528,3567,1341,1167,211,25,66,10605,560,12103
4100,경기도,용인시카선거구,6413604,4137,용인시기흥구,죽전1동,계,22296,12551,3387,1743,4048,1424,834,333,28,56,11853,698,9745
4100,경기도,용인시카선거구,6413604,4137,용인시기흥구,죽전1동,관내사전투표,3927,3927,1141,538,1265,388,216,93,8,10,3659,268,0
4100,경기도,용인시카선거구,6413604,4137,용인시기흥구,죽전1동,선거일투표,18369,8624,2246,1205,2783,1036,618,240,20,46,8194,430,9745
4100,경기도,용인시카선거구,6413604,4137,용인시기흥구,죽전3동,계,19661,9828,2975,1366,2821,1141,655,260,33,54,9305,523,9833
4100,경기도,용인시카선거구,6413604,4137,용인시기흥구,죽전3동,관내사전투표,2539,2539,826,365,690,291,137,65,12,14,2400,139,0
4100,경기도,용인시카선거구,6413604,4137,용인시기흥구,죽전3동,선거일투표,17122,7289,2149,1001,2131,850,518,195,21,40,6905,384,9833
4100,경기도,용인시카선거구,6413604,4137,용인시기흥구,상현2동,계,25022,14194,4635,1521,4215,1343,1393,301,59,85,13552,642,10828
4100,경기도,용인시카선거구,6413604,4137,용인시기흥구,상현2동,관내사전투표,4618,4613,1508,525,1441,393,426,81,18,24,4416,197,5
4100,경기도,용인시카선거구,6413604,4137,용인시기흥구,상현2동,선거일투표,20404,9581,3127,996,2774,950,967,220,41,61,9136,445,10823
4100,경기도,용인시카선거구,6413604,4137,용인시기흥구,잘못 투입·구분된 투표지,,0,12,4,1,3,1,1,1,0,0,11,1,-12
4100,경기도,안성시가선거구,6413801,4138,안성시,합계,,59545,27320,8734,5729,11649,26112,1208,32225
4100,경기도,안성시가선거구,6413801,4138,안성시,거소투표,,64,63,23,13,23,59,4,1
4100,경기도,안성시가선거구,6413801,4138,안성시,관외사전투표,,3590,3586,1289,659,1540,3488,98,4
4100,경기도,안성시가선거구,6413801,4138,안성시,공도읍,계,45735,18885,6311,4226,7601,18138,747,26850
4100,경기도,안성시가선거구,6413801,4138,안성시,공도읍,관내사전투표,5171,5166,1727,1302,2057,5086,80,5
4100,경기도,안성시가선거구,6413801,4138,안성시,공도읍,선거일투표,40564,13719,4584,2924,5544,13052,667,26845
4100,경기도,안성시가선거구,6413801,4138,안성시,양성면,계,4544,2449,525,457,1336,2318,131,2095
4100,경기도,안성시가선거구,6413801,4138,안성시,양성면,관내사전투표,951,949,224,169,508,901,48,2
4100,경기도,안성시가선거구,6413801,4138,안성시,양성면,선거일투표,3593,1500,301,288,828,1417,83,2093
4100,경기도,안성시가선거구,6413801,4138,안성시,원곡면,계,5612,2302,576,369,1134,2079,223,3310
4100,경기도,안성시가선거구,6413801,4138,안성시,원곡면,관내사전투표,862,861,220,144,460,824,37,1
4100,경기도,안성시가선거구,6413801,4138,안성시,원곡면,선거일투표,4750,1441,356,225,674,1255,186,3309
4100,경기도,안성시가선거구,6413801,4138,안성시,잘못 투입·구분된 투표지,,0,35,10,5,15,30,5,-35
4100,경기도,안성시나선거구,6413802,4138,안성시,합계,,39642,19956,5310,2202,5326,3221,2521,18580,1376,19686
4100,경기도,안성시나선거구,6413802,4138,안성시,거소투표,,38,33,5,4,6,8,6,29,4,5
4100,경기도,안성시나선거구,6413802,4138,안성시,관외사전투표,,2888,2885,808,349,770,432,337,2696,189,3
4100,경기도,안성시나선거구,6413802,4138,안성시,미양면,계,5016,2373,572,222,898,312,169,2173,200,2643
4100,경기도,안성시나선거구,6413802,4138,안성시,미양면,관내사전투표,854,853,222,88,320,100,62,792,61,1
4100,경기도,안성시나선거구,6413802,4138,안성시,미양면,선거일투표,4162,1520,350,134,578,212,107,1381,139,2642
4100,경기도,안성시나선거구,6413802,4138,안성시,대덕면,계,12517,5061,1443,542,1222,926,544,4677,384,7456
4100,경기도,안성시나선거구,6413802,4138,안성시,대덕면,관내사전투표,1648,1645,525,176,371,282,169,1523,122,3
4100,경기도,안성시나선거구,6413802,4138,안성시,대덕면,선거일투표,10869,3416,918,366,851,644,375,3154,262,7453
4100,경기도,안성시나선거구,6413802,4138,안성시,고삼면,계,1857,1198,299,114,339,253,80,1085,113,659
4100,경기도,안성시나선거구,6413802,4138,안성시,고삼면,관내사전투표,580,580,161,60,146,130,43,540,40,0
4100,경기도,안성시나선거구,6413802,4138,안성시,고삼면,선거일투표,1277,618,138,54,193,123,37,545,73,659
4100,경기도,안성시나선거구,6413802,4138,안성시,안성3동,계,17326,8391,2181,969,2085,1289,1382,7906,485,8935
4100,경기도,안성시나선거구,6413802,4138,안성시,안성3동,관내사전투표,2757,2754,795,328,666,406,438,2633,121,3
4100,경기도,안성시나선거구,6413802,4138,안성시,안성3동,선거일투표,14569,5637,1386,641,1419,883,944,5273,364,8932
4100,경기도,안성시나선거구,6413802,4138,안성시,잘못 투입·구분된 투표지,,0,15,2,2,6,1,3,14,1,-15
4100,경기도,안성시다선거구,6413803,4138,안성시,합계,,64331,34475,8180,5637,9109,6791,1377,736,31830,2645,29856
4100,경기도,안성시다선거구,6413803,4138,안성시,거소투표,,84,77,16,7,24,15,4,4,70,7,7
4100,경기도,안성시다선거구,6413803,4138,안성시,관외사전투표,,3442,3436,999,481,1081,432,132,69,3194,242,6
4100,경기도,안성시다선거구,6413803,4138,안성시,보개면,계,4835,2826,561,502,772,578,117,84,2614,212,2009
4100,경기도,안성시다선거구,6413803,4138,안성시,보개면,관내사전투표,1375,1374,289,280,342,265,69,31,1276,98,1
4100,경기도,안성시다선거구,6413803,4138,안성시,보개면,선거일투표,3460,1452,272,222,430,313,48,53,1338,114,2008
4100,경기도,안성시다선거구,6413803,4138,안성시,금광면,계,6209,3334,791,579,807,683,182,60,3102,232,2875
4100,경기도,안성시다선거구,6413803,4138,안성시,금광면,관내사전투표,996,993,223,184,258,194,38,21,918,75,3
4100,경기도,안성시다선거구,6413803,4138,안성시,금광면,선거일투표,5213,2341,568,395,549,489,144,39,2184,157,2872
4100,경기도,안성시다선거구,6413803,4138,안성시,서운면,계,2967,1702,360,282,524,301,64,23,1554,148,1265
4100,경기도,안성시다선거구,6413803,4138,안성시,서운면,관내사전투표,813,811,173,156,228,138,32,13,740,71,2
4100,경기도,안성시다선거구,6413803,4138,안성시,서운면,선거일투표,2154,891,187,126,296,163,32,10,814,77,1263
4100,경기도,안성시다선거구,6413803,4138,안성시,일죽면,계,6534,3439,610,372,724,1322,62,65,3155,284,3095
4100,경기도,안성시다선거구,6413803,4138,안성시,일죽면,관내사전투표,1562,1562,298,174,326,587,34,8,1427,135,0
4100,경기도,안성시다선거구,6413803,4138,안성시,일죽면,선거일투표,4972,1877,312,198,398,735,28,57,1728,149,3095
4100,경기도,안성시다선거구,6413803,4138,안성시,죽산면,계,6242,3327,736,498,730,989,48,43,3044,283,2915
4100,경기도,안성시다선거구,6413803,4138,안성시,죽산면,관내사전투표,1717,1713,383,264,349,509,23,19,1547,166,4
4100,경기도,안성시다선거구,6413803,4138,안성시,죽산면,선거일투표,4525,1614,353,234,381,480,25,24,1497,117,2911
4100,경기도,안성시다선거구,6413803,4138,안성시,삼죽면,계,3394,1659,351,192,392,485,42,30,1492,167,1735
4100,경기도,안성시다선거구,6413803,4138,안성시,삼죽면,관내사전투표,795,783,191,87,179,214,19,19,709,74,12
4100,경기도,안성시다선거구,6413803,4138,안성시,삼죽면,선거일투표,2599,876,160,105,213,271,23,11,783,93,1723
4100,경기도,안성시다선거구,6413803,4138,안성시,안성1동,계,10618,5673,1239,1075,1643,877,268,166,5268,405,4945
4100,경기도,안성시다선거구,6413803,4138,안성시,안성1동,관내사전투표,2563,2562,586,517,735,413,112,61,2424,138,1
4100,경기도,안성시다선거구,6413803,4138,안성시,안성1동,선거일투표,8055,3111,653,558,908,464,156,105,2844,267,4944
4100,경기도,안성시다선거구,6413803,4138,안성시,안성2동,계,20006,8948,2501,1644,2398,1099,454,192,8288,660,11058
4100,경기도,안성시다선거구,6413803,4138,안성시,안성2동,관내사전투표,3391,3384,931,680,846,427,172,58,3114,270,7
4100,경기도,안성시다선거구,6413803,4138,안성시,안성2동,선거일투표,16615,5564,1570,964,1552,672,282,134,5174,390,11051
4100,경기도,안성시다선거구,6413803,4138,안성시,잘못 투입·구분된 투표지,,0,54,16,5,14,10,4,0,49,5,-54
4100,경기도,김포시가선거구,6413901,4139,김포시,합계,,106927,56362,15926,10714,18101,7557,1135,53433,2929,50565
4100,경기도,김포시가선거구,6413901,4139,김포시,거소투표,,83,78,21,14,25,8,2,70,8,5
4100,경기도,김포시가선거구,6413901,4139,김포시,관외사전투표,,4750,4748,1452,933,1606,407,92,4490,258,2
4100,경기도,김포시가선거구,6413901,4139,김포시,고촌읍,계,35825,18810,5221,3370,6427,2581,316,17915,895,17015
4100,경기도,김포시가선거구,6413901,4139,김포시,고촌읍,관내사전투표,4737,4722,1396,907,1503,536,76,4418,304,15
4100,경기도,김포시가선거구,6413901,4139,김포시,고촌읍,선거일투표,31088,14088,3825,2463,4924,2045,240,13497,591,17000
4100,경기도,김포시가선거구,6413901,4139,김포시,사우동,계,19283,9444,2517,1847,2906,1293,252,8815,629,9839
4100,경기도,김포시가선거구,6413901,4139,김포시,사우동,관내사전투표,3503,3491,930,681,1036,439,109,3195,296,12
4100,경기도,김포시가선거구,6413901,4139,김포시,사우동,선거일투표,15780,5953,1587,1166,1870,854,143,5620,333,9827
4100,경기도,김포시가선거구,6413901,4139,김포시,풍무동,계,46986,23239,6703,4539,7125,3262,471,22100,1139,23747
4100,경기도,김포시가선거구,6413901,4139,김포시,풍무동,관내사전투표,5208,5194,1523,1133,1541,637,102,4936,258,14
4100,경기도,김포시가선거구,6413901,4139,김포시,풍무동,선거일투표,41778,18045,5180,3406,5584,2625,369,17164,881,23733
4100,경기도,김포시가선거구,6413901,4139,김포시,잘못 투입·구분된 투표지,,0,43,12,11,12,6,2,43,0,-43
4100,경기도,김포시나선거구,6413902,4139,김포시,합계,,81722,42761,15087,5104,11589,7117,38897,3864,38961
4100,경기도,김포시나선거구,6413902,4139,김포시,거소투표,,87,81,30,9,18,13,70,11,6
4100,경기도,김포시나선거구,6413902,4139,김포시,관외사전투표,,5273,5269,1974,683,1332,816,4805,464,4
4100,경기도,김포시나선거구,6413902,4139,김포시,김포본동,계,46160,23127,8103,2663,6045,4239,21050,2077,23033
4100,경기도,김포시나선거구,6413902,4139,김포시,김포본동,관내사전투표,3972,3957,1366,424,1032,743,3565,392,15
4100,경기도,김포시나선거구,6413902,4139,김포시,김포본동,선거일투표,42188,19170,6737,2239,5013,3496,17485,1685,23018
4100,경기도,김포시나선거구,6413902,4139,김포시,장기동,계,30202,14253,4972,1747,4187,2041,12947,1306,15949
4100,경기도,김포시나선거구,6413902,4139,김포시,장기동,관내사전투표,4043,4033,1473,552,1156,540,3721,312,10
4100,경기도,김포시나선거구,6413902,4139,김포시,장기동,선거일투표,26159,10220,3499,1195,3031,1501,9226,994,15939
4100,경기도,김포시나선거구,6413902,4139,김포시,잘못 투입·구분된 투표지,,0,31,8,2,7,8,25,6,-31
4100,경기도,김포시다선거구,6413903,4139,김포시,합계,,108573,48943,16119,6164,17737,4151,44171,4772,59630
4100,경기도,김포시다선거구,6413903,4139,김포시,거소투표,,109,107,24,17,34,11,86,21,2
4100,경기도,김포시다선거구,6413903,4139,김포시,관외사전투표,,5017,5017,1717,596,1895,332,4540,477,0
4100,경기도,김포시다선거구,6413903,4139,김포시,통진읍,계,24332,10020,3396,1028,3667,765,8856,1164,14312
4100,경기도,김포시다선거구,6413903,4139,김포시,통진읍,관내사전투표,2932,2931,1065,269,1048,214,2596,335,1
4100,경기도,김포시다선거구,6413903,4139,김포시,통진읍,선거일투표,21400,7089,2331,759,2619,551,6260,829,14311
4100,경기도,김포시다선거구,6413903,4139,김포시,양촌읍,계,23846,9856,3434,1154,3682,752,9022,834,13990
4100,경기도,김포시다선거구,6413903,4139,김포시,양촌읍,관내사전투표,3210,3207,1128,400,1191,216,2935,272,3
4100,경기도,김포시다선거구,6413903,4139,김포시,양촌읍,선거일투표,20636,6649,2306,754,2491,536,6087,562,13987
4100,경기도,김포시다선거구,6413903,4139,김포시,대곶면,계,8800,3891,989,390,1746,293,3418,473,4909
4100,경기도,김포시다선거구,6413903,4139,김포시,대곶면,관내사전투표,1168,1168,312,122,515,76,1025,143,0
4100,경기도,김포시다선거구,6413903,4139,김포시,대곶면,선거일투표,7632,2723,677,268,1231,217,2393,330,4909
4100,경기도,김포시다선거구,6413903,4139,김포시,월곶면,계,4942,2513,676,277,1089,203,2245,268,2429
4100,경기도,김포시다선거구,6413903,4139,김포시,월곶면,관내사전투표,1136,1135,343,128,439,84,994,141,1
4100,경기도,김포시다선거구,6413903,4139,김포시,월곶면,선거일투표,3806,1378,333,149,650,119,1251,127,2428
4100,경기도,김포시다선거구,6413903,4139,김포시,하성면,계,7307,3572,995,335,1580,280,3190,382,3735
4100,경기도,김포시다선거구,6413903,4139,김포시,하성면,관내사전투표,1378,1378,390,115,595,114,1214,164,0
4100,경기도,김포시다선거구,6413903,4139,김포시,하성면,선거일투표,5929,2194,605,220,985,166,1976,218,3735
4100,경기도,김포시다선거구,6413903,4139,김포시,구래동,계,34220,13941,4876,2365,4038,1513,12792,1149,20279
4100,경기도,김포시다선거구,6413903,4139,김포시,구래동,관내사전투표,3959,3955,1390,694,1080,397,3561,394,4
4100,경기도,김포시다선거구,6413903,4139,김포시,구래동,선거일투표,30261,9986,3486,1671,2958,1116,9231,755,20275
4100,경기도,김포시다선거구,6413903,4139,김포시,잘못 투입·구분된 투표지,,0,26,12,2,6,2,22,4,-26
4100,경기도,김포시라선거구,6413904,4139,김포시,합계,,95382,47710,14456,8724,12130,8959,785,45054,2656,47672
4100,경기도,김포시라선거구,6413904,4139,김포시,거소투표,,91,87,29,17,11,16,8,81,6,4
4100,경기도,김포시라선거구,6413904,4139,김포시,관외사전투표,,5111,5104,1606,975,1307,828,82,4798,306,7
4100,경기도,김포시라선거구,6413904,4139,김포시,장기본동,계,28041,13501,4032,2291,3534,2590,229,12676,825,14540
4100,경기도,김포시라선거구,6413904,4139,김포시,장기본동,관내사전투표,3697,3690,1080,634,983,679,49,3425,265,7
4100,경기도,김포시라선거구,6413904,4139,김포시,장기본동,선거일투표,24344,9811,2952,1657,2551,1911,180,9251,560,14533
4100,경기도,김포시라선거구,6413904,4139,김포시,마산동,계,26513,11943,4040,2005,2977,2058,206,11286,657,14570
4100,경기도,김포시라선거구,6413904,4139,김포시,마산동,관내사전투표,3146,3139,1141,566,769,477,46,2999,140,7
4100,경기도,김포시라선거구,6413904,4139,김포시,마산동,선거일투표,23367,8804,2899,1439,2208,1581,160,8287,517,14563
4100,경기도,김포시라선거구,6413904,4139,김포시,운양동,계,35626,17046,4739,3431,4295,3462,259,16186,860,18580
4100,경기도,김포시라선거구,6413904,4139,김포시,운양동,관내사전투표,4218,4210,1273,932,1002,741,51,3999,211,8
4100,경기도,김포시라선거구,6413904,4139,김포시,운양동,선거일투표,31408,12836,3466,2499,3293,2721,208,12187,649,18572
4100,경기도,김포시라선거구,6413904,4139,김포시,잘못 투입·구분된 투표지,,0,29,10,5,6,5,1,27,2,-29
4100,경기도,광주시가선거구,6414001,4140,광주시,합계,,69743,32615,14691,13961,2608,31260,1355,37128
4100,경기도,광주시가선거구,6414001,4140,광주시,거소투표,,106,97,32,37,17,86,11,9
4100,경기도,광주시가선거구,6414001,4140,광주시,관외사전투표,,4384,4379,2135,1722,395,4252,127,5
4100,경기도,광주시가선거구,6414001,4140,광주시,퇴촌면,계,13042,6006,2548,2646,632,5826,180,7036
4100,경기도,광주시가선거구,6414001,4140,광주시,퇴촌면,관내사전투표,2206,2204,944,950,236,2130,74,2
4100,경기도,광주시가선거구,6414001,4140,광주시,퇴촌면,선거일투표,10836,3802,1604,1696,396,3696,106,7034
4100,경기도,광주시가선거구,6414001,4140,광주시,남종면,계,1325,844,228,485,85,798,46,481
4100,경기도,광주시가선거구,6414001,4140,광주시,남종면,관내사전투표,290,290,110,150,24,284,6,0
4100,경기도,광주시가선거구,6414001,4140,광주시,남종면,선거일투표,1035,554,118,335,61,514,40,481
4100,경기도,광주시가선거구,6414001,4140,광주시,남한산성면,계,2068,1173,422,584,98,1104,69,895
4100,경기도,광주시가선거구,6414001,4140,광주시,남한산성면,관내사전투표,331,331,131,146,40,317,14,0
4100,경기도,광주시가선거구,6414001,4140,광주시,남한산성면,선거일투표,1737,842,291,438,58,787,55,895
4100,경기도,광주시가선거구,6414001,4140,광주시,송정동,계,17622,7695,3432,3289,572,7293,402,9927
4100,경기도,광주시가선거구,6414001,4140,광주시,송정동,관내사전투표,1886,1885,898,797,137,1832,53,1
4100,경기도,광주시가선거구,6414001,4140,광주시,송정동,선거일투표,15736,5810,2534,2492,435,5461,349,9926
4100,경기도,광주시가선거구,6414001,4140,광주시,탄벌동,계,31196,12401,5884,5192,806,11882,519,18795
4100,경기도,광주시가선거구,6414001,4140,광주시,탄벌동,관내사전투표,3760,3759,1823,1635,216,3674,85,1
4100,경기도,광주시가선거구,6414001,4140,광주시,탄벌동,선거일투표,27436,8642,4061,3557,590,8208,434,18794
4100,경기도,광주시가선거구,6414001,4140,광주시,잘못 투입·구분된 투표지,,0,20,10,6,3,19,1,-20
4100,경기도,광주시나선거구,6414002,4140,광주시,합계,,94652,45113,13909,8384,11783,6499,40575,4538,49539
4100,경기도,광주시나선거구,6414002,4140,광주시,거소투표,,111,109,29,24,30,12,95,14,2
4100,경기도,광주시나선거구,6414002,4140,광주시,관외사전투표,,5363,5355,1864,944,1481,595,4884,471,8
4100,경기도,광주시나선거구,6414002,4140,광주시,경안동,계,23725,10350,2846,1955,2563,1819,9183,1167,13375
4100,경기도,광주시나선거구,6414002,4140,광주시,경안동,관내사전투표,3070,3067,855,572,724,537,2688,379,3
4100,경기도,광주시나선거구,6414002,4140,광주시,경안동,선거일투표,20655,7283,1991,1383,1839,1282,6495,788,13372
4100,경기도,광주시나선거구,6414002,4140,광주시,쌍령동,계,14421,6794,1924,1456,1722,989,6091,703,7627
4100,경기도,광주시나선거구,6414002,4140,광주시,쌍령동,관내사전투표,2649,2648,781,604,598,401,2384,264,1
4100,경기도,광주시나선거구,6414002,4140,광주시,쌍령동,선거일투표,11772,4146,1143,852,1124,588,3707,439,7626
4100,경기도,광주시나선거구,6414002,4140,광주시,광남1동,계,27177,10881,3584,1765,3046,1479,9874,1007,16296
4100,경기도,광주시나선거구,6414002,4140,광주시,광남1동,관내사전투표,3676,3674,1286,588,1079,455,3408,266,2
4100,경기도,광주시나선거구,6414002,4140,광주시,광남1동,선거일투표,23501,7207,2298,1177,1967,1024,6466,741,16294
4100,경기도,광주시나선거구,6414002,4140,광주시,광남2동,계,23855,11586,3654,2233,2932,1600,10419,1167,12269
4100,경기도,광주시나선거구,6414002,4140,광주시,광남2동,관내사전투표,3574,3573,1187,707,833,455,3182,391,1
4100,경기도,광주시나선거구,6414002,4140,광주시,광남2동,선거일투표,20281,8013,2467,1526,2099,1145,7237,776,12268
4100,경기도,광주시나선거구,6414002,4140,광주시,잘못 투입·구분된 투표지,,0,38,8,7,9,5,29,9,-38
4100,경기도,광주시다선거구,6414003,4140,광주시,합계,,95429,42111,13499,7368,19882,40749,1362,53318
4100,경기도,광주시다선거구,6414003,4140,광주시,거소투표,,109,102,29,15,51,95,7,7
4100,경기도,광주시다선거구,6414003,4140,광주시,관외사전투표,,7894,7885,2853,1291,3554,7698,187,9
4100,경기도,광주시다선거구,6414003,4140,광주시,오포읍,계,87426,34092,10610,6055,16265,32930,1162,53334
4100,경기도,광주시다선거구,6414003,4140,광주시,오포읍,관내사전투표,5140,5136,1380,1190,2437,5007,129,4
4100,경기도,광주시다선거구,6414003,4140,광주시,오포읍,선거일투표,82286,28956,9230,4865,13828,27923,1033,53330
4100,경기도,광주시다선거구,6414003,4140,광주시,잘못 투입·구분된 투표지,,0,32,7,7,12,26,6,-32
4100,경기도,광주시라선거구,6414004,4140,광주시,검색된 결과가 없습니다.
4100,경기도,포천시가선거구,6414101,4141,포천시,합계,,65167,34121,9518,3637,9687,3906,4989,31737,2384,31046
4100,경기도,포천시가선거구,6414101,4141,포천시,거소투표,,188,164,58,12,36,15,20,141,23,24
4100,경기도,포천시가선거구,6414101,4141,포천시,관외사전투표,,2915,2912,941,329,918,320,228,2736,176,3
4100,경기도,포천시가선거구,6414101,4141,포천시,군내면,계,6949,3581,928,295,845,358,928,3354,227,3368
4100,경기도,포천시가선거구,6414101,4141,포천시,군내면,관내사전투표,1463,1462,414,114,346,143,348,1365,97,1
4100,경기도,포천시가선거구,6414101,4141,포천시,군내면,선거일투표,5486,2119,514,181,499,215,580,1989,130,3367
4100,경기도,포천시가선거구,6414101,4141,포천시,신북면,계,10292,4842,1243,529,1339,670,676,4457,385,5450
4100,경기도,포천시가선거구,6414101,4141,포천시,신북면,관내사전투표,1643,1636,442,200,415,220,233,1510,126,7
4100,경기도,포천시가선거구,6414101,4141,포천시,신북면,선거일투표,8649,3206,801,329,924,450,443,2947,259,5443
4100,경기도,포천시가선거구,6414101,4141,포천시,창수면,계,1945,1198,342,129,348,133,138,1090,108,747
4100,경기도,포천시가선거구,6414101,4141,포천시,창수면,관내사전투표,564,560,182,60,160,48,64,514,46,4
4100,경기도,포천시가선거구,6414101,4141,포천시,창수면,선거일투표,1381,638,160,69,188,85,74,576,62,743
4100,경기도,포천시가선거구,6414101,4141,포천시,영중면,계,4271,2379,624,268,696,324,263,2175,204,1892
4100,경기도,포천시가선거구,6414101,4141,포천시,영중면,관내사전투표,923,922,231,120,267,125,105,848,74,1
4100,경기도,포천시가선거구,6414101,4141,포천시,영중면,선거일투표,3348,1457,393,148,429,199,158,1327,130,1891
4100,경기도,포천시가선거구,6414101,4141,포천시,영북면,계,6983,3609,986,485,1045,495,278,3289,320,3374
4100,경기도,포천시가선거구,6414101,4141,포천시,영북면,관내사전투표,1312,1305,362,180,372,157,121,1192,113,7
4100,경기도,포천시가선거구,6414101,4141,포천시,영북면,선거일투표,5671,2304,624,305,673,338,157,2097,207,3367
4100,경기도,포천시가선거구,6414101,4141,포천시,관인면,계,2434,1464,406,137,431,206,139,1319,145,970
4100,경기도,포천시가선거구,6414101,4141,포천시,관인면,관내사전투표,569,566,170,49,164,80,58,521,45,3
4100,경기도,포천시가선거구,6414101,4141,포천시,관인면,선거일투표,1865,898,236,88,267,126,81,798,100,967
4100,경기도,포천시가선거구,6414101,4141,포천시,포천동,계,16395,8646,2378,920,2016,909,1971,8194,452,7749
4100,경기도,포천시가선거구,6414101,4141,포천시,포천동,관내사전투표,3723,3714,1111,410,790,354,872,3537,177,9
4100,경기도,포천시가선거구,6414101,4141,포천시,포천동,선거일투표,12672,4932,1267,510,1226,555,1099,4657,275,7740
4100,경기도,포천시가선거구,6414101,4141,포천시,선단동,계,12795,5285,1602,530,2004,470,339,4945,340,7510
4100,경기도,포천시가선거구,6414101,4141,포천시,선단동,관내사전투표,2010,2008,606,214,761,166,136,1883,125,2
4100,경기도,포천시가선거구,6414101,4141,포천시,선단동,선거일투표,10785,3277,996,316,1243,304,203,3062,215,7508
4100,경기도,포천시가선거구,6414101,4141,포천시,잘못 투입·구분된 투표지,,0,41,10,3,9,6,9,37,4,-41
4100,경기도,포천시나선거구,6414102,4141,포천시,합계,,66813,33630,6984,6605,8004,5533,2399,1510,31035,2595,33183
4100,경기도,포천시나선거구,6414102,4141,포천시,거소투표,,104,98,33,21,15,14,5,6,94,4,6
4100,경기도,포천시나선거구,6414102,4141,포천시,관외사전투표,,3102,3098,847,551,821,413,172,94,2898,200,4
4100,경기도,포천시나선거구,6414102,4141,포천시,소흘읍,계,37065,17100,3758,3513,3528,2375,1786,917,15877,1223,19965
4100,경기도,포천시나선거구,6414102,4141,포천시,소흘읍,관내사전투표,5694,5693,1290,1273,1083,789,576,302,5313,380,1
4100,경기도,포천시나선거구,6414102,4141,포천시,소흘읍,선거일투표,31371,11407,2468,2240,2445,1586,1210,615,10564,843,19964
4100,경기도,포천시나선거구,6414102,4141,포천시,내촌면,계,4151,2153,405,278,577,369,44,269,1942,211,1998
4100,경기도,포천시나선거구,6414102,4141,포천시,내촌면,관내사전투표,934,932,197,123,242,165,17,111,855,77,2
4100,경기도,포천시나선거구,6414102,4141,포천시,내촌면,선거일투표,3217,1221,208,155,335,204,27,158,1087,134,1996
4100,경기도,포천시나선거구,6414102,4141,포천시,가산면,계,6832,3413,602,421,705,1172,98,91,3089,324,3419
4100,경기도,포천시나선거구,6414102,4141,포천시,가산면,관내사전투표,1423,1422,235,176,314,479,36,39,1279,143,1
4100,경기도,포천시나선거구,6414102,4141,포천시,가산면,선거일투표,5409,1991,367,245,391,693,62,52,1810,181,3418
4100,경기도,포천시나선거구,6414102,4141,포천시,일동면,계,8127,4121,696,980,1199,705,161,69,3810,311,4006
4100,경기도,포천시나선거구,6414102,4141,포천시,일동면,관내사전투표,1440,1440,259,375,361,230,73,29,1327,113,0
4100,경기도,포천시나선거구,6414102,4141,포천시,일동면,선거일투표,6687,2681,437,605,838,475,88,40,2483,198,4006
4100,경기도,포천시나선거구,6414102,4141,포천시,이동면,계,5136,2443,433,600,772,280,80,45,2210,233,2693
4100,경기도,포천시나선거구,6414102,4141,포천시,이동면,관내사전투표,788,788,149,214,237,73,27,15,715,73,0
4100,경기도,포천시나선거구,6414102,4141,포천시,이동면,선거일투표,4348,1655,284,386,535,207,53,30,1495,160,2693
4100,경기도,포천시나선거구,6414102,4141,포천시,화현면,계,2296,1188,204,240,385,204,51,19,1103,85,1108
4100,경기도,포천시나선거구,6414102,4141,포천시,화현면,관내사전투표,499,498,91,98,157,84,16,11,457,41,1
4100,경기도,포천시나선거구,6414102,4141,포천시,화현면,선거일투표,1797,690,113,142,228,120,35,8,646,44,1107
4100,경기도,포천시나선거구,6414102,4141,포천시,잘못 투입·구분된 투표지,,0,16,6,1,2,1,2,0,12,4,-16
4100,경기도,연천군가선거구,6414201,4142,연천군,합계,,14864,9329,1989,1248,2587,2572,8396,933,5535
4100,경기도,연천군가선거구,6414201,4142,연천군,거소투표,,177,173,58,15,60,17,150,23,4
4100,경기도,연천군가선거구,6414201,4142,연천군,관외사전투표,,1077,1077,286,160,309,203,958,119,0
4100,경기도,연천군가선거구,6414201,4142,연천군,연천읍,계,6070,3415,702,509,777,1112,3100,315,2655
4100,경기도,연천군가선거구,6414201,4142,연천군,연천읍,관내사전투표,1128,1128,244,167,249,354,1014,114,0
4100,경기도,연천군가선거구,6414201,4142,연천군,연천읍,선거일투표,4942,2287,458,342,528,758,2086,201,2655
4100,경기도,연천군가선거구,6414201,4142,연천군,군남면,계,2640,1570,286,178,539,369,1372,198,1070
4100,경기도,연천군가선거구,6414201,4142,연천군,군남면,관내사전투표,347,347,82,53,114,81,330,17,0
4100,경기도,연천군가선거구,6414201,4142,연천군,군남면,선거일투표,2293,1223,204,125,425,288,1042,181,1070
4100,경기도,연천군가선거구,6414201,4142,연천군,미산면,계,1401,820,128,110,266,227,731,89,581
4100,경기도,연천군가선거구,6414201,4142,연천군,미산면,관내사전투표,304,304,52,55,102,81,290,14,0
4100,경기도,연천군가선거구,6414201,4142,연천군,미산면,선거일투표,1097,516,76,55,164,146,441,75,581
4100,경기도,연천군가선거구,6414201,4142,연천군,왕징면,계,937,656,132,87,214,157,590,66,281
4100,경기도,연천군가선거구,6414201,4142,연천군,왕징면,관내사전투표,232,232,43,33,75,54,205,27,0
4100,경기도,연천군가선거구,6414201,4142,연천군,왕징면,선거일투표,705,424,89,54,139,103,385,39,281
4100,경기도,연천군가선거구,6414201,4142,연천군,신서면,계,2386,1508,372,179,400,444,1395,113,878
4100,경기도,연천군가선거구,6414201,4142,연천군,신서면,관내사전투표,517,517,126,65,145,136,472,45,0
4100,경기도,연천군가선거구,6414201,4142,연천군,신서면,선거일투표,1869,991,246,114,255,308,923,68,878
4100,경기도,연천군가선거구,6414201,4142,연천군,중면,계,176,109,25,10,21,43,99,10,67
4100,경기도,연천군가선거구,6414201,4142,연천군,중면,관내사전투표,48,48,17,4,9,17,47,1,0
4100,경기도,연천군가선거구,6414201,4142,연천군,중면,선거일투표,128,61,8,6,12,26,52,9,67
4100,경기도,연천군가선거구,6414201,4142,연천군,잘못 투입·구분된 투표지,,0,1,0,0,1,0,1,0,-1
4100,경기도,연천군나선거구,6414202,4142,연천군,합계,,23034,13464,2288,1376,3643,1896,1270,442,734,934,12583,881,9570
4100,경기도,연천군나선거구,6414202,4142,연천군,거소투표,,164,159,26,22,41,13,12,7,19,7,147,12,5
4100,경기도,연천군나선거구,6414202,4142,연천군,관외사전투표,,1426,1426,337,147,447,150,118,27,53,42,1321,105,0
4100,경기도,연천군나선거구,6414202,4142,연천군,전곡읍,계,14953,8110,1338,901,2291,919,929,345,591,289,7603,507,6843
4100,경기도,연천군나선거구,6414202,4142,연천군,전곡읍,관내사전투표,2871,2871,488,344,786,294,347,117,205,113,2694,177,0
4100,경기도,연천군나선거구,6414202,4142,연천군,전곡읍,선거일투표,12082,5239,850,557,1505,625,582,228,386,176,4909,330,6843
4100,경기도,연천군나선거구,6414202,4142,연천군,청산면,계,3588,2027,300,177,539,500,131,44,59,133,1883,144,1561
4100,경기도,연천군나선거구,6414202,4142,연천군,청산면,관내사전투표,596,596,90,60,174,135,31,10,30,36,566,30,0
4100,경기도,연천군나선거구,6414202,4142,연천군,청산면,선거일투표,2992,1431,210,117,365,365,100,34,29,97,1317,114,1561
4100,경기도,연천군나선거구,6414202,4142,연천군,백학면,계,2243,1310,205,95,225,243,52,17,8,378,1223,87,933
4100,경기도,연천군나선거구,6414202,4142,연천군,백학면,관내사전투표,474,474,93,47,88,87,23,2,4,107,451,23,0
4100,경기도,연천군나선거구,6414202,4142,연천군,백학면,선거일투표,1769,836,112,48,137,156,29,15,4,271,772,64,933
4100,경기도,연천군나선거구,6414202,4142,연천군,장남면,계,660,432,82,34,100,71,28,2,4,85,406,26,228
4100,경기도,연천군나선거구,6414202,4142,연천군,장남면,관내사전투표,140,140,32,16,34,22,12,1,2,14,133,7,0
4100,경기도,연천군나선거구,6414202,4142,연천군,장남면,선거일투표,520,292,50,18,66,49,16,1,2,71,273,19,228
4100,경기도,연천군나선거구,6414202,4142,연천군,잘못 투입·구분된 투표지,,0,0,0,0,0,0,0,0,0,0,0,0,0
4100,경기도,양평군가선거구,6414301,4143,양평군,합계,,55511,32311,7893,4186,9545,5469,1699,1093,29885,2426,23200
4100,경기도,양평군가선거구,6414301,4143,양평군,거소투표,,132,125,36,11,26,17,3,1,94,31,7
4100,경기도,양평군가선거구,6414301,4143,양평군,관외사전투표,,4502,4502,1214,510,1330,790,203,119,4166,336,0
4100,경기도,양평군가선거구,6414301,4143,양평군,양평읍,계,24325,12917,2844,2110,3143,2540,804,587,12028,889,11408
4100,경기도,양평군가선거구,6414301,4143,양평군,양평읍,관내사전투표,4496,4487,1096,757,1089,821,240,190,4193,294,9
4100,경기도,양평군가선거구,6414301,4143,양평군,양평읍,선거일투표,19829,8430,1748,1353,2054,1719,564,397,7835,595,11399
4100,경기도,양평군가선거구,6414301,4143,양평군,양서면,계,11366,6015,1600,606,2001,892,270,169,5538,477,5351
4100,경기도,양평군가선거구,6414301,4143,양평군,양서면,관내사전투표,1959,1952,529,244,657,239,76,52,1797,155,7
4100,경기도,양평군가선거구,6414301,4143,양평군,양서면,선거일투표,9407,4063,1071,362,1344,653,194,117,3741,322,5344
4100,경기도,양평군가선거구,6414301,4143,양평군,옥천면,계,7329,4418,1214,551,1226,720,174,156,4041,377,2911
4100,경기도,양평군가선거구,6414301,4143,양평군,옥천면,관내사전투표,2221,2220,640,292,610,351,83,80,2056,164,1
4100,경기도,양평군가선거구,6414301,4143,양평군,옥천면,선거일투표,5108,2198,574,259,616,369,91,76,1985,213,2910
4100,경기도,양평군가선거구,6414301,4143,양평군,서종면,계,7857,4315,980,395,1814,508,244,60,4001,314,3542
4100,경기도,양평군가선거구,6414301,4143,양평군,서종면,관내사전투표,1477,1474,374,161,573,159,94,21,1382,92,3
4100,경기도,양평군가선거구,6414301,4143,양평군,서종면,선거일투표,6380,2841,606,234,1241,349,150,39,2619,222,3539
4100,경기도,양평군가선거구,6414301,4143,양평군,잘못 투입·구분된 투표지,,0,19,5,3,5,2,1,1,17,2,-19
4100,경기도,양평군나선거구,6414302,4143,양평군,합계,,51654,31102,8117,4395,10348,5031,633,28524,2578,20552
4100,경기도,양평군나선거구,6414302,4143,양평군,거소투표,,107,96,34,13,24,10,3,84,12,11
4100,경기도,양평군나선거구,6414302,4143,양평군,관외사전투표,,3498,3497,1071,369,1146,571,73,3230,267,1
4100,경기도,양평군나선거구,6414302,4143,양평군,강상면,계,8096,4571,1428,609,1451,636,73,4197,374,3525
4100,경기도,양평군나선거구,6414302,4143,양평군,강상면,관내사전투표,1858,1856,590,253,606,222,30,1701,155,2
4100,경기도,양평군나선거구,6414302,4143,양평군,강상면,선거일투표,6238,2715,838,356,845,414,43,2496,219,3523
4100,경기도,양평군나선거구,6414302,4143,양평군,강하면,계,4115,2389,598,226,1073,286,28,2211,178,1726
4100,경기도,양평군나선거구,6414302,4143,양평군,강하면,관내사전투표,1027,1023,279,112,438,105,10,944,79,4
4100,경기도,양평군나선거구,6414302,4143,양평군,강하면,선거일투표,3088,1366,319,114,635,181,18,1267,99,1722
4100,경기도,양평군나선거구,6414302,4143,양평군,단월면,계,3412,2047,460,361,673,344,44,1882,165,1365
4100,경기도,양평군나선거구,6414302,4143,양평군,단월면,관내사전투표,948,944,226,176,314,143,18,877,67,4
4100,경기도,양평군나선거구,6414302,4143,양평군,단월면,선거일투표,2464,1103,234,185,359,201,26,1005,98,1361
4100,경기도,양평군나선거구,6414302,4143,양평군,청운면,계,3380,2058,442,348,686,322,57,1855,203,1322
4100,경기도,양평군나선거구,6414302,4143,양평군,청운면,관내사전투표,952,949,227,159,298,149,20,853,96,3
4100,경기도,양평군나선거구,6414302,4143,양평군,청운면,선거일투표,2428,1109,215,189,388,173,37,1002,107,1319
4100,경기도,양평군나선거구,6414302,4143,양평군,양동면,계,3984,2312,532,339,900,299,41,2111,201,1672
4100,경기도,양평군나선거구,6414302,4143,양평군,양동면,관내사전투표,1092,1091,260,165,436,131,17,1009,82,1
4100,경기도,양평군나선거구,6414302,4143,양평군,양동면,선거일투표,2892,1221,272,174,464,168,24,1102,119,1671
4100,경기도,양평군나선거구,6414302,4143,양평군,지평면,계,6030,3553,858,500,1296,499,88,3241,312,2477
4100,경기도,양평군나선거구,6414302,4143,양평군,지평면,관내사전투표,1400,1384,395,195,461,190,29,1270,114,16
4100,경기도,양평군나선거구,6414302,4143,양평군,지평면,선거일투표,4630,2169,463,305,835,309,59,1971,198,2461
4100,경기도,양평군나선거구,6414302,4143,양평군,용문면,계,14595,7945,2032,1295,2170,1678,155,7330,615,6650
4100,경기도,양평군나선거구,6414302,4143,양평군,용문면,관내사전투표,2676,2669,791,448,737,462,30,2468,201,7
4100,경기도,양평군나선거구,6414302,4143,양평군,용문면,선거일투표,11919,5276,1241,847,1433,1216,125,4862,414,6643
4100,경기도,양평군나선거구,6414302,4143,양평군,개군면,계,4437,2593,649,329,916,383,70,2347,246,1844
4100,경기도,양평군나선거구,6414302,4143,양평군,개군면,관내사전투표,949,949,242,121,330,136,22,851,98,0
4100,경기도,양평군나선거구,6414302,4143,양평군,개군면,선거일투표,3488,1644,407,208,586,247,48,1496,148,1844
4100,경기도,양평군나선거구,6414302,4143,양평군,잘못 투입·구분된 투표지,,0,41,13,6,13,3,1,36,5,-41
4100,경기도,가평군가선거구,6414401,4144,가평군,합계,,20688,12666,3676,4889,2840,718,12123,543,8022
4100,경기도,가평군가선거구,6414401,4144,가평군,거소투표,,33,32,11,13,6,2,32,0,1
4100,경기도,가평군가선거구,6414401,4144,가평군,관외사전투표,,1065,1065,393,476,128,31,1028,37,0
4100,경기도,가평군가선거구,6414401,4144,가평군,가평읍,계,16262,9570,2607,3611,2428,517,9163,407,6692
4100,경기도,가평군가선거구,6414401,4144,가평군,가평읍,관내사전투표,3695,3679,1163,1231,974,181,3549,130,16
4100,경기도,가평군가선거구,6414401,4144,가평군,가평읍,선거일투표,12567,5891,1444,2380,1454,336,5614,277,6676
4100,경기도,가평군가선거구,6414401,4144,가평군,북면,계,3328,1977,656,784,272,167,1879,98,1351
4100,경기도,가평군가선거구,6414401,4144,가평군,북면,관내사전투표,726,726,264,280,98,62,704,22,0
4100,경기도,가평군가선거구,6414401,4144,가평군,북면,선거일투표,2602,1251,392,504,174,105,1175,76,1351
4100,경기도,가평군가선거구,6414401,4144,가평군,잘못 투입·구분된 투표지,,0,22,9,5,6,1,21,1,-22
4100,경기도,가평군나선거구,6414402,4144,가평군,합계,,21367,12374,3615,6211,1414,69,748,12057,317,8993
4100,경기도,가평군나선거구,6414402,4144,가평군,거소투표,,27,23,10,10,0,0,3,23,0,4
4100,경기도,가평군나선거구,6414402,4144,가평군,관외사전투표,,1316,1316,486,648,119,5,40,1298,18,0
4100,경기도,가평군나선거구,6414402,4144,가평군,설악면,계,8159,4426,1083,1802,906,16,506,4313,113,3733
4100,경기도,가평군나선거구,6414402,4144,가평군,설악면,관내사전투표,1810,1807,447,760,324,5,230,1766,41,3
4100,경기도,가평군나선거구,6414402,4144,가평군,설악면,선거일투표,6349,2619,636,1042,582,11,276,2547,72,3730
4100,경기도,가평군나선거구,6414402,4144,가평군,청평면,계,11865,6599,2032,3745,389,48,199,6413,186,5266
4100,경기도,가평군나선거구,6414402,4144,가평군,청평면,관내사전투표,2270,2263,760,1241,140,9,64,2214,49,7
4100,경기도,가평군나선거구,6414402,4144,가평군,청평면,선거일투표,9595,4336,1272,2504,249,39,135,4199,137,5259
4100,경기도,가평군나선거구,6414402,4144,가평군,잘못 투입·구분된 투표지,,0,10,4,6,0,0,0,10,0,-10
4100,경기도,가평군다선거구,6414403,4144,가평군,합계,,13736,8119,2340,3370,1937,7647,472,5617
4100,경기도,가평군다선거구,6414403,4144,가평군,거소투표,,291,273,129,87,35,251,22,18
4100,경기도,가평군다선거구,6414403,4144,가평군,관외사전투표,,769,769,279,390,78,747,22,0
4100,경기도,가평군다선거구,6414403,4144,가평군,상면,계,4982,2881,716,1671,369,2756,125,2101
4100,경기도,가평군다선거구,6414403,4144,가평군,상면,관내사전투표,1006,1006,275,548,132,955,51,0
4100,경기도,가평군다선거구,6414403,4144,가평군,상면,선거일투표,3976,1875,441,1123,237,1801,74,2101
4100,경기도,가평군다선거구,6414403,4144,가평군,조종면,계,7694,4194,1216,1222,1454,3892,302,3500
4100,경기도,가평군다선거구,6414403,4144,가평군,조종면,관내사전투표,1449,1447,449,396,512,1357,90,2
4100,경기도,가평군다선거구,6414403,4144,가평군,조종면,선거일투표,6245,2747,767,826,942,2535,212,3498
4100,경기도,가평군다선거구,6414403,4144,가평군,잘못 투입·구분된 투표지,,0,2,0,0,1,1,1,-24200,강원도,춘천시가선거구,6420101,4201,춘천시,합계,,43250,25103,4905,3373,1296,6209,4724,1942,791,368,23608,1495,18147
4200,강원도,춘천시가선거구,6420101,4201,춘천시,거소투표,,113,107,12,9,10,18,22,8,4,4,87,20,6
4200,강원도,춘천시가선거구,6420101,4201,춘천시,관외사전투표,,3219,3219,805,451,150,774,542,152,81,48,3003,216,0
4200,강원도,춘천시가선거구,6420101,4201,춘천시,동산면,계,1285,765,120,80,19,157,266,52,21,6,721,44,520
4200,강원도,춘천시가선거구,6420101,4201,춘천시,동산면,관내사전투표,275,275,52,38,9,49,87,15,8,1,259,16,0
4200,강원도,춘천시가선거구,6420101,4201,춘천시,동산면,선거일투표,1010,490,68,42,10,108,179,37,13,5,462,28,520
4200,강원도,춘천시가선거구,6420101,4201,춘천시,신동면,계,2393,1428,258,150,53,355,372,76,44,21,1329,99,965
4200,강원도,춘천시가선거구,6420101,4201,춘천시,신동면,관내사전투표,672,672,150,86,30,163,136,34,17,10,626,46,0
4200,강원도,춘천시가선거구,6420101,4201,춘천시,신동면,선거일투표,1721,756,108,64,23,192,236,42,27,11,703,53,965
4200,강원도,춘천시가선거구,6420101,4201,춘천시,동내면,계,13421,7032,1338,1091,250,1011,1702,878,278,80,6628,404,6389
4200,강원도,춘천시가선거구,6420101,4201,춘천시,동내면,관내사전투표,2006,2006,390,326,54,312,488,226,66,14,1876,130,0
4200,강원도,춘천시가선거구,6420101,4201,춘천시,동내면,선거일투표,11415,5026,948,765,196,699,1214,652,212,66,4752,274,6389
4200,강원도,춘천시가선거구,6420101,4201,춘천시,남면,계,921,540,90,46,13,180,134,22,10,8,503,37,381
4200,강원도,춘천시가선거구,6420101,4201,춘천시,남면,관내사전투표,244,244,38,28,3,74,65,12,5,4,229,15,0
4200,강원도,춘천시가선거구,6420101,4201,춘천시,남면,선거일투표,677,296,52,18,10,106,69,10,5,4,274,22,381
4200,강원도,춘천시가선거구,6420101,4201,춘천시,남산면,계,3010,1619,280,140,48,466,406,64,24,68,1496,123,1391
4200,강원도,춘천시가선거구,6420101,4201,춘천시,남산면,관내사전투표,498,498,92,53,12,127,119,19,5,28,455,43,0
4200,강원도,춘천시가선거구,6420101,4201,춘천시,남산면,선거일투표,2512,1121,188,87,36,339,287,45,19,40,1041,80,1391
4200,강원도,춘천시가선거구,6420101,4201,춘천시,강남동,계,18888,10393,2002,1406,753,3248,1280,690,329,133,9841,552,8495
4200,강원도,춘천시가선거구,6420101,4201,춘천시,강남동,관내사전투표,3241,3241,596,450,235,1041,426,218,95,38,3099,142,0
4200,강원도,춘천시가선거구,6420101,4201,춘천시,강남동,선거일투표,15647,7152,1406,956,518,2207,854,472,234,95,6742,410,8495
4200,강원도,춘천시가선거구,6420101,4201,춘천시,잘못 투입·구분된 투표지,,0,0,0,0,0,0,0,0,0,0,0,0,0
4200,강원도,춘천시나선거구,6420102,4201,춘천시,합계,,31587,17345,5273,2021,5687,2556,817,16354,991,14242
4200,강원도,춘천시나선거구,6420102,4201,춘천시,거소투표,,69,61,18,8,18,5,4,53,8,8
4200,강원도,춘천시나선거구,6420102,4201,춘천시,관외사전투표,,2096,2088,769,276,647,219,84,1995,93,8
4200,강원도,춘천시나선거구,6420102,4201,춘천시,소양동,계,7271,4114,1311,478,1144,724,223,3880,234,3157
4200,강원도,춘천시나선거구,6420102,4201,춘천시,소양동,관내사전투표,1656,1656,576,182,433,279,94,1564,92,0
4200,강원도,춘천시나선거구,6420102,4201,춘천시,소양동,선거일투표,5615,2458,735,296,711,445,129,2316,142,3157
4200,강원도,춘천시나선거구,6420102,4201,춘천시,교동,계,3241,1603,443,206,547,254,61,1511,92,1638
4200,강원도,춘천시나선거구,6420102,4201,춘천시,교동,관내사전투표,767,767,218,113,233,119,34,717,50,0
4200,강원도,춘천시나선거구,6420102,4201,춘천시,교동,선거일투표,2474,836,225,93,314,135,27,794,42,1638
4200,강원도,춘천시나선거구,6420102,4201,춘천시,조운동,계,2486,1292,319,125,476,206,61,1187,105,1194
4200,강원도,춘천시나선거구,6420102,4201,춘천시,조운동,관내사전투표,633,633,162,55,221,105,34,577,56,0
4200,강원도,춘천시나선거구,6420102,4201,춘천시,조운동,선거일투표,1853,659,157,70,255,101,27,610,49,1194
4200,강원도,춘천시나선거구,6420102,4201,춘천시,약사명동,계,2740,1483,457,163,524,200,70,1414,69,1257
4200,강원도,춘천시나선거구,6420102,4201,춘천시,약사명동,관내사전투표,654,655,204,67,232,93,29,625,30,-1
4200,강원도,춘천시나선거구,6420102,4201,춘천시,약사명동,선거일투표,2086,828,253,96,292,107,41,789,39,1258
4200,강원도,춘천시나선거구,6420102,4201,춘천시,근화동,계,6132,2766,776,332,925,411,167,2611,155,3366
4200,강원도,춘천시나선거구,6420102,4201,춘천시,근화동,관내사전투표,881,878,237,107,309,140,38,831,47,3
4200,강원도,춘천시나선거구,6420102,4201,춘천시,근화동,선거일투표,5251,1888,539,225,616,271,129,1780,108,3363
4200,강원도,춘천시나선거구,6420102,4201,춘천시,효자1동,계,3749,2180,652,251,769,284,84,2040,140,1569
4200,강원도,춘천시나선거구,6420102,4201,춘천시,효자1동,관내사전투표,1106,1105,320,140,390,141,44,1035,70,1
4200,강원도,춘천시나선거구,6420102,4201,춘천시,효자1동,선거일투표,2643,1075,332,111,379,143,40,1005,70,1568
4200,강원도,춘천시나선거구,6420102,4201,춘천시,효자3동,계,3803,1741,524,180,629,251,63,1647,94,2062
4200,강원도,춘천시나선거구,6420102,4201,춘천시,효자3동,관내사전투표,727,726,238,80,262,90,22,692,34,1
4200,강원도,춘천시나선거구,6420102,4201,춘천시,효자3동,선거일투표,3076,1015,286,100,367,161,41,955,60,2061
4200,강원도,춘천시나선거구,6420102,4201,춘천시,잘못 투입·구분된 투표지,,0,17,4,2,8,2,0,16,1,-17
4200,강원도,춘천시다선거구,6420103,4201,춘천시,합계,,40067,21536,5322,3687,5428,3976,2007,20420,1116,18531
4200,강원도,춘천시다선거구,6420103,4201,춘천시,거소투표,,103,99,21,16,26,18,6,87,12,4
4200,강원도,춘천시다선거구,6420103,4201,춘천시,관외사전투표,,2799,2795,845,509,645,386,265,2650,145,4
4200,강원도,춘천시다선거구,6420103,4201,춘천시,후평1동,계,9824,4755,1193,623,1334,978,351,4479,276,5069
4200,강원도,춘천시다선거구,6420103,4201,춘천시,후평1동,관내사전투표,1895,1886,537,254,488,359,133,1771,115,9
4200,강원도,춘천시다선거구,6420103,4201,춘천시,후평1동,선거일투표,7929,2869,656,369,846,619,218,2708,161,5060
4200,강원도,춘천시다선거구,6420103,4201,춘천시,후평2동,계,11162,5571,1304,938,1260,1176,620,5298,273,5591
4200,강원도,춘천시다선거구,6420103,4201,춘천시,후평2동,관내사전투표,2276,2266,516,435,518,428,260,2157,109,10
4200,강원도,춘천시다선거구,6420103,4201,춘천시,후평2동,선거일투표,8886,3305,788,503,742,748,360,3141,164,5581
4200,강원도,춘천시다선거구,6420103,4201,춘천시,후평3동,계,16179,8287,1948,1599,2157,1412,762,7878,409,7892
4200,강원도,춘천시다선거구,6420103,4201,춘천시,후평3동,관내사전투표,2776,2774,666,553,717,446,239,2621,153,2
4200,강원도,춘천시다선거구,6420103,4201,춘천시,후평3동,선거일투표,13403,5513,1282,1046,1440,966,523,5257,256,7890
4200,강원도,춘천시다선거구,6420103,4201,춘천시,잘못 투입·구분된 투표지,,0,29,11,2,6,6,3,28,1,-29
4200,강원도,춘천시라선거구,6420104,4201,춘천시,합계,,40177,21939,4823,3163,6952,2149,3456,265,20808,1131,18238
4200,강원도,춘천시라선거구,6420104,4201,춘천시,거소투표,,134,125,31,13,40,13,5,10,112,13,9
4200,강원도,춘천시라선거구,6420104,4201,춘천시,관외사전투표,,3640,3638,975,614,988,276,585,16,3454,184,2
4200,강원도,춘천시라선거구,6420104,4201,춘천시,효자2동,계,10208,4452,950,591,1578,482,401,177,4179,273,5756
4200,강원도,춘천시라선거구,6420104,4201,춘천시,효자2동,관내사전투표,1340,1340,290,207,518,121,110,27,1273,67,0
4200,강원도,춘천시라선거구,6420104,4201,춘천시,효자2동,선거일투표,8868,3112,660,384,1060,361,291,150,2906,206,5756
4200,강원도,춘천시라선거구,6420104,4201,춘천시,석사동,계,26195,13721,2867,1945,4344,1378,2464,62,13060,661,12474
4200,강원도,춘천시라선거구,6420104,4201,춘천시,석사동,관내사전투표,3229,3228,658,488,1004,268,624,10,3052,176,1
4200,강원도,춘천시라선거구,6420104,4201,춘천시,석사동,선거일투표,22966,10493,2209,1457,3340,1110,1840,52,10008,485,12473
4200,강원도,춘천시라선거구,6420104,4201,춘천시,잘못 투입·구분된 투표지,,0,3,0,0,2,0,1,0,3,0,-3
4200,강원도,춘천시마선거구,6420105,4201,춘천시,합계,,39901,23348,5284,3861,5104,4276,3663,22188,1160,16553
4200,강원도,춘천시마선거구,6420105,4201,춘천시,거소투표,,66,63,14,6,17,15,7,59,4,3
4200,강원도,춘천시마선거구,6420105,4201,춘천시,관외사전투표,,4234,4227,1138,731,800,652,720,4041,186,7
4200,강원도,춘천시마선거구,6420105,4201,춘천시,퇴계동,계,35601,19036,4123,3123,4281,3605,2936,18068,968,16565
4200,강원도,춘천시마선거구,6420105,4201,춘천시,퇴계동,관내사전투표,3504,3495,743,641,789,649,493,3315,180,9
4200,강원도,춘천시마선거구,6420105,4201,춘천시,퇴계동,선거일투표,32097,15541,3380,2482,3492,2956,2443,14753,788,16556
4200,강원도,춘천시마선거구,6420105,4201,춘천시,잘못 투입·구분된 투표지,,0,22,9,1,6,4,0,20,2,-22
4200,강원도,춘천시바선거구,6420106,4201,춘천시,합계,,23290,13621,5469,5073,1852,660,13054,567,9669
4200,강원도,춘천시바선거구,6420106,4201,춘천시,거소투표,,73,70,36,22,6,4,68,2,3
4200,강원도,춘천시바선거구,6420106,4201,춘천시,관외사전투표,,2364,2363,1104,779,283,112,2278,85,1
4200,강원도,춘천시바선거구,6420106,4201,춘천시,신북읍,계,6579,3741,1323,1264,750,211,3548,193,2838
4200,강원도,춘천시바선거구,6420106,4201,춘천시,신북읍,관내사전투표,1203,1203,429,400,232,78,1139,64,0
4200,강원도,춘천시바선거구,6420106,4201,춘천시,신북읍,선거일투표,5376,2538,894,864,518,133,2409,129,2838
4200,강원도,춘천시바선거구,6420106,4201,춘천시,동면,계,13467,6943,2900,2694,769,323,6686,257,6524
4200,강원도,춘천시바선거구,6420106,4201,춘천시,동면,관내사전투표,1517,1513,677,584,179,39,1479,34,4
4200,강원도,춘천시바선거구,6420106,4201,춘천시,동면,선거일투표,11950,5430,2223,2110,590,284,5207,223,6520
4200,강원도,춘천시바선거구,6420106,4201,춘천시,북산면,계,807,492,101,312,43,10,466,26,315
4200,강원도,춘천시바선거구,6420106,4201,춘천시,북산면,관내사전투표,231,231,52,145,20,6,223,8,0
4200,강원도,춘천시바선거구,6420106,4201,춘천시,북산면,선거일투표,576,261,49,167,23,4,243,18,315
4200,강원도,춘천시바선거구,6420106,4201,춘천시,잘못 투입·구분된 투표지,,0,12,5,2,1,0,8,4,-12
4200,강원도,춘천시사선거구,6420107,4201,춘천시,검색된 결과가 없습니다.
4200,강원도,원주시가선거구,6420201,4202,원주시,합계,,42002,21182,4081,2457,2905,5065,3344,2220,20072,1110,20820
4200,강원도,원주시가선거구,6420201,4202,원주시,거소투표,,50,46,11,3,11,8,6,2,41,5,4
4200,강원도,원주시가선거구,6420201,4202,원주시,관외사전투표,,2705,2704,601,378,336,786,225,255,2581,123,1
4200,강원도,원주시가선거구,6420201,4202,원주시,문막읍,계,15231,6876,1376,551,1349,1285,1800,126,6487,389,8355
4200,강원도,원주시가선거구,6420201,4202,원주시,문막읍,관내사전투표,2516,2516,536,213,474,479,633,47,2382,134,0
4200,강원도,원주시가선거구,6420201,4202,원주시,문막읍,선거일투표,12715,4360,840,338,875,806,1167,79,4105,255,8355
4200,강원도,원주시가선거구,6420201,4202,원주시,지정면,계,20092,9258,1767,1321,901,2301,773,1794,8857,401,10834
4200,강원도,원주시가선거구,6420201,4202,원주시,지정면,관내사전투표,2222,2218,450,339,213,554,232,312,2100,118,4
4200,강원도,원주시가선거구,6420201,4202,원주시,지정면,선거일투표,17870,7040,1317,982,688,1747,541,1482,6757,283,10830
4200,강원도,원주시가선거구,6420201,4202,원주시,부론면,계,1994,1191,137,106,178,314,322,13,1070,121,803
4200,강원도,원주시가선거구,6420201,4202,원주시,부론면,관내사전투표,514,514,50,53,84,136,135,3,461,53,0
4200,강원도,원주시가선거구,6420201,4202,원주시,부론면,선거일투표,1480,677,87,53,94,178,187,10,609,68,803
4200,강원도,원주시가선거구,6420201,4202,원주시,귀래면,계,1930,1105,189,98,130,369,218,30,1034,71,825
4200,강원도,원주시가선거구,6420201,4202,원주시,귀래면,관내사전투표,465,465,85,43,56,145,94,14,437,28,0
4200,강원도,원주시가선거구,6420201,4202,원주시,귀래면,선거일투표,1465,640,104,55,74,224,124,16,597,43,825
4200,강원도,원주시가선거구,6420201,4202,원주시,잘못 투입·구분된 투표지,,0,2,0,0,0,2,0,0,2,0,-2
4200,강원도,원주시나선거구,6420202,4202,원주시,합계,,31613,16871,5579,3177,7603,16359,512,14742
4200,강원도,원주시나선거구,6420202,4202,원주시,거소투표,,53,47,16,9,17,42,5,6
4200,강원도,원주시나선거구,6420202,4202,원주시,관외사전투표,,2466,2448,852,467,1071,2390,58,18
4200,강원도,원주시나선거구,6420202,4202,원주시,호저면,계,3194,1718,396,233,992,1621,97,1476
4200,강원도,원주시나선거구,6420202,4202,원주시,호저면,관내사전투표,539,533,129,67,297,493,40,6
4200,강원도,원주시나선거구,6420202,4202,원주시,호저면,선거일투표,2655,1185,267,166,695,1128,57,1470
4200,강원도,원주시나선거구,6420202,4202,원주시,무실동,계,25900,12617,4304,2460,5506,12270,347,13283
4200,강원도,원주시나선거구,6420202,4202,원주시,무실동,관내사전투표,3382,3375,1200,676,1423,3299,76,7
4200,강원도,원주시나선거구,6420202,4202,원주시,무실동,선거일투표,22518,9242,3104,1784,4083,8971,271,13276
4200,강원도,원주시나선거구,6420202,4202,원주시,잘못 투입·구분된 투표지,,0,41,11,8,17,36,5,-41
4200,강원도,원주시다선거구,6420203,4202,원주시,합계,,44011,21896,4339,4637,7926,1778,1659,20339,1557,22115
4200,강원도,원주시다선거구,6420203,4202,원주시,거소투표,,67,62,19,11,13,4,7,54,8,5
4200,강원도,원주시다선거구,6420203,4202,원주시,관외사전투표,,2347,2347,588,496,788,167,165,2204,143,0
4200,강원도,원주시다선거구,6420203,4202,원주시,중앙동,계,2469,1333,215,210,592,135,72,1224,109,1136
4200,강원도,원주시다선거구,6420203,4202,원주시,중앙동,관내사전투표,708,708,120,103,317,65,35,640,68,0
4200,강원도,원주시다선거구,6420203,4202,원주시,중앙동,선거일투표,1761,625,95,107,275,70,37,584,41,1136
4200,강원도,원주시다선거구,6420203,4202,원주시,원인동,계,3593,1616,291,316,636,141,90,1474,142,1977
4200,강원도,원주시다선거구,6420203,4202,원주시,원인동,관내사전투표,504,504,86,114,216,33,24,473,31,0
4200,강원도,원주시다선거구,6420203,4202,원주시,원인동,선거일투표,3089,1112,205,202,420,108,66,1001,111,1977
4200,강원도,원주시다선거구,6420203,4202,원주시,일산동,계,7234,3418,619,785,1351,253,144,3152,266,3816
4200,강원도,원주시다선거구,6420203,4202,원주시,일산동,관내사전투표,1238,1236,242,294,489,79,55,1159,77,2
4200,강원도,원주시다선거구,6420203,4202,원주시,일산동,선거일투표,5996,2182,377,491,862,174,89,1993,189,3814
4200,강원도,원주시다선거구,6420203,4202,원주시,태장1동,계,8542,4110,813,897,1454,355,278,3797,313,4432
4200,강원도,원주시다선거구,6420203,4202,원주시,태장1동,관내사전투표,1811,1811,359,397,631,165,131,1683,128,0
4200,강원도,원주시다선거구,6420203,4202,원주시,태장1동,선거일투표,6731,2299,454,500,823,190,147,2114,185,4432
4200,강원도,원주시다선거구,6420203,4202,원주시,태장2동,계,19759,9002,1792,1918,3092,721,903,8426,576,10757
4200,강원도,원주시다선거구,6420203,4202,원주시,태장2동,관내사전투표,2853,2852,577,664,918,219,292,2670,182,1
4200,강원도,원주시다선거구,6420203,4202,원주시,태장2동,선거일투표,16906,6150,1215,1254,2174,502,611,5756,394,10756
4200,강원도,원주시다선거구,6420203,4202,원주시,잘못 투입·구분된 투표지,,0,8,2,4,0,2,0,8,0,-8
4200,강원도,원주시라선거구,6420204,4202,원주시,합계,,40885,20908,5813,3048,5628,4363,660,19512,1396,19977
4200,강원도,원주시라선거구,6420204,4202,원주시,거소투표,,64,57,13,7,10,17,6,53,4,7
4200,강원도,원주시라선거구,6420204,4202,원주시,관외사전투표,,2354,2352,881,325,567,354,80,2207,145,2
4200,강원도,원주시라선거구,6420204,4202,원주시,학성동,계,4321,2263,576,276,680,501,65,2098,165,2058
4200,강원도,원주시라선거구,6420204,4202,원주시,학성동,관내사전투표,1022,1021,259,122,295,235,29,940,81,1
4200,강원도,원주시라선거구,6420204,4202,원주시,학성동,선거일투표,3299,1242,317,154,385,266,36,1158,84,2057
4200,강원도,원주시라선거구,6420204,4202,원주시,단계동,계,23234,11168,2961,1897,3154,2097,326,10435,733,12066
4200,강원도,원주시라선거구,6420204,4202,원주시,단계동,관내사전투표,3641,3637,1001,619,988,660,124,3392,245,4
4200,강원도,원주시라선거구,6420204,4202,원주시,단계동,선거일투표,19593,7531,1960,1278,2166,1437,202,7043,488,12062
4200,강원도,원주시라선거구,6420204,4202,원주시,우산동,계,10912,5051,1375,542,1215,1389,183,4704,347,5861
4200,강원도,원주시라선거구,6420204,4202,원주시,우산동,관내사전투표,1588,1586,485,162,381,395,47,1470,116,2
4200,강원도,원주시라선거구,6420204,4202,원주시,우산동,선거일투표,9324,3465,890,380,834,994,136,3234,231,5859
4200,강원도,원주시라선거구,6420204,4202,원주시,잘못 투입·구분된 투표지,,0,17,7,1,2,5,0,15,2,-17
4200,강원도,원주시마선거구,6420205,4202,원주시,합계,,40115,22062,5631,3068,7291,3936,19926,2136,18053
4200,강원도,원주시마선거구,6420205,4202,원주시,거소투표,,61,55,16,5,14,12,47,8,6
4200,강원도,원주시마선거구,6420205,4202,원주시,관외사전투표,,2680,2677,845,379,784,382,2390,287,3
4200,강원도,원주시마선거구,6420205,4202,원주시,소초면,계,7026,3259,671,327,1483,430,2911,348,3767
4200,강원도,원주시마선거구,6420205,4202,원주시,소초면,관내사전투표,805,801,183,82,358,93,716,85,4
4200,강원도,원주시마선거구,6420205,4202,원주시,소초면,선거일투표,6221,2458,488,245,1125,337,2195,263,3763
4200,강원도,원주시마선거구,6420205,4202,원주시,개운동,계,10252,5173,1270,701,1742,1016,4729,444,5079
4200,강원도,원주시마선거구,6420205,4202,원주시,개운동,관내사전투표,1736,1731,425,260,573,345,1603,128,5
4200,강원도,원주시마선거구,6420205,4202,원주시,개운동,선거일투표,8516,3442,845,441,1169,671,3126,316,5074
4200,강원도,원주시마선거구,6420205,4202,원주시,명륜1동,계,7259,3987,1037,557,1321,688,3603,384,3272
4200,강원도,원주시마선거구,6420205,4202,원주시,명륜1동,관내사전투표,1474,1468,429,222,444,234,1329,139,6
4200,강원도,원주시마선거구,6420205,4202,원주시,명륜1동,선거일투표,5785,2519,608,335,877,454,2274,245,3266
4200,강원도,원주시마선거구,6420205,4202,원주시,봉산동,계,6575,3516,759,609,904,876,3148,368,3059
4200,강원도,원주시마선거구,6420205,4202,원주시,봉산동,관내사전투표,1032,1032,233,180,261,259,933,99,0
4200,강원도,원주시마선거구,6420205,4202,원주시,봉산동,선거일투표,5543,2484,526,429,643,617,2215,269,3059
4200,강원도,원주시마선거구,6420205,4202,원주시,행구동,계,6262,3370,1026,487,1034,530,3077,293,2892
4200,강원도,원주시마선거구,6420205,4202,원주시,행구동,관내사전투표,1332,1332,376,202,411,209,1198,134,0
4200,강원도,원주시마선거구,6420205,4202,원주시,행구동,선거일투표,4930,2038,650,285,623,321,1879,159,2892
4200,강원도,원주시마선거구,6420205,4202,원주시,잘못 투입·구분된 투표지,,0,25,7,3,9,2,21,4,-25
4200,강원도,원주시바선거구,6420206,4202,원주시,합계,,33084,17791,5627,3227,8101,16955,836,15293
4200,강원도,원주시바선거구,6420206,4202,원주시,거소투표,,77,74,15,15,35,65,9,3
4200,강원도,원주시바선거구,6420206,4202,원주시,관외사전투표,,2565,2562,897,505,1094,2496,66,3
4200,강원도,원주시바선거구,6420206,4202,원주시,흥업면,계,8032,3996,1261,729,1792,3782,214,4036
4200,강원도,원주시바선거구,6420206,4202,원주시,흥업면,관내사전투표,1755,1754,557,352,767,1676,78,1
4200,강원도,원주시바선거구,6420206,4202,원주시,흥업면,선거일투표,6277,2242,704,377,1025,2106,136,4035
4200,강원도,원주시바선거구,6420206,4202,원주시,판부면,계,5816,2656,945,428,1190,2563,93,3160
4200,강원도,원주시바선거구,6420206,4202,원주시,판부면,관내사전투표,770,767,293,125,334,752,15,3
4200,강원도,원주시바선거구,6420206,4202,원주시,판부면,선거일투표,5046,1889,652,303,856,1811,78,3157
4200,강원도,원주시바선거구,6420206,4202,원주시,신림면,계,3196,1773,456,229,941,1626,147,1423
4200,강원도,원주시바선거구,6420206,4202,원주시,신림면,관내사전투표,702,700,193,92,385,670,30,2
4200,강원도,원주시바선거구,6420206,4202,원주시,신림면,선거일투표,2494,1073,263,137,556,956,117,1421
4200,강원도,원주시바선거구,6420206,4202,원주시,명륜2동,계,13398,6710,2049,1317,3040,6406,304,6688
4200,강원도,원주시바선거구,6420206,4202,원주시,명륜2동,관내사전투표,2215,2212,654,483,993,2130,82,3
4200,강원도,원주시바선거구,6420206,4202,원주시,명륜2동,선거일투표,11183,4498,1395,834,2047,4276,222,6685
4200,강원도,원주시바선거구,6420206,4202,원주시,잘못 투입·구분된 투표지,,0,20,4,4,9,17,3,-20
4200,강원도,원주시사선거구,6420207,4202,원주시,합계,,37310,18308,7373,2132,8032,17537,771,19002
4200,강원도,원주시사선거구,6420207,4202,원주시,거소투표,,63,55,17,9,26,52,3,8
4200,강원도,원주시사선거구,6420207,4202,원주시,관외사전투표,,3404,3404,1535,447,1335,3317,87,0
4200,강원도,원주시사선거구,6420207,4202,원주시,단구동,계,33843,14842,5818,1676,6667,14161,681,19001
4200,강원도,원주시사선거구,6420207,4202,원주시,단구동,관내사전투표,3954,3950,1635,429,1801,3865,85,4
4200,강원도,원주시사선거구,6420207,4202,원주시,단구동,선거일투표,29889,10892,4183,1247,4866,10296,596,18997
4200,강원도,원주시사선거구,6420207,4202,원주시,잘못 투입·구분된 투표지,,0,7,3,0,4,7,0,-7
4200,강원도,원주시아선거구,6420208,4202,원주시,합계,,35040,18476,6323,3606,3736,2995,700,17360,1116,16564
4200,강원도,원주시아선거구,6420208,4202,원주시,거소투표,,58,55,13,11,8,11,4,47,8,3
4200,강원도,원주시아선거구,6420208,4202,원주시,관외사전투표,,3681,3672,1315,738,726,548,138,3465,207,9
4200,강원도,원주시아선거구,6420208,4202,원주시,반곡관설동,계,31301,14728,4990,2850,3001,2429,557,13827,901,16573
4200,강원도,원주시아선거구,6420208,4202,원주시,반곡관설동,관내사전투표,4224,4214,1475,898,864,625,121,3983,231,10
4200,강원도,원주시아선거구,6420208,4202,원주시,반곡관설동,선거일투표,27077,10514,3515,1952,2137,1804,436,9844,670,16563
4200,강원도,원주시아선거구,6420208,4202,원주시,잘못 투입·구분된 투표지,,0,21,5,7,1,7,1,21,0,-21
4200,강원도,강릉시가선거구,6420301,4203,강릉시,합계,,22447,12630,2420,2483,4784,2000,11687,943,9817
4200,강원도,강릉시가선거구,6420301,4203,강릉시,거소투표,,42,42,9,4,18,6,37,5,0
4200,강원도,강릉시가선거구,6420301,4203,강릉시,관외사전투표,,1627,1623,420,315,572,215,1522,101,4
4200,강원도,강릉시가선거구,6420301,4203,강릉시,성산면,계,3069,1863,219,576,724,188,1707,156,1206
4200,강원도,강릉시가선거구,6420301,4203,강릉시,성산면,관내사전투표,756,756,85,248,302,81,716,40,0
4200,강원도,강릉시가선거구,6420301,4203,강릉시,성산면,선거일투표,2313,1107,134,328,422,107,991,116,1206
4200,강원도,강릉시가선거구,6420301,4203,강릉시,왕산면,계,1357,809,76,158,369,128,731,78,548
4200,강원도,강릉시가선거구,6420301,4203,강릉시,왕산면,관내사전투표,232,231,28,44,114,35,221,10,1
4200,강원도,강릉시가선거구,6420301,4203,강릉시,왕산면,선거일투표,1125,578,48,114,255,93,510,68,547
4200,강원도,강릉시가선거구,6420301,4203,강릉시,구정면,계,3617,2127,296,275,1154,242,1967,160,1490
4200,강원도,강릉시가선거구,6420301,4203,강릉시,구정면,관내사전투표,776,775,103,102,435,92,732,43,1
4200,강원도,강릉시가선거구,6420301,4203,강릉시,구정면,선거일투표,2841,1352,193,173,719,150,1235,117,1489
4200,강원도,강릉시가선거구,6420301,4203,강릉시,내곡동,계,12735,6148,1395,1154,1938,1219,5706,442,6587
4200,강원도,강릉시가선거구,6420301,4203,강릉시,내곡동,관내사전투표,2217,2213,516,417,712,434,2079,134,4
4200,강원도,강릉시가선거구,6420301,4203,강릉시,내곡동,선거일투표,10518,3935,879,737,1226,785,3627,308,6583
4200,강원도,강릉시가선거구,6420301,4203,강릉시,잘못 투입·구분된 투표지,,0,18,5,1,9,2,17,1,-18
4200,강원도,강릉시나선거구,6420302,4203,강릉시,합계,,22874,12828,2251,2262,6504,1055,12072,756,10046
4200,강원도,강릉시나선거구,6420302,4203,강릉시,거소투표,,55,54,6,7,35,6,54,0,1
4200,강원도,강릉시나선거구,6420302,4203,강릉시,관외사전투표,,1466,1458,368,325,648,70,1411,47,8
4200,강원도,강릉시나선거구,6420302,4203,강릉시,강동면,계,3716,2231,253,235,1499,110,2097,134,1485
4200,강원도,강릉시나선거구,6420302,4203,강릉시,강동면,관내사전투표,977,975,113,94,674,41,922,53,2
4200,강원도,강릉시나선거구,6420302,4203,강릉시,강동면,선거일투표,2739,1256,140,141,825,69,1175,81,1483
4200,강원도,강릉시나선거구,6420302,4203,강릉시,옥계면,계,3064,1867,189,169,713,647,1718,149,1197
4200,강원도,강릉시나선거구,6420302,4203,강릉시,옥계면,관내사전투표,883,881,96,83,335,324,838,43,2
4200,강원도,강릉시나선거구,6420302,4203,강릉시,옥계면,선거일투표,2181,986,93,86,378,323,880,106,1195
4200,강원도,강릉시나선거구,6420302,4203,강릉시,강남동,계,14573,7191,1426,1522,3599,219,6766,425,7382
4200,강원도,강릉시나선거구,6420302,4203,강릉시,강남동,관내사전투표,2595,2584,521,559,1330,79,2489,95,11
4200,강원도,강릉시나선거구,6420302,4203,강릉시,강남동,선거일투표,11978,4607,905,963,2269,140,4277,330,7371
4200,강원도,강릉시나선거구,6420302,4203,강릉시,잘못 투입·구분된 투표지,,0,27,9,4,10,3,26,1,-27
4200,강원도,강릉시다선거구,6420303,4203,강릉시,합계,,39142,21572,5724,3585,5402,5205,619,20535,1037,17570
4200,강원도,강릉시다선거구,6420303,4203,강릉시,거소투표,,73,70,11,15,22,18,1,67,3,3
4200,강원도,강릉시다선거구,6420303,4203,강릉시,관외사전투표,,3197,3189,999,540,800,607,99,3045,144,8
4200,강원도,강릉시다선거구,6420303,4203,강릉시,홍제동,계,11536,5925,1567,920,1359,1712,122,5680,245,5611
4200,강원도,강릉시다선거구,6420303,4203,강릉시,홍제동,관내사전투표,1932,1929,464,312,412,629,34,1851,78,3
4200,강원도,강릉시다선거구,6420303,4203,강릉시,홍제동,선거일투표,9604,3996,1103,608,947,1083,88,3829,167,5608
4200,강원도,강릉시다선거구,6420303,4203,강릉시,중앙동,계,4253,2135,409,381,520,700,23,2033,102,2118
4200,강원도,강릉시다선거구,6420303,4203,강릉시,중앙동,관내사전투표,861,861,185,178,202,255,7,827,34,0
4200,강원도,강릉시다선거구,6420303,4203,강릉시,중앙동,선거일투표,3392,1274,224,203,318,445,16,1206,68,2118
4200,강원도,강릉시다선거구,6420303,4203,강릉시,교1동,계,20083,10235,2735,1727,2700,2160,372,9694,541,9848
4200,강원도,강릉시다선거구,6420303,4203,강릉시,교1동,관내사전투표,3195,3190,909,559,810,671,121,3070,120,5
4200,강원도,강릉시다선거구,6420303,4203,강릉시,교1동,선거일투표,16888,7045,1826,1168,1890,1489,251,6624,421,9843
4200,강원도,강릉시다선거구,6420303,4203,강릉시,잘못 투입·구분된 투표지,,0,18,3,2,1,8,2,16,2,-18
4200,강원도,강릉시라선거구,6420304,4203,강릉시,합계,,35862,18741,3729,3955,5905,2456,1631,17676,1065,17121
4200,강원도,강릉시라선거구,6420304,4203,강릉시,거소투표,,69,64,18,7,19,11,5,60,4,5
4200,강원도,강릉시라선거구,6420304,4203,강릉시,관외사전투표,,2183,2179,596,442,627,237,162,2064,115,4
4200,강원도,강릉시라선거구,6420304,4203,강릉시,옥천동,계,3288,1812,343,238,760,235,135,1711,101,1476
4200,강원도,강릉시라선거구,6420304,4203,강릉시,옥천동,관내사전투표,905,901,176,129,359,130,64,858,43,4
4200,강원도,강릉시라선거구,6420304,4203,강릉시,옥천동,선거일투표,2383,911,167,109,401,105,71,853,58,1472
4200,강원도,강릉시라선거구,6420304,4203,강릉시,포남1동,계,8773,4353,825,592,1674,679,341,4111,242,4420
4200,강원도,강릉시라선거구,6420304,4203,강릉시,포남1동,관내사전투표,1464,1461,257,187,573,240,126,1383,78,3
4200,강원도,강릉시라선거구,6420304,4203,강릉시,포남1동,선거일투표,7309,2892,568,405,1101,439,215,2728,164,4417
4200,강원도,강릉시라선거구,6420304,4203,강릉시,성덕동,계,21549,10310,1939,2674,2820,1290,987,9710,600,11239
4200,강원도,강릉시라선거구,6420304,4203,강릉시,성덕동,관내사전투표,3309,3302,643,889,907,433,287,3159,143,7
4200,강원도,강릉시라선거구,6420304,4203,강릉시,성덕동,선거일투표,18240,7008,1296,1785,1913,857,700,6551,457,11232
4200,강원도,강릉시라선거구,6420304,4203,강릉시,잘못 투입·구분된 투표지,,0,23,8,2,5,4,1,20,3,-23
4200,강원도,강릉시마선거구,6420305,4203,강릉시,합계,,34606,19175,3945,2137,6340,2822,3075,18319,856,15431
4200,강원도,강릉시마선거구,6420305,4203,강릉시,거소투표,,64,59,12,12,22,4,6,56,3,5
4200,강원도,강릉시마선거구,6420305,4203,강릉시,관외사전투표,,2440,2425,686,330,710,228,388,2342,83,15
4200,강원도,강릉시마선거구,6420305,4203,강릉시,주문진읍,계,14627,7275,1032,902,3414,795,760,6903,372,7352
4200,강원도,강릉시마선거구,6420305,4203,강릉시,주문진읍,관내사전투표,2239,2231,326,277,1093,243,232,2171,60,8
4200,강원도,강릉시마선거구,6420305,4203,강릉시,주문진읍,선거일투표,12388,5044,706,625,2321,552,528,4732,312,7344
4200,강원도,강릉시마선거구,6420305,4203,강릉시,사천면,계,4195,2504,440,187,407,1080,255,2369,135,1691
4200,강원도,강릉시마선거구,6420305,4203,강릉시,사천면,관내사전투표,1124,1120,225,86,178,448,118,1055,65,4
4200,강원도,강릉시마선거구,6420305,4203,강릉시,사천면,선거일투표,3071,1384,215,101,229,632,137,1314,70,1687
4200,강원도,강릉시마선거구,6420305,4203,강릉시,연곡면,계,5596,3195,1006,301,1079,299,389,3074,121,2401
4200,강원도,강릉시마선거구,6420305,4203,강릉시,연곡면,관내사전투표,1427,1426,473,138,495,126,144,1376,50,1
4200,강원도,강릉시마선거구,6420305,4203,강릉시,연곡면,선거일투표,4169,1769,533,163,584,173,245,1698,71,2400
4200,강원도,강릉시마선거구,6420305,4203,강릉시,경포동,계,7684,3685,762,400,699,409,1274,3544,141,3999
4200,강원도,강릉시마선거구,6420305,4203,강릉시,경포동,관내사전투표,651,651,100,46,100,99,280,625,26,0
4200,강원도,강릉시마선거구,6420305,4203,강릉시,경포동,선거일투표,7033,3034,662,354,599,310,994,2919,115,3999
4200,강원도,강릉시마선거구,6420305,4203,강릉시,잘못 투입·구분된 투표지,,0,32,7,5,9,7,3,31,1,-32
4200,강원도,강릉시바선거구,6420306,4203,강릉시,합계,,30873,16981,3767,2096,4480,3961,1912,16216,765,13892
4200,강원도,강릉시바선거구,6420306,4203,강릉시,거소투표,,57,54,8,16,12,12,1,49,5,3
4200,강원도,강릉시바선거구,6420306,4203,강릉시,관외사전투표,,1985,1982,530,323,545,312,173,1883,99,3
4200,강원도,강릉시바선거구,6420306,4203,강릉시,교2동,계,6288,3122,653,360,926,760,239,2938,184,3166
4200,강원도,강릉시바선거구,6420306,4203,강릉시,교2동,관내사전투표,1109,1108,244,129,325,280,87,1065,43,1
4200,강원도,강릉시바선거구,6420306,4203,강릉시,교2동,선거일투표,5179,2014,409,231,601,480,152,1873,141,3165
4200,강원도,강릉시바선거구,6420306,4203,강릉시,포남2동,계,10819,5418,1185,552,1325,1792,337,5191,227,5401
4200,강원도,강릉시바선거구,6420306,4203,강릉시,포남2동,관내사전투표,1909,1909,424,179,436,662,119,1820,89,0
4200,강원도,강릉시바선거구,6420306,4203,강릉시,포남2동,선거일투표,8910,3509,761,373,889,1130,218,3371,138,5401
4200,강원도,강릉시바선거구,6420306,4203,강릉시,초당동,계,3937,2148,521,224,655,409,256,2065,83,1789
4200,강원도,강릉시바선거구,6420306,4203,강릉시,초당동,관내사전투표,948,938,241,99,294,185,87,906,32,10
4200,강원도,강릉시바선거구,6420306,4203,강릉시,초당동,선거일투표,2989,1210,280,125,361,224,169,1159,51,1779
4200,강원도,강릉시바선거구,6420306,4203,강릉시,송정동,계,7787,4226,861,618,1008,670,902,4059,167,3561
4200,강원도,강릉시바선거구,6420306,4203,강릉시,송정동,관내사전투표,1751,1745,351,270,425,273,351,1670,75,6
4200,강원도,강릉시바선거구,6420306,4203,강릉시,송정동,선거일투표,6036,2481,510,348,583,397,551,2389,92,3555
4200,강원도,강릉시바선거구,6420306,4203,강릉시,잘못 투입·구분된 투표지,,0,31,9,3,9,6,4,31,0,-31
4200,강원도,동해시가선거구,6420401,4204,동해시,합계,,33370,18254,3407,3361,4328,2835,680,2962,17573,681,15116
4200,강원도,동해시가선거구,6420401,4204,동해시,거소투표,,384,358,76,46,111,19,26,42,320,38,26
4200,강원도,동해시가선거구,6420401,4204,동해시,관외사전투표,,1554,1552,380,307,367,155,40,231,1480,72,2
4200,강원도,동해시가선거구,6420401,4204,동해시,송정동,계,3124,1616,183,429,384,238,14,310,1558,58,1508
4200,강원도,동해시가선거구,6420401,4204,동해시,송정동,관내사전투표,557,557,73,138,138,76,1,107,533,24,0
4200,강원도,동해시가선거구,6420401,4204,동해시,송정동,선거일투표,2567,1059,110,291,246,162,13,203,1025,34,1508
4200,강원도,동해시가선거구,6420401,4204,동해시,북삼동,계,15748,8108,1612,1350,2012,1129,355,1391,7849,259,7640
4200,강원도,동해시가선거구,6420401,4204,동해시,북삼동,관내사전투표,3416,3415,687,574,834,472,127,611,3305,110,1
4200,강원도,동해시가선거구,6420401,4204,동해시,북삼동,선거일투표,12332,4693,925,776,1178,657,228,780,4544,149,7639
4200,강원도,동해시가선거구,6420401,4204,동해시,북평동,계,10026,5125,992,1014,1032,1007,124,762,4931,194,4901
4200,강원도,동해시가선거구,6420401,4204,동해시,북평동,관내사전투표,2029,2029,343,402,427,441,28,298,1939,90,0
4200,강원도,동해시가선거구,6420401,4204,동해시,북평동,선거일투표,7997,3096,649,612,605,566,96,464,2992,104,4901
4200,강원도,동해시가선거구,6420401,4204,동해시,삼화동,계,2534,1492,164,215,421,286,121,225,1432,60,1042
4200,강원도,동해시가선거구,6420401,4204,동해시,삼화동,관내사전투표,682,682,75,109,188,110,60,116,658,24,0
4200,강원도,동해시가선거구,6420401,4204,동해시,삼화동,선거일투표,1852,810,89,106,233,176,61,109,774,36,1042
4200,강원도,동해시가선거구,6420401,4204,동해시,잘못 투입·구분된 투표지,,0,3,0,0,1,1,0,1,3,0,-3
4200,강원도,동해시나선거구,6420402,4204,동해시,합계,,43516,23791,2601,1744,2274,4394,3592,2059,2154,774,688,370,1888,22538,1253,19725
4200,강원도,동해시나선거구,6420402,4204,동해시,거소투표,,564,527,76,38,41,110,76,25,24,23,15,12,42,482,45,37
4200,강원도,동해시나선거구,6420402,4204,동해시,관외사전투표,,1836,1834,313,136,205,370,228,104,94,60,49,25,145,1729,105,2
4200,강원도,동해시나선거구,6420402,4204,동해시,천곡동,계,23240,11786,1367,803,1348,2556,1581,730,862,313,429,207,1031,11227,559,11454
4200,강원도,동해시나선거구,6420402,4204,동해시,천곡동,관내사전투표,4020,4020,448,252,482,914,546,251,251,80,130,66,402,3822,198,0
4200,강원도,동해시나선거구,6420402,4204,동해시,천곡동,선거일투표,19220,7766,919,551,866,1642,1035,479,611,233,299,141,629,7405,361,11454
4200,강원도,동해시나선거구,6420402,4204,동해시,부곡동,계,4645,2558,235,192,206,312,675,205,243,93,60,26,165,2412,146,2087
4200,강원도,동해시나선거구,6420402,4204,동해시,부곡동,관내사전투표,1247,1246,109,103,97,159,325,105,121,28,28,7,88,1170,76,1
4200,강원도,동해시나선거구,6420402,4204,동해시,부곡동,선거일투표,3398,1312,126,89,109,153,350,100,122,65,32,19,77,1242,70,2086
4200,강원도,동해시나선거구,6420402,4204,동해시,동호동,계,4335,2316,209,197,167,346,405,248,243,103,51,29,193,2191,125,2019
4200,강원도,동해시나선거구,6420402,4204,동해시,동호동,관내사전투표,972,972,99,84,78,158,158,107,93,36,17,10,83,923,49,0
4200,강원도,동해시나선거구,6420402,4204,동해시,동호동,선거일투표,3363,1344,110,113,89,188,247,141,150,67,34,19,110,1268,76,2019
4200,강원도,동해시나선거구,6420402,4204,동해시,발한동,계,3224,1793,156,153,107,269,248,196,318,78,32,24,116,1697,96,1431
4200,강원도,동해시나선거구,6420402,4204,동해시,발한동,관내사전투표,762,762,63,57,49,101,100,85,132,28,14,12,67,708,54,0
4200,강원도,동해시나선거구,6420402,4204,동해시,발한동,선거일투표,2462,1031,93,96,58,168,148,111,186,50,18,12,49,989,42,1431
4200,강원도,동해시나선거구,6420402,4204,동해시,묵호동,계,2686,1386,120,110,92,203,139,360,102,46,19,20,76,1287,99,1300
4200,강원도,동해시나선거구,6420402,4204,동해시,묵호동,관내사전투표,520,520,47,48,46,69,45,128,43,13,12,3,30,484,36,0
4200,강원도,동해시나선거구,6420402,4204,동해시,묵호동,선거일투표,2166,866,73,62,46,134,94,232,59,33,7,17,46,803,63,1300
4200,강원도,동해시나선거구,6420402,4204,동해시,망상동,계,2986,1589,124,115,108,228,239,191,268,58,33,27,120,1511,78,1397
4200,강원도,동해시나선거구,6420402,4204,동해시,망상동,관내사전투표,525,525,48,35,47,70,75,60,98,4,11,9,44,501,24,0
4200,강원도,동해시나선거구,6420402,4204,동해시,망상동,선거일투표,2461,1064,76,80,61,158,164,131,170,54,22,18,76,1010,54,1397
4200,강원도,동해시나선거구,6420402,4204,동해시,잘못 투입·구분된 투표지,,0,2,1,0,0,0,1,0,0,0,0,0,0,2,0,-2
4200,강원도,삼척시가선거구,6420501,4205,삼척시,합계,,32053,20859,3066,1530,2024,2498,1571,2921,3672,488,251,61,672,1234,19988,871,11194
4200,강원도,삼척시가선거구,6420501,4205,삼척시,거소투표,,94,88,9,10,7,11,2,20,15,1,0,0,4,5,84,4,6
4200,강원도,삼척시가선거구,6420501,4205,삼척시,관외사전투표,,2051,2051,471,164,175,272,177,189,281,59,20,2,17,129,1956,95,0
4200,강원도,삼척시가선거구,6420501,4205,삼척시,도계읍,계,8764,5115,242,160,1264,256,84,1891,336,35,9,11,555,59,4902,213,3649
4200,강원도,삼척시가선거구,6420501,4205,삼척시,도계읍,관내사전투표,2537,2537,111,80,654,117,40,950,168,15,5,8,255,32,2435,102,0
4200,강원도,삼척시가선거구,6420501,4205,삼척시,도계읍,선거일투표,6227,2578,131,80,610,139,44,941,168,20,4,3,300,27,2467,111,3649
4200,강원도,삼척시가선거구,6420501,4205,삼척시,하장면,계,1140,765,113,52,22,88,14,130,251,5,7,3,6,28,719,46,375
4200,강원도,삼척시가선거구,6420501,4205,삼척시,하장면,관내사전투표,221,221,35,15,8,27,5,29,66,2,1,0,4,14,206,15,0
4200,강원도,삼척시가선거구,6420501,4205,삼척시,하장면,선거일투표,919,544,78,37,14,61,9,101,185,3,6,3,2,14,513,31,375
4200,강원도,삼척시가선거구,6420501,4205,삼척시,미로면,계,1631,1170,103,65,112,192,46,57,453,16,3,3,14,39,1103,67,461
4200,강원도,삼척시가선거구,6420501,4205,삼척시,미로면,관내사전투표,611,611,50,29,62,97,18,35,246,11,1,2,5,21,577,34,0
4200,강원도,삼척시가선거구,6420501,4205,삼척시,미로면,선거일투표,1020,559,53,36,50,95,28,22,207,5,2,1,9,18,526,33,461
4200,강원도,삼척시가선거구,6420501,4205,삼척시,신기면,계,670,479,61,60,84,44,19,58,106,6,3,0,12,8,461,18,191
4200,강원도,삼척시가선거구,6420501,4205,삼척시,신기면,관내사전투표,270,270,36,28,54,25,10,41,53,0,1,0,7,6,261,9,0
4200,강원도,삼척시가선거구,6420501,4205,삼척시,신기면,선거일투표,400,209,25,32,30,19,9,17,53,6,2,0,5,2,200,9,191
4200,강원도,삼척시가선거구,6420501,4205,삼척시,성내동,계,6962,4898,984,391,162,838,423,295,918,175,43,19,22,433,4703,195,2064
4200,강원도,삼척시가선거구,6420501,4205,삼척시,성내동,관내사전투표,2609,2609,529,198,96,400,228,163,487,92,26,8,11,252,2490,119,0
4200,강원도,삼척시가선거구,6420501,4205,삼척시,성내동,선거일투표,4353,2289,455,193,66,438,195,132,431,83,17,11,11,181,2213,76,2064
4200,강원도,삼척시가선거구,6420501,4205,삼척시,교동,계,10741,6293,1083,628,198,797,806,281,1312,191,166,23,42,533,6060,233,4448
4200,강원도,삼척시가선거구,6420501,4205,삼척시,교동,관내사전투표,2536,2536,460,247,75,329,303,116,520,73,72,1,20,224,2440,96,0
4200,강원도,삼척시가선거구,6420501,4205,삼척시,교동,선거일투표,8205,3757,623,381,123,468,503,165,792,118,94,22,22,309,3620,137,4448
4200,강원도,삼척시가선거구,6420501,4205,삼척시,잘못 투입·구분된 투표지,,0,0,0,0,0,0,0,0,0,0,0,0,0,0,0,0,0
4200,강원도,삼척시나선거구,6420502,4205,삼척시,합계,,24970,16689,2182,3263,4012,1340,3540,1659,15996,693,8281
4200,강원도,삼척시나선거구,6420502,4205,삼척시,거소투표,,90,76,12,18,18,2,17,5,72,4,14
4200,강원도,삼척시나선거구,6420502,4205,삼척시,관외사전투표,,2537,2537,489,643,572,178,441,138,2461,76,0
4200,강원도,삼척시나선거구,6420502,4205,삼척시,원덕읍,계,4376,2859,199,535,582,117,297,994,2724,135,1517
4200,강원도,삼척시나선거구,6420502,4205,삼척시,원덕읍,관내사전투표,1263,1263,88,237,259,47,102,477,1210,53,0
4200,강원도,삼척시나선거구,6420502,4205,삼척시,원덕읍,선거일투표,3113,1596,111,298,323,70,195,517,1514,82,1517
4200,강원도,삼척시나선거구,6420502,4205,삼척시,근덕면,계,4493,3059,298,657,825,489,586,81,2936,123,1434
4200,강원도,삼척시나선거구,6420502,4205,삼척시,근덕면,관내사전투표,1175,1174,106,256,295,217,222,27,1123,51,1
4200,강원도,삼척시나선거구,6420502,4205,삼척시,근덕면,선거일투표,3318,1885,192,401,530,272,364,54,1813,72,1433
4200,강원도,삼척시나선거구,6420502,4205,삼척시,노곡면,계,588,426,35,83,99,30,141,11,399,27,162
4200,강원도,삼척시나선거구,6420502,4205,삼척시,노곡면,관내사전투표,155,155,15,26,35,3,63,4,146,9,0
4200,강원도,삼척시나선거구,6420502,4205,삼척시,노곡면,선거일투표,433,271,20,57,64,27,78,7,253,18,162
4200,강원도,삼척시나선거구,6420502,4205,삼척시,가곡면,계,598,433,44,59,72,21,31,181,408,25,165
4200,강원도,삼척시나선거구,6420502,4205,삼척시,가곡면,관내사전투표,187,187,22,25,28,8,16,75,174,13,0
4200,강원도,삼척시나선거구,6420502,4205,삼척시,가곡면,선거일투표,411,246,22,34,44,13,15,106,234,12,165
4200,강원도,삼척시나선거구,6420502,4205,삼척시,남양동,계,6148,4068,490,648,998,288,1363,121,3908,160,2080
4200,강원도,삼척시나선거구,6420502,4205,삼척시,남양동,관내사전투표,1493,1492,196,257,344,117,482,44,1440,52,1
4200,강원도,삼척시나선거구,6420502,4205,삼척시,남양동,선거일투표,4655,2576,294,391,654,171,881,77,2468,108,2079
4200,강원도,삼척시나선거구,6420502,4205,삼척시,정라동,계,6140,3228,614,620,845,215,663,128,3085,143,2912
4200,강원도,삼척시나선거구,6420502,4205,삼척시,정라동,관내사전투표,638,638,120,110,175,38,154,20,617,21,0
4200,강원도,삼척시나선거구,6420502,4205,삼척시,정라동,선거일투표,5502,2590,494,510,670,177,509,108,2468,122,2912
4200,강원도,삼척시나선거구,6420502,4205,삼척시,잘못 투입·구분된 투표지,,0,3,1,0,1,0,1,0,3,0,-3
4200,강원도,태백시가선거구,6420601,4206,태백시,합계,,17978,11419,1713,1505,2871,2694,139,332,622,467,516,10859,560,6559
4200,강원도,태백시가선거구,6420601,4206,태백시,거소투표,,29,29,1,6,6,9,0,2,1,0,1,26,3,0
4200,강원도,태백시가선거구,6420601,4206,태백시,관외사전투표,,909,909,223,159,197,154,10,22,22,41,32,860,49,0
4200,강원도,태백시가선거구,6420601,4206,태백시,황지동,계,4826,3019,421,411,620,768,28,87,205,184,176,2900,119,1807
4200,강원도,태백시가선거구,6420601,4206,태백시,황지동,관내사전투표,1263,1263,195,187,290,285,9,28,73,79,73,1219,44,0
4200,강원도,태백시가선거구,6420601,4206,태백시,황지동,선거일투표,3563,1756,226,224,330,483,19,59,132,105,103,1681,75,1807
4200,강원도,태백시가선거구,6420601,4206,태백시,황연동,계,3841,2384,321,290,602,627,26,47,149,99,107,2268,116,1457
4200,강원도,태백시가선거구,6420601,4206,태백시,황연동,관내사전투표,1131,1131,151,142,302,280,8,20,68,50,53,1074,57,0
4200,강원도,태백시가선거구,6420601,4206,태백시,황연동,선거일투표,2710,1253,170,148,300,347,18,27,81,49,54,1194,59,1457
4200,강원도,태백시가선거구,6420601,4206,태백시,삼수동,계,4470,2525,342,364,605,606,30,55,163,90,140,2395,130,1945
4200,강원도,태백시가선거구,6420601,4206,태백시,삼수동,관내사전투표,1030,1030,110,132,246,289,14,26,71,40,60,988,42,0
4200,강원도,태백시가선거구,6420601,4206,태백시,삼수동,선거일투표,3440,1495,232,232,359,317,16,29,92,50,80,1407,88,1945
4200,강원도,태백시가선거구,6420601,4206,태백시,구문소동,계,2075,1358,191,155,481,256,17,89,44,23,32,1288,70,717
4200,강원도,태백시가선거구,6420601,4206,태백시,구문소동,관내사전투표,700,700,102,86,228,135,8,53,25,11,14,662,38,0
4200,강원도,태백시가선거구,6420601,4206,태백시,구문소동,선거일투표,1375,658,89,69,253,121,9,36,19,12,18,626,32,717
4200,강원도,태백시가선거구,6420601,4206,태백시,철암동,계,1828,1193,214,120,359,274,28,30,38,30,28,1121,72,635
4200,강원도,태백시가선거구,6420601,4206,태백시,철암동,관내사전투표,617,617,105,61,186,154,12,15,17,17,10,577,40,0
4200,강원도,태백시가선거구,6420601,4206,태백시,철암동,선거일투표,1211,576,109,59,173,120,16,15,21,13,18,544,32,635
4200,강원도,태백시가선거구,6420601,4206,태백시,잘못 투입·구분된 투표지,,0,2,0,0,1,0,0,0,0,0,0,1,1,-2
4200,강원도,태백시나선거구,6420602,4206,태백시,합계,,17258,11119,2255,1294,2387,1196,655,1467,1362,10616,503,6139
4200,강원도,태백시나선거구,6420602,4206,태백시,거소투표,,28,28,9,4,5,6,1,1,2,28,0,0
4200,강원도,태백시나선거구,6420602,4206,태백시,관외사전투표,,1824,1823,480,249,347,172,84,198,213,1743,80,1
4200,강원도,태백시나선거구,6420602,4206,태백시,상장동,계,9237,5257,1122,562,1008,656,322,525,833,5028,229,3980
4200,강원도,태백시나선거구,6420602,4206,태백시,상장동,관내사전투표,2028,2028,423,241,403,247,103,209,311,1937,91,0
4200,강원도,태백시나선거구,6420602,4206,태백시,상장동,선거일투표,7209,3229,699,321,605,409,219,316,522,3091,138,3980
4200,강원도,태백시나선거구,6420602,4206,태백시,문곡소도동,계,3117,1921,315,209,529,189,138,276,200,1856,65,1196
4200,강원도,태백시나선거구,6420602,4206,태백시,문곡소도동,관내사전투표,713,713,123,70,193,77,53,105,68,689,24,0
4200,강원도,태백시나선거구,6420602,4206,태백시,문곡소도동,선거일투표,2404,1208,192,139,336,112,85,171,132,1167,41,1196
4200,강원도,태백시나선거구,6420602,4206,태백시,장성동,계,3052,2090,329,270,498,173,110,467,114,1961,129,962
4200,강원도,태백시나선거구,6420602,4206,태백시,장성동,관내사전투표,1277,1277,204,162,325,96,61,272,75,1195,82,0
4200,강원도,태백시나선거구,6420602,4206,태백시,장성동,선거일투표,1775,813,125,108,173,77,49,195,39,766,47,962
4200,강원도,태백시나선거구,6420602,4206,태백시,잘못 투입·구분된 투표지,,0,0,0,0,0,0,0,0,0,0,0,0
4200,강원도,정선군가선거구,6420701,4207,정선군,합계,,18003,12958,2112,2405,1361,2430,1639,340,2003,12290,668,5045
4200,강원도,정선군가선거구,6420701,4207,정선군,거소투표,,56,53,19,11,6,7,2,0,4,49,4,3
4200,강원도,정선군가선거구,6420701,4207,정선군,관외사전투표,,956,955,211,182,108,201,80,23,103,908,47,1
4200,강원도,정선군가선거구,6420701,4207,정선군,정선읍,계,8423,5972,787,1756,377,1481,446,47,802,5696,276,2451
4200,강원도,정선군가선거구,6420701,4207,정선군,정선읍,관내사전투표,2600,2600,393,767,221,559,157,23,385,2505,95,0
4200,강원도,정선군가선거구,6420701,4207,정선군,정선읍,선거일투표,5823,3372,394,989,156,922,289,24,417,3191,181,2451
4200,강원도,정선군가선거구,6420701,4207,정선군,화암면,계,1435,950,161,191,105,205,147,17,52,878,72,485
4200,강원도,정선군가선거구,6420701,4207,정선군,화암면,관내사전투표,371,371,61,71,49,96,48,11,12,348,23,0
4200,강원도,정선군가선거구,6420701,4207,정선군,화암면,선거일투표,1064,579,100,120,56,109,99,6,40,530,49,485
4200,강원도,정선군가선거구,6420701,4207,정선군,여량면,계,1779,1293,579,56,39,210,181,22,130,1217,76,486
4200,강원도,정선군가선거구,6420701,4207,정선군,여량면,관내사전투표,600,600,271,34,24,105,74,11,54,573,27,0
4200,강원도,정선군가선거구,6420701,4207,정선군,여량면,선거일투표,1179,693,308,22,15,105,107,11,76,644,49,486
4200,강원도,정선군가선거구,6420701,4207,정선군,북평면,계,2188,1553,193,104,44,172,87,8,872,1480,73,635
4200,강원도,정선군가선거구,6420701,4207,정선군,북평면,관내사전투표,807,807,101,62,32,103,41,5,428,772,35,0
4200,강원도,정선군가선거구,6420701,4207,정선군,북평면,선거일투표,1381,746,92,42,12,69,46,3,444,708,38,635
4200,강원도,정선군가선거구,6420701,4207,정선군,임계면,계,3166,2181,162,105,682,153,696,223,40,2061,120,985
4200,강원도,정선군가선거구,6420701,4207,정선군,임계면,관내사전투표,987,987,70,51,312,81,324,85,24,947,40,0
4200,강원도,정선군가선거구,6420701,4207,정선군,임계면,선거일투표,2179,1194,92,54,370,72,372,138,16,1114,80,985
4200,강원도,정선군가선거구,6420701,4207,정선군,잘못 투입·구분된 투표지,,0,1,0,0,0,1,0,0,0,1,0,-1
4200,강원도,정선군나선거구,6420702,4207,정선군,합계,,13998,9126,1616,1397,1450,2096,695,1248,152,8654,472,4872
4200,강원도,정선군나선거구,6420702,4207,정선군,거소투표,,27,23,5,3,0,4,0,5,1,18,5,4
4200,강원도,정선군나선거구,6420702,4207,정선군,관외사전투표,,687,687,159,104,102,162,53,58,7,645,42,0
4200,강원도,정선군나선거구,6420702,4207,정선군,고한읍,계,3741,2202,143,689,160,955,104,36,10,2097,105,1539
4200,강원도,정선군나선거구,6420702,4207,정선군,고한읍,관내사전투표,1159,1159,74,392,83,489,52,19,4,1113,46,0
4200,강원도,정선군나선거구,6420702,4207,정선군,고한읍,선거일투표,2582,1043,69,297,77,466,52,17,6,984,59,1539
4200,강원도,정선군나선거구,6420702,4207,정선군,사북읍,계,3939,2417,152,240,914,516,381,75,17,2295,122,1522
4200,강원도,정선군나선거구,6420702,4207,정선군,사북읍,관내사전투표,1189,1189,85,115,449,260,182,34,7,1132,57,0
4200,강원도,정선군나선거구,6420702,4207,정선군,사북읍,선거일투표,2750,1228,67,125,465,256,199,41,10,1163,65,1522
4200,강원도,정선군나선거구,6420702,4207,정선군,신동읍,계,2964,2078,826,82,20,115,36,815,90,1984,94,886
4200,강원도,정선군나선거구,6420702,4207,정선군,신동읍,관내사전투표,802,802,342,32,10,30,12,309,31,766,36,0
4200,강원도,정선군나선거구,6420702,4207,정선군,신동읍,선거일투표,2162,1276,484,50,10,85,24,506,59,1218,58,886
4200,강원도,정선군나선거구,6420702,4207,정선군,남면,계,2640,1719,331,279,254,344,121,259,27,1615,104,921
4200,강원도,정선군나선거구,6420702,4207,정선군,남면,관내사전투표,555,555,121,91,92,104,29,83,7,527,28,0
4200,강원도,정선군나선거구,6420702,4207,정선군,남면,선거일투표,2085,1164,210,188,162,240,92,176,20,1088,76,921
4200,강원도,정선군나선거구,6420702,4207,정선군,잘못 투입·구분된 투표지,,0,0,0,0,0,0,0,0,0,0,0,0
4200,강원도,속초시가선거구,6420801,4208,속초시,합계,,28573,15437,3051,2833,3840,1990,1938,705,247,14604,833,13136
4200,강원도,속초시가선거구,6420801,4208,속초시,거소투표,,83,70,12,16,13,7,12,2,1,63,7,13
4200,강원도,속초시가선거구,6420801,4208,속초시,관외사전투표,,1506,1506,343,320,342,143,160,71,35,1414,92,0
4200,강원도,속초시가선거구,6420801,4208,속초시,영랑동,계,4273,2453,467,441,515,478,285,133,30,2349,104,1820
4200,강원도,속초시가선거구,6420801,4208,속초시,영랑동,관내사전투표,1007,1006,220,192,211,139,113,77,13,965,41,1
4200,강원도,속초시가선거구,6420801,4208,속초시,영랑동,선거일투표,3266,1447,247,249,304,339,172,56,17,1384,63,1819
4200,강원도,속초시가선거구,6420801,4208,속초시,동명동,계,2711,1384,279,296,321,196,130,68,20,1310,74,1327
4200,강원도,속초시가선거구,6420801,4208,속초시,동명동,관내사전투표,553,553,99,116,145,78,56,20,7,521,32,0
4200,강원도,속초시가선거구,6420801,4208,속초시,동명동,선거일투표,2158,831,180,180,176,118,74,48,13,789,42,1327
4200,강원도,속초시가선거구,6420801,4208,속초시,금호동,계,5197,2726,645,465,564,381,337,156,31,2579,147,2471
4200,강원도,속초시가선거구,6420801,4208,속초시,금호동,관내사전투표,1121,1121,290,188,225,170,122,54,14,1063,58,0
4200,강원도,속초시가선거구,6420801,4208,속초시,금호동,선거일투표,4076,1605,355,277,339,211,215,102,17,1516,89,2471
4200,강원도,속초시가선거구,6420801,4208,속초시,교동,계,7801,3619,719,657,817,387,569,173,63,3385,234,4182
4200,강원도,속초시가선거구,6420801,4208,속초시,교동,관내사전투표,1214,1213,264,223,276,121,189,47,23,1143,70,1
4200,강원도,속초시가선거구,6420801,4208,속초시,교동,선거일투표,6587,2406,455,434,541,266,380,126,40,2242,164,4181
4200,강원도,속초시가선거구,6420801,4208,속초시,청호동,계,4236,2097,382,381,701,213,223,61,47,2008,89,2139
4200,강원도,속초시가선거구,6420801,4208,속초시,청호동,관내사전투표,817,817,163,141,266,71,90,31,13,775,42,0
4200,강원도,속초시가선거구,6420801,4208,속초시,청호동,선거일투표,3419,1280,219,240,435,142,133,30,34,1233,47,2139
4200,강원도,속초시가선거구,6420801,4208,속초시,대포동,계,2766,1579,204,256,567,184,221,41,20,1493,86,1187
4200,강원도,속초시가선거구,6420801,4208,속초시,대포동,관내사전투표,492,492,82,83,161,53,68,13,6,466,26,0
4200,강원도,속초시가선거구,6420801,4208,속초시,대포동,선거일투표,2274,1087,122,173,406,131,153,28,14,1027,60,1187
4200,강원도,속초시가선거구,6420801,4208,속초시,잘못 투입·구분된 투표지,,0,3,0,1,0,1,1,0,0,3,0,-3
4200,강원도,속초시나선거구,6420802,4208,속초시,합계,,43048,21655,3570,5215,5718,5418,404,20325,1330,21393
4200,강원도,속초시나선거구,6420802,4208,속초시,거소투표,,200,165,18,40,45,29,15,147,18,35
4200,강원도,속초시나선거구,6420802,4208,속초시,관외사전투표,,3114,3112,617,806,691,761,78,2953,159,2
4200,강원도,속초시나선거구,6420802,4208,속초시,노학동,계,17736,8534,1369,1888,2217,2395,157,8026,508,9202
4200,강원도,속초시나선거구,6420802,4208,속초시,노학동,관내사전투표,3203,3199,509,755,793,921,50,3028,171,4
4200,강원도,속초시나선거구,6420802,4208,속초시,노학동,선거일투표,14533,5335,860,1133,1424,1474,107,4998,337,9198
4200,강원도,속초시나선거구,6420802,4208,속초시,조양동,계,21998,9824,1564,2475,2757,2231,154,9181,643,12174
4200,강원도,속초시나선거구,6420802,4208,속초시,조양동,관내사전투표,2994,2991,523,835,727,698,47,2830,161,3
4200,강원도,속초시나선거구,6420802,4208,속초시,조양동,선거일투표,19004,6833,1041,1640,2030,1533,107,6351,482,12171
4200,강원도,속초시나선거구,6420802,4208,속초시,잘못 투입·구분된 투표지,,0,20,2,6,8,2,0,18,2,-20
4200,강원도,고성군가선거구,6420901,4209,고성군,합계,,17059,11244,1292,2020,1757,1330,1226,668,1411,1026,10730,514,5815
4200,강원도,고성군가선거구,6420901,4209,고성군,거소투표,,152,144,16,25,32,11,8,1,12,16,121,23,8
4200,강원도,고성군가선거구,6420901,4209,고성군,관외사전투표,,1069,1068,211,196,232,131,85,31,74,59,1019,49,1
4200,강원도,고성군가선거구,6420901,4209,고성군,간성읍,계,5670,3625,343,587,295,460,889,44,249,598,3465,160,2045
4200,강원도,고성군가선거구,6420901,4209,고성군,간성읍,관내사전투표,1514,1513,169,279,119,190,346,17,134,210,1464,49,1
4200,강원도,고성군가선거구,6420901,4209,고성군,간성읍,선거일투표,4156,2112,174,308,176,270,543,27,115,388,2001,111,2044
4200,강원도,고성군가선거구,6420901,4209,고성군,죽왕면,계,3030,2062,177,572,188,433,145,31,171,238,1955,107,968
4200,강원도,고성군가선거구,6420901,4209,고성군,죽왕면,관내사전투표,700,700,65,199,60,165,38,9,71,59,666,34,0
4200,강원도,고성군가선거구,6420901,4209,고성군,죽왕면,선거일투표,2330,1362,112,373,128,268,107,22,100,179,1289,73,968
4200,강원도,고성군가선거구,6420901,4209,고성군,토성면,계,7138,4345,545,640,1010,295,99,561,905,115,4170,175,2793
4200,강원도,고성군가선거구,6420901,4209,고성군,토성면,관내사전투표,1642,1642,239,261,422,120,48,196,249,45,1580,62,0
4200,강원도,고성군가선거구,6420901,4209,고성군,토성면,선거일투표,5496,2703,306,379,588,175,51,365,656,70,2590,113,2793
4200,강원도,고성군가선거구,6420901,4209,고성군,잘못 투입·구분된 투표지,,0,0,0,0,0,0,0,0,0,0,0,0,0
4200,강원도,고성군나선거구,6420902,4209,고성군,합계,,7717,5532,1192,459,1863,1045,690,5249,283,2185
4200,강원도,고성군나선거구,6420902,4209,고성군,거소투표,,40,40,8,4,13,7,5,37,3,0
4200,강원도,고성군나선거구,6420902,4209,고성군,관외사전투표,,438,438,107,47,157,73,42,426,12,0
4200,강원도,고성군나선거구,6420902,4209,고성군,거진읍,계,5209,3599,360,321,1492,787,470,3430,169,1610
4200,강원도,고성군나선거구,6420902,4209,고성군,거진읍,관내사전투표,1236,1234,122,110,537,242,185,1196,38,2
4200,강원도,고성군나선거구,6420902,4209,고성군,거진읍,선거일투표,3973,2365,238,211,955,545,285,2234,131,1608
4200,강원도,고성군나선거구,6420902,4209,고성군,현내면,계,2030,1440,713,85,198,176,169,1341,99,590
4200,강원도,고성군나선거구,6420902,4209,고성군,현내면,관내사전투표,414,402,183,25,62,49,56,375,27,12
4200,강원도,고성군나선거구,6420902,4209,고성군,현내면,선거일투표,1616,1038,530,60,136,127,113,966,72,578
4200,강원도,고성군나선거구,6420902,4209,고성군,잘못 투입·구분된 투표지,,0,15,4,2,3,2,4,15,0,-15
4200,강원도,양양군가선거구,6421001,4210,양양군,합계,,17931,11554,2744,4018,947,1660,1736,11105,449,6377
4200,강원도,양양군가선거구,6421001,4210,양양군,거소투표,,52,51,9,23,7,3,8,50,1,1
4200,강원도,양양군가선거구,6421001,4210,양양군,관외사전투표,,941,938,322,298,72,105,118,915,23,3
4200,강원도,양양군가선거구,6421001,4210,양양군,양양읍,계,10417,6472,1423,2462,575,520,1251,6231,241,3945
4200,강원도,양양군가선거구,6421001,4210,양양군,양양읍,관내사전투표,2818,2814,649,1121,233,224,525,2752,62,4
4200,강원도,양양군가선거구,6421001,4210,양양군,양양읍,선거일투표,7599,3658,774,1341,342,296,726,3479,179,3941
4200,강원도,양양군가선거구,6421001,4210,양양군,서면,계,2498,1666,482,632,165,103,180,1562,104,832
4200,강원도,양양군가선거구,6421001,4210,양양군,서면,관내사전투표,640,637,180,254,53,49,75,611,26,3
4200,강원도,양양군가선거구,6421001,4210,양양군,서면,선거일투표,1858,1029,302,378,112,54,105,951,78,829
4200,강원도,양양군가선거구,6421001,4210,양양군,강현면,계,4023,2414,502,601,127,928,177,2335,79,1609
4200,강원도,양양군가선거구,6421001,4210,양양군,강현면,관내사전투표,866,864,191,241,45,300,67,844,20,2
4200,강원도,양양군가선거구,6421001,4210,양양군,강현면,선거일투표,3157,1550,311,360,82,628,110,1491,59,1607
4200,강원도,양양군가선거구,6421001,4210,양양군,잘못 투입·구분된 투표지,,0,13,6,2,1,1,2,12,1,-13
4200,강원도,양양군나선거구,6421002,4210,양양군,합계,,7428,5117,748,536,842,888,509,601,780,4904,213,2311
4200,강원도,양양군나선거구,6421002,4210,양양군,거소투표,,52,47,6,4,6,5,17,3,5,46,1,5
4200,강원도,양양군나선거구,6421002,4210,양양군,관외사전투표,,588,588,130,55,123,97,48,71,42,566,22,0
4200,강원도,양양군나선거구,6421002,4210,양양군,손양면,계,1987,1321,152,279,100,661,13,52,12,1269,52,666
4200,강원도,양양군나선거구,6421002,4210,양양군,손양면,관내사전투표,486,486,57,102,29,255,3,16,6,468,18,0
4200,강원도,양양군나선거구,6421002,4210,양양군,손양면,선거일투표,1501,835,95,177,71,406,10,36,6,801,34,666
4200,강원도,양양군나선거구,6421002,4210,양양군,현북면,계,2215,1510,320,89,485,73,22,425,35,1449,61,705
4200,강원도,양양군나선거구,6421002,4210,양양군,현북면,관내사전투표,481,481,111,22,167,16,9,127,9,461,20,0
4200,강원도,양양군나선거구,6421002,4210,양양군,현북면,선거일투표,1734,1029,209,67,318,57,13,298,26,988,41,705
4200,강원도,양양군나선거구,6421002,4210,양양군,현남면,계,2586,1650,140,109,128,52,409,50,685,1573,77,936
4200,강원도,양양군나선거구,6421002,4210,양양군,현남면,관내사전투표,586,585,47,40,43,15,154,9,247,555,30,1
4200,강원도,양양군나선거구,6421002,4210,양양군,현남면,선거일투표,2000,1065,93,69,85,37,255,41,438,1018,47,935
4200,강원도,양양군나선거구,6421002,4210,양양군,잘못 투입·구분된 투표지,,0,1,0,0,0,0,0,0,1,1,0,-1
4200,강원도,인제군가선거구,6421101,4211,인제군,합계,,18357,12199,3288,1355,4543,1080,867,547,11680,519,6158
4200,강원도,인제군가선거구,6421101,4211,인제군,거소투표,,153,146,38,23,45,5,6,8,125,21,7
4200,강원도,인제군가선거구,6421101,4211,인제군,관외사전투표,,952,952,302,93,381,71,26,33,906,46,0
4200,강원도,인제군가선거구,6421101,4211,인제군,인제읍,계,8398,5472,1057,955,2650,257,165,174,5258,214,2926
4200,강원도,인제군가선거구,6421101,4211,인제군,인제읍,관내사전투표,2513,2513,509,482,1132,128,89,92,2432,81,0
4200,강원도,인제군가선거구,6421101,4211,인제군,인제읍,선거일투표,5885,2959,548,473,1518,129,76,82,2826,133,2926
4200,강원도,인제군가선거구,6421101,4211,인제군,북면,계,6699,4357,1570,198,975,614,553,282,4192,165,2342
4200,강원도,인제군가선거구,6421101,4211,인제군,북면,관내사전투표,1878,1878,708,82,390,262,226,133,1801,77,0
4200,강원도,인제군가선거구,6421101,4211,인제군,북면,선거일투표,4821,2479,862,116,585,352,327,149,2391,88,2342
4200,강원도,인제군가선거구,6421101,4211,인제군,서화면,계,2155,1272,321,86,492,133,117,50,1199,73,883
4200,강원도,인제군가선거구,6421101,4211,인제군,서화면,관내사전투표,526,526,139,43,190,47,50,22,491,35,0
4200,강원도,인제군가선거구,6421101,4211,인제군,서화면,선거일투표,1629,746,182,43,302,86,67,28,708,38,883
4200,강원도,인제군가선거구,6421101,4211,인제군,잘못 투입·구분된 투표지,,0,0,0,0,0,0,0,0,0,0,0
4200,강원도,인제군나선거구,6421102,4211,인제군,합계,,9582,6339,804,823,1020,817,716,103,706,1101,6090,249,3243
4200,강원도,인제군나선거구,6421102,4211,인제군,거소투표,,44,39,5,0,4,2,2,1,2,20,36,3,5
4200,강원도,인제군나선거구,6421102,4211,인제군,관외사전투표,,675,675,141,75,181,72,55,6,36,84,650,25,0
4200,강원도,인제군나선거구,6421102,4211,인제군,남면,계,3042,1855,253,60,559,24,28,6,23,857,1810,45,1187
4200,강원도,인제군나선거구,6421102,4211,인제군,남면,관내사전투표,964,964,111,29,294,13,16,3,9,466,941,23,0
4200,강원도,인제군나선거구,6421102,4211,인제군,남면,선거일투표,2078,891,142,31,265,11,12,3,14,391,869,22,1187
4200,강원도,인제군나선거구,6421102,4211,인제군,기린면,계,4103,2691,268,535,174,536,483,38,439,89,2562,129,1412
4200,강원도,인제군나선거구,6421102,4211,인제군,기린면,관내사전투표,967,967,112,196,60,194,173,17,158,31,941,26,0
4200,강원도,인제군나선거구,6421102,4211,인제군,기린면,선거일투표,3136,1724,156,339,114,342,310,21,281,58,1621,103,1412
4200,강원도,인제군나선거구,6421102,4211,인제군,상남면,계,1718,1079,137,153,102,183,148,52,206,51,1032,47,639
4200,강원도,인제군나선거구,6421102,4211,인제군,상남면,관내사전투표,430,430,62,61,46,78,53,21,68,22,411,19,0
4200,강원도,인제군나선거구,6421102,4211,인제군,상남면,선거일투표,1288,649,75,92,56,105,95,31,138,29,621,28,639
4200,강원도,인제군나선거구,6421102,4211,인제군,잘못 투입·구분된 투표지,,0,0,0,0,0,0,0,0,0,0,0,0,0
4200,강원도,홍천군가선거구,6421201,4212,홍천군,합계,,32532,19130,5695,2919,4762,2826,2002,18204,926,13402
4200,강원도,홍천군가선거구,6421201,4212,홍천군,거소투표,,64,62,15,11,18,8,4,56,6,2
4200,강원도,홍천군가선거구,6421201,4212,홍천군,관외사전투표,,1827,1827,647,237,473,200,185,1742,85,0
4200,강원도,홍천군가선거구,6421201,4212,홍천군,홍천읍,계,26846,14801,4355,2315,3628,2226,1613,14137,664,12045
4200,강원도,홍천군가선거구,6421201,4212,홍천군,홍천읍,관내사전투표,5249,5243,1561,845,1238,783,612,5039,204,6
4200,강원도,홍천군가선거구,6421201,4212,홍천군,홍천읍,선거일투표,21597,9558,2794,1470,2390,1443,1001,9098,460,12039
4200,강원도,홍천군가선거구,6421201,4212,홍천군,북방면,계,3795,2429,676,355,643,388,199,2261,168,1366
4200,강원도,홍천군가선거구,6421201,4212,홍천군,북방면,관내사전투표,1125,1123,313,185,286,163,122,1069,54,2
4200,강원도,홍천군가선거구,6421201,4212,홍천군,북방면,선거일투표,2670,1306,363,170,357,225,77,1192,114,1364
4200,강원도,홍천군가선거구,6421201,4212,홍천군,잘못 투입·구분된 투표지,,0,11,2,1,0,4,1,8,3,-11
4200,강원도,홍천군나선거구,6421202,4212,홍천군,합계,,17228,10387,2398,950,3177,1383,1853,9761,626,6841
4200,강원도,홍천군나선거구,6421202,4212,홍천군,거소투표,,62,61,18,5,19,5,3,50,11,1
4200,강원도,홍천군나선거구,6421202,4212,홍천군,관외사전투표,,1186,1186,319,101,460,132,100,1112,74,0
4200,강원도,홍천군나선거구,6421202,4212,홍천군,화촌면,계,3875,2277,331,432,1045,164,172,2144,133,1598
4200,강원도,홍천군나선거구,6421202,4212,홍천군,화촌면,관내사전투표,897,896,127,173,408,69,58,835,61,1
4200,강원도,홍천군나선거구,6421202,4212,홍천군,화촌면,선거일투표,2978,1381,204,259,637,95,114,1309,72,1597
4200,강원도,홍천군나선거구,6421202,4212,홍천군,영귀미면,계,3615,2246,317,119,520,180,989,2125,121,1369
4200,강원도,홍천군나선거구,6421202,4212,홍천군,영귀미면,관내사전투표,837,833,117,46,198,76,354,791,42,4
4200,강원도,홍천군나선거구,6421202,4212,홍천군,영귀미면,선거일투표,2778,1413,200,73,322,104,635,1334,79,1365
4200,강원도,홍천군나선거구,6421202,4212,홍천군,남면,계,5138,2794,1104,139,587,591,226,2647,147,2344
4200,강원도,홍천군나선거구,6421202,4212,홍천군,남면,관내사전투표,1093,1086,456,64,224,208,71,1023,63,7
4200,강원도,홍천군나선거구,6421202,4212,홍천군,남면,선거일투표,4045,1708,648,75,363,383,155,1624,84,2337
4200,강원도,홍천군나선거구,6421202,4212,홍천군,서면,계,3352,1811,306,152,543,308,362,1671,140,1541
4200,강원도,홍천군나선거구,6421202,4212,홍천군,서면,관내사전투표,581,581,108,51,192,99,91,541,40,0
4200,강원도,홍천군나선거구,6421202,4212,홍천군,서면,선거일투표,2771,1230,198,101,351,209,271,1130,100,1541
4200,강원도,홍천군나선거구,6421202,4212,홍천군,잘못 투입·구분된 투표지,,0,12,3,2,3,3,1,12,0,-12
4200,강원도,홍천군다선거구,6421203,4212,홍천군,합계,,10983,7418,1563,2980,1184,1400,7127,291,3565
4200,강원도,홍천군다선거구,6421203,4212,홍천군,거소투표,,14,14,5,8,0,0,13,1,0
4200,강원도,홍천군다선거구,6421203,4212,홍천군,관외사전투표,,714,714,237,360,50,54,701,13,0
4200,강원도,홍천군다선거구,6421203,4212,홍천군,두촌면,계,2157,1371,226,490,526,59,1301,70,786
4200,강원도,홍천군다선거구,6421203,4212,홍천군,두촌면,관내사전투표,573,572,94,218,199,27,538,34,1
4200,강원도,홍천군다선거구,6421203,4212,홍천군,두촌면,선거일투표,1584,799,132,272,327,32,763,36,785
4200,강원도,홍천군다선거구,6421203,4212,홍천군,내촌면,계,2128,1387,278,482,533,38,1331,56,741
4200,강원도,홍천군다선거구,6421203,4212,홍천군,내촌면,관내사전투표,590,590,123,216,192,27,558,32,0
4200,강원도,홍천군다선거구,6421203,4212,홍천군,내촌면,선거일투표,1538,797,155,266,341,11,773,24,741
4200,강원도,홍천군다선거구,6421203,4212,홍천군,서석면,계,3281,2155,632,1270,53,143,2098,57,1126
4200,강원도,홍천군다선거구,6421203,4212,홍천군,서석면,관내사전투표,726,723,236,398,16,49,699,24,3
4200,강원도,홍천군다선거구,6421203,4212,홍천군,서석면,선거일투표,2555,1432,396,872,37,94,1399,33,1123
4200,강원도,홍천군다선거구,6421203,4212,홍천군,내면,계,2689,1773,185,366,22,1106,1679,94,916
4200,강원도,홍천군다선거구,6421203,4212,홍천군,내면,관내사전투표,669,669,97,152,12,383,644,25,0
4200,강원도,홍천군다선거구,6421203,4212,홍천군,내면,선거일투표,2020,1104,88,214,10,723,1035,69,916
4200,강원도,홍천군다선거구,6421203,4212,홍천군,잘못 투입·구분된 투표지,,0,4,0,4,0,0,4,0,-4
4200,강원도,횡성군가선거구,6421301,4213,횡성군,합계,,23279,15425,3448,2943,4162,3530,14083,1342,7854
4200,강원도,횡성군가선거구,6421301,4213,횡성군,거소투표,,33,32,7,5,8,6,26,6,1
4200,강원도,횡성군가선거구,6421301,4213,횡성군,관외사전투표,,1386,1384,372,279,433,210,1294,90,2
4200,강원도,횡성군가선거구,6421301,4213,횡성군,횡성읍,계,16808,10537,2348,1950,2957,2357,9612,925,6271
4200,강원도,횡성군가선거구,6421301,4213,횡성군,횡성읍,관내사전투표,4916,4910,1152,949,1333,1049,4483,427,6
4200,강원도,횡성군가선거구,6421301,4213,횡성군,횡성읍,선거일투표,11892,5627,1196,1001,1624,1308,5129,498,6265
4200,강원도,횡성군가선거구,6421301,4213,횡성군,공근면,계,3205,2201,452,509,476,548,1985,216,1004
4200,강원도,횡성군가선거구,6421301,4213,횡성군,공근면,관내사전투표,1095,1094,242,245,243,259,989,105,1
4200,강원도,횡성군가선거구,6421301,4213,횡성군,공근면,선거일투표,2110,1107,210,264,233,289,996,111,1003
4200,강원도,횡성군가선거구,6421301,4213,횡성군,서원면,계,1847,1257,265,198,286,407,1156,101,590
4200,강원도,횡성군가선거구,6421301,4213,횡성군,서원면,관내사전투표,543,542,107,85,121,183,496,46,1
4200,강원도,횡성군가선거구,6421301,4213,횡성군,서원면,선거일투표,1304,715,158,113,165,224,660,55,589
4200,강원도,횡성군가선거구,6421301,4213,횡성군,잘못 투입·구분된 투표지,,0,14,4,2,2,2,10,4,-14
4200,강원도,횡성군나선거구,6421302,4213,횡성군,합계,,18498,12319,2471,1616,3806,1635,2125,11653,666,6179
4200,강원도,횡성군나선거구,6421302,4213,횡성군,거소투표,,22,18,5,2,4,4,0,15,3,4
4200,강원도,횡성군나선거구,6421302,4213,횡성군,관외사전투표,,1207,1206,329,128,444,130,120,1151,55,1
4200,강원도,횡성군나선거구,6421302,4213,횡성군,우천면,계,3908,2472,273,675,341,766,302,2357,115,1436
4200,강원도,횡성군나선거구,6421302,4213,횡성군,우천면,관내사전투표,955,955,107,258,142,287,126,920,35,0
4200,강원도,횡성군나선거구,6421302,4213,횡성군,우천면,선거일투표,2953,1517,166,417,199,479,176,1437,80,1436
4200,강원도,횡성군나선거구,6421302,4213,횡성군,안흥면,계,2532,1674,290,230,566,122,341,1549,125,858
4200,강원도,횡성군나선거구,6421302,4213,횡성군,안흥면,관내사전투표,759,759,132,102,270,49,161,714,45,0
4200,강원도,횡성군나선거구,6421302,4213,횡성군,안흥면,선거일투표,1773,915,158,128,296,73,180,835,80,858
4200,강원도,횡성군나선거구,6421302,4213,횡성군,둔내면,계,5128,3207,1003,154,1693,95,153,3098,109,1921
4200,강원도,횡성군나선거구,6421302,4213,횡성군,둔내면,관내사전투표,1393,1393,473,81,693,45,62,1354,39,0
4200,강원도,횡성군나선거구,6421302,4213,횡성군,둔내면,선거일투표,3735,1814,530,73,1000,50,91,1744,70,1921
4200,강원도,횡성군나선거구,6421302,4213,횡성군,갑천면,계,2128,1382,212,155,263,124,485,1239,143,746
4200,강원도,횡성군나선거구,6421302,4213,횡성군,갑천면,관내사전투표,574,573,101,65,122,62,196,546,27,1
4200,강원도,횡성군나선거구,6421302,4213,횡성군,갑천면,선거일투표,1554,809,111,90,141,62,289,693,116,745
4200,강원도,횡성군나선거구,6421302,4213,횡성군,청일면,계,2093,1354,181,114,172,288,531,1286,68,739
4200,강원도,횡성군나선거구,6421302,4213,횡성군,청일면,관내사전투표,538,538,94,42,79,83,213,511,27,0
4200,강원도,횡성군나선거구,6421302,4213,횡성군,청일면,선거일투표,1555,816,87,72,93,205,318,775,41,739
4200,강원도,횡성군나선거구,6421302,4213,횡성군,강림면,계,1480,997,173,158,322,104,192,949,48,483
4200,강원도,횡성군나선거구,6421302,4213,횡성군,강림면,관내사전투표,496,495,92,95,155,44,91,477,18,1
4200,강원도,횡성군나선거구,6421302,4213,횡성군,강림면,선거일투표,984,502,81,63,167,60,101,472,30,482
4200,강원도,횡성군나선거구,6421302,4213,횡성군,잘못 투입·구분된 투표지,,0,9,5,0,1,2,1,9,0,-9
4200,강원도,영월군가선거구,6421401,4214,영월군,합계,,18003,11874,2949,1548,3162,2005,1611,11275,599,6129
4200,강원도,영월군가선거구,6421401,4214,영월군,거소투표,,52,52,8,8,14,1,8,39,13,0
4200,강원도,영월군가선거구,6421401,4214,영월군,관외사전투표,,1337,1337,412,158,373,170,162,1275,62,0
4200,강원도,영월군가선거구,6421401,4214,영월군,영월읍,계,12995,8170,1845,1167,2074,1433,1290,7809,361,4825
4200,강원도,영월군가선거구,6421401,4214,영월군,영월읍,관내사전투표,3486,3481,802,497,893,642,494,3328,153,5
4200,강원도,영월군가선거구,6421401,4214,영월군,영월읍,선거일투표,9509,4689,1043,670,1181,791,796,4481,208,4820
4200,강원도,영월군가선거구,6421401,4214,영월군,상동읍,계,900,576,148,59,165,125,36,533,43,324
4200,강원도,영월군가선거구,6421401,4214,영월군,상동읍,관내사전투표,266,265,81,21,65,56,24,247,18,1
4200,강원도,영월군가선거구,6421401,4214,영월군,상동읍,선거일투표,634,311,67,38,100,69,12,286,25,323
4200,강원도,영월군가선거구,6421401,4214,영월군,산솔면,계,1244,792,232,71,249,121,60,733,59,452
4200,강원도,영월군가선거구,6421401,4214,영월군,산솔면,관내사전투표,277,277,92,25,86,41,18,262,15,0
4200,강원도,영월군가선거구,6421401,4214,영월군,산솔면,선거일투표,967,515,140,46,163,80,42,471,44,452
4200,강원도,영월군가선거구,6421401,4214,영월군,김삿갓면,계,1475,940,303,85,286,151,54,879,61,535
4200,강원도,영월군가선거구,6421401,4214,영월군,김삿갓면,관내사전투표,415,415,117,45,127,80,20,389,26,0
4200,강원도,영월군가선거구,6421401,4214,영월군,김삿갓면,선거일투표,1060,525,186,40,159,71,34,490,35,535
4200,강원도,영월군가선거구,6421401,4214,영월군,잘못 투입·구분된 투표지,,0,7,1,0,1,4,1,7,0,-7
4200,강원도,영월군나선거구,6421402,4214,영월군,합계,,16368,10929,2038,1590,2804,1617,1289,1051,10389,540,5439
4200,강원도,영월군나선거구,6421402,4214,영월군,거소투표,,49,45,6,5,11,11,7,2,42,3,4
4200,강원도,영월군나선거구,6421402,4214,영월군,관외사전투표,,1320,1320,316,217,380,141,102,96,1252,68,0
4200,강원도,영월군나선거구,6421402,4214,영월군,영월읍,계,3801,2355,524,296,346,104,761,217,2248,107,1446
4200,강원도,영월군나선거구,6421402,4214,영월군,영월읍,관내사전투표,825,825,204,124,129,26,228,72,783,42,0
4200,강원도,영월군나선거구,6421402,4214,영월군,영월읍,선거일투표,2976,1530,320,172,217,78,533,145,1465,65,1446
4200,강원도,영월군나선거구,6421402,4214,영월군,북면,계,1769,1095,205,183,251,115,148,129,1031,64,674
4200,강원도,영월군나선거구,6421402,4214,영월군,북면,관내사전투표,321,321,50,50,67,33,51,37,288,33,0
4200,강원도,영월군나선거구,6421402,4214,영월군,북면,선거일투표,1448,774,155,133,184,82,97,92,743,31,674
4200,강원도,영월군나선거구,6421402,4214,영월군,남면,계,1992,1347,407,97,279,94,79,318,1274,73,645
4200,강원도,영월군나선거구,6421402,4214,영월군,남면,관내사전투표,542,542,168,39,115,45,33,107,507,35,0
4200,강원도,영월군나선거구,6421402,4214,영월군,남면,선거일투표,1450,805,239,58,164,49,46,211,767,38,645
4200,강원도,영월군나선거구,6421402,4214,영월군,한반도면,계,2423,1501,271,203,366,273,110,199,1422,79,922
4200,강원도,영월군나선거구,6421402,4214,영월군,한반도면,관내사전투표,380,380,67,46,113,75,29,38,368,12,0
4200,강원도,영월군나선거구,6421402,4214,영월군,한반도면,선거일투표,2043,1121,204,157,253,198,81,161,1054,67,922
4200,강원도,영월군나선거구,6421402,4214,영월군,주천면,계,3294,2184,189,427,680,677,51,61,2085,99,1110
4200,강원도,영월군나선거구,6421402,4214,영월군,주천면,관내사전투표,924,924,86,183,269,298,23,27,886,38,0
4200,강원도,영월군나선거구,6421402,4214,영월군,주천면,선거일투표,2370,1260,103,244,411,379,28,34,1199,61,1110
4200,강원도,영월군나선거구,6421402,4214,영월군,무릉도원면,계,1720,1082,120,162,491,202,31,29,1035,47,638
4200,강원도,영월군나선거구,6421402,4214,영월군,무릉도원면,관내사전투표,374,374,42,65,160,69,10,10,356,18,0
4200,강원도,영월군나선거구,6421402,4214,영월군,무릉도원면,선거일투표,1346,708,78,97,331,133,21,19,679,29,638
4200,강원도,영월군나선거구,6421402,4214,영월군,잘못 투입·구분된 투표지,,0,0,0,0,0,0,0,0,0,0,0
4200,강원도,평창군가선거구,6421501,4215,평창군,합계,,16703,11810,2275,980,2139,3694,2188,11276,534,4893
4200,강원도,평창군가선거구,6421501,4215,평창군,거소투표,,26,25,3,0,3,9,7,22,3,1
4200,강원도,평창군가선거구,6421501,4215,평창군,관외사전투표,,1100,1099,289,82,147,368,140,1026,73,1
4200,강원도,평창군가선거구,6421501,4215,평창군,평창읍,계,7052,5064,695,272,1577,1999,305,4848,216,1988
4200,강원도,평창군가선거구,6421501,4215,평창군,평창읍,관내사전투표,2499,2497,344,129,859,910,147,2389,108,2
4200,강원도,평창군가선거구,6421501,4215,평창군,평창읍,선거일투표,4553,2567,351,143,718,1089,158,2459,108,1986
4200,강원도,평창군가선거구,6421501,4215,평창군,미탄면,계,1457,1076,252,92,162,387,121,1014,62,381
4200,강원도,평창군가선거구,6421501,4215,평창군,미탄면,관내사전투표,578,577,141,54,77,216,57,545,32,1
4200,강원도,평창군가선거구,6421501,4215,평창군,미탄면,선거일투표,879,499,111,38,85,171,64,469,30,380
4200,강원도,평창군가선거구,6421501,4215,평창군,방림면,계,2273,1520,353,126,190,576,194,1439,81,753
4200,강원도,평창군가선거구,6421501,4215,평창군,방림면,관내사전투표,445,442,107,38,55,163,55,418,24,3
4200,강원도,평창군가선거구,6421501,4215,평창군,방림면,선거일투표,1828,1078,246,88,135,413,139,1021,57,750
4200,강원도,평창군가선거구,6421501,4215,평창군,봉평면,계,4795,3015,680,407,59,352,1418,2916,99,1780
4200,강원도,평창군가선거구,6421501,4215,평창군,봉평면,관내사전투표,1397,1396,350,184,31,159,627,1351,45,1
4200,강원도,평창군가선거구,6421501,4215,평창군,봉평면,선거일투표,3398,1619,330,223,28,193,791,1565,54,1779
4200,강원도,평창군가선거구,6421501,4215,평창군,잘못 투입·구분된 투표지,,0,11,3,1,1,3,3,11,0,-11
4200,강원도,평창군나선거구,6421502,4215,평창군,합계,,20669,13553,2881,1708,3363,3086,1976,13014,539,7116
4200,강원도,평창군나선거구,6421502,4215,평창군,거소투표,,26,26,5,4,7,6,4,26,0,0
4200,강원도,평창군나선거구,6421502,4215,평창군,관외사전투표,,1308,1307,299,165,474,207,105,1250,57,1
4200,강원도,평창군나선거구,6421502,4215,평창군,대화면,계,4388,2943,318,783,1555,117,42,2815,128,1445
4200,강원도,평창군나선거구,6421502,4215,평창군,대화면,관내사전투표,1272,1272,121,363,686,47,19,1236,36,0
4200,강원도,평창군나선거구,6421502,4215,평창군,대화면,선거일투표,3116,1671,197,420,869,70,23,1579,92,1445
4200,강원도,평창군나선거구,6421502,4215,평창군,용평면,계,2627,1751,277,344,525,403,130,1679,72,876
4200,강원도,평창군나선거구,6421502,4215,평창군,용평면,관내사전투표,692,689,111,127,238,137,49,662,27,3
4200,강원도,평창군나선거구,6421502,4215,평창군,용평면,선거일투표,1935,1062,166,217,287,266,81,1017,45,873
4200,강원도,평창군나선거구,6421502,4215,평창군,진부면,계,7368,4777,1601,247,489,2096,185,4618,159,2591
4200,강원도,평창군나선거구,6421502,4215,평창군,진부면,관내사전투표,2041,2038,699,100,201,886,76,1962,76,3
4200,강원도,평창군나선거구,6421502,4215,평창군,진부면,선거일투표,5327,2739,902,147,288,1210,109,2656,83,2588
4200,강원도,평창군나선거구,6421502,4215,평창군,대관령면,계,4952,2737,380,163,310,255,1508,2616,121,2215
4200,강원도,평창군나선거구,6421502,4215,평창군,대관령면,관내사전투표,1288,1282,179,86,146,110,702,1223,59,6
4200,강원도,평창군나선거구,6421502,4215,평창군,대관령면,선거일투표,3664,1455,201,77,164,145,806,1393,62,2209
4200,강원도,평창군나선거구,6421502,4215,평창군,잘못 투입·구분된 투표지,,0,12,1,2,3,2,2,10,2,-12
4200,강원도,화천군가선거구,6421601,4216,화천군,합계,,9550,6563,1840,770,1227,1317,1087,6241,322,2987
4200,강원도,화천군가선거구,6421601,4216,화천군,거소투표,,87,85,20,4,24,11,10,69,16,2
4200,강원도,화천군가선거구,6421601,4216,화천군,관외사전투표,,850,849,302,99,177,116,122,816,33,1
4200,강원도,화천군가선거구,6421601,4216,화천군,화천읍,계,6312,4081,1270,293,399,1069,856,3887,194,2231
4200,강원도,화천군가선거구,6421601,4216,화천군,화천읍,관내사전투표,1707,1698,510,120,190,448,345,1613,85,9
4200,강원도,화천군가선거구,6421601,4216,화천군,화천읍,선거일투표,4605,2383,760,173,209,621,511,2274,109,2222
4200,강원도,화천군가선거구,6421601,4216,화천군,간동면,계,2301,1535,247,369,625,119,97,1457,78,766
4200,강원도,화천군가선거구,6421601,4216,화천군,간동면,관내사전투표,567,565,106,106,247,44,36,539,26,2
4200,강원도,화천군가선거구,6421601,4216,화천군,간동면,선거일투표,1734,970,141,263,378,75,61,918,52,764
4200,강원도,화천군가선거구,6421601,4216,화천군,잘못 투입·구분된 투표지,,0,13,1,5,2,2,2,12,1,-13
4200,강원도,화천군나선거구,6421602,4216,화천군,합계,,11505,7271,1917,1726,2148,1186,6977,294,4234
4200,강원도,화천군나선거구,6421602,4216,화천군,거소투표,,128,120,25,38,24,11,98,22,8
4200,강원도,화천군나선거구,6421602,4216,화천군,관외사전투표,,992,992,375,281,181,118,955,37,0
4200,강원도,화천군나선거구,6421602,4216,화천군,하남면,계,2236,1537,414,338,459,256,1467,70,699
4200,강원도,화천군나선거구,6421602,4216,화천군,하남면,관내사전투표,523,523,176,94,136,99,505,18,0
4200,강원도,화천군나선거구,6421602,4216,화천군,하남면,선거일투표,1713,1014,238,244,323,157,962,52,699
4200,강원도,화천군나선거구,6421602,4216,화천군,상서면,계,3235,1720,402,405,142,697,1646,74,1515
4200,강원도,화천군나선거구,6421602,4216,화천군,상서면,관내사전투표,585,585,135,145,59,223,562,23,0
4200,강원도,화천군나선거구,6421602,4216,화천군,상서면,선거일투표,2650,1135,267,260,83,474,1084,51,1515
4200,강원도,화천군나선거구,6421602,4216,화천군,사내면,계,4914,2899,701,662,1342,103,2808,91,2015
4200,강원도,화천군나선거구,6421602,4216,화천군,사내면,관내사전투표,1286,1285,330,284,569,58,1241,44,1
4200,강원도,화천군나선거구,6421602,4216,화천군,사내면,선거일투표,3628,1614,371,378,773,45,1567,47,2014
4200,강원도,화천군나선거구,6421602,4216,화천군,잘못 투입·구분된 투표지,,0,3,0,2,0,1,3,0,-3
4200,강원도,양구군가선거구,6421701,4217,양구군,합계,,11188,7619,1924,723,1565,1159,1964,7335,284,3569
4200,강원도,양구군가선거구,6421701,4217,양구군,거소투표,,136,131,35,10,29,18,30,122,9,5
4200,강원도,양구군가선거구,6421701,4217,양구군,관외사전투표,,798,798,213,70,189,95,192,759,39,0
4200,강원도,양구군가선거구,6421701,4217,양구군,양구읍,계,10254,6690,1676,643,1347,1046,1742,6454,236,3564
4200,강원도,양구군가선거구,6421701,4217,양구군,양구읍,관내사전투표,2886,2886,707,274,563,466,778,2788,98,0
4200,강원도,양구군가선거구,6421701,4217,양구군,양구읍,선거일투표,7368,3804,969,369,784,580,964,3666,138,3564
4200,강원도,양구군가선거구,6421701,4217,양구군,잘못 투입·구분된 투표지,,0,0,0,0,0,0,0,0,0,0
4200,강원도,양구군나선거구,6421702,4217,양구군,합계,,7364,5184,911,443,1301,929,555,832,4971,213,2180
4200,강원도,양구군나선거구,6421702,4217,양구군,거소투표,,165,163,31,11,47,16,17,20,142,21,2
4200,강원도,양구군나선거구,6421702,4217,양구군,관외사전투표,,620,620,145,61,160,114,41,74,595,25,0
4200,강원도,양구군나선거구,6421702,4217,양구군,국토정중앙면,계,2775,1826,175,213,803,168,197,193,1749,77,949
4200,강원도,양구군나선거구,6421702,4217,양구군,국토정중앙면,관내사전투표,595,594,53,81,254,53,67,69,577,17,1
4200,강원도,양구군나선거구,6421702,4217,양구군,국토정중앙면,선거일투표,2180,1232,122,132,549,115,130,124,1172,60,948
4200,강원도,양구군나선거구,6421702,4217,양구군,동면,계,1686,1133,247,50,93,355,35,326,1106,27,553
4200,강원도,양구군나선거구,6421702,4217,양구군,동면,관내사전투표,372,372,97,21,37,97,6,104,362,10,0
4200,강원도,양구군나선거구,6421702,4217,양구군,동면,선거일투표,1314,761,150,29,56,258,29,222,744,17,553
4200,강원도,양구군나선거구,6421702,4217,양구군,방산면,계,1038,701,114,70,126,185,64,110,669,32,337
4200,강원도,양구군나선거구,6421702,4217,양구군,방산면,관내사전투표,192,192,42,17,29,43,19,33,183,9,0
4200,강원도,양구군나선거구,6421702,4217,양구군,방산면,선거일투표,846,509,72,53,97,142,45,77,486,23,337
4200,강원도,양구군나선거구,6421702,4217,양구군,해안면,계,1080,741,199,38,72,91,201,109,710,31,339
4200,강원도,양구군나선거구,6421702,4217,양구군,해안면,관내사전투표,346,346,91,18,36,40,87,65,337,9,0
4200,강원도,양구군나선거구,6421702,4217,양구군,해안면,선거일투표,734,395,108,20,36,51,114,44,373,22,339
4200,강원도,양구군나선거구,6421702,4217,양구군,잘못 투입·구분된 투표지,,0,0,0,0,0,0,0,0,0,0,0
4200,강원도,철원군가선거구,6421801,4218,철원군,합계,,17136,10352,1860,1364,2934,1965,1321,376,9820,532,6784
4200,강원도,철원군가선거구,6421801,4218,철원군,거소투표,,144,136,27,13,39,31,5,4,119,17,8
4200,강원도,철원군가선거구,6421801,4218,철원군,관외사전투표,,812,811,188,117,232,130,76,30,773,38,1
4200,강원도,철원군가선거구,6421801,4218,철원군,철원읍,계,4373,2654,497,265,1018,426,195,127,2528,126,1719
4200,강원도,철원군가선거구,6421801,4218,철원군,철원읍,관내사전투표,1073,1073,196,135,398,165,80,47,1021,52,0
4200,강원도,철원군가선거구,6421801,4218,철원군,철원읍,선거일투표,3300,1581,301,130,620,261,115,80,1507,74,1719
4200,강원도,철원군가선거구,6421801,4218,철원군,동송읍,계,11807,6750,1148,969,1645,1377,1045,215,6399,351,5057
4200,강원도,철원군가선거구,6421801,4218,철원군,동송읍,관내사전투표,1925,1924,353,279,471,380,292,58,1833,91,1
4200,강원도,철원군가선거구,6421801,4218,철원군,동송읍,선거일투표,9882,4826,795,690,1174,997,753,157,4566,260,5056
4200,강원도,철원군가선거구,6421801,4218,철원군,잘못 투입·구분된 투표지,,0,1,0,0,0,1,0,0,1,0,-1
4200,강원도,철원군나선거구,6421802,4218,철원군,합계,,19963,12103,2899,1099,3876,1655,1761,11290,813,7860
4200,강원도,철원군나선거구,6421802,4218,철원군,거소투표,,359,325,70,32,80,28,26,236,89,34
4200,강원도,철원군나선거구,6421802,4218,철원군,관외사전투표,,710,710,226,80,220,73,72,671,39,0
4200,강원도,철원군나선거구,6421802,4218,철원군,김화읍,계,2739,1579,398,184,659,125,112,1478,101,1160
4200,강원도,철원군나선거구,6421802,4218,철원군,김화읍,관내사전투표,567,567,131,71,248,47,48,545,22,0
4200,강원도,철원군나선거구,6421802,4218,철원군,김화읍,선거일투표,2172,1012,267,113,411,78,64,933,79,1160
4200,강원도,철원군나선거구,6421802,4218,철원군,갈말읍,계,9660,5680,1462,317,1091,1248,1226,5344,336,3980
4200,강원도,철원군나선거구,6421802,4218,철원군,갈말읍,관내사전투표,1845,1841,470,105,361,408,428,1772,69,4
4200,강원도,철원군나선거구,6421802,4218,철원군,갈말읍,선거일투표,7815,3839,992,212,730,840,798,3572,267,3976
4200,강원도,철원군나선거구,6421802,4218,철원군,서면,계,4585,2571,483,341,1233,110,257,2424,147,2014
4200,강원도,철원군나선거구,6421802,4218,철원군,서면,관내사전투표,966,965,208,126,438,43,94,909,56,1
4200,강원도,철원군나선거구,6421802,4218,철원군,서면,선거일투표,3619,1606,275,215,795,67,163,1515,91,2013
4200,강원도,철원군나선거구,6421802,4218,철원군,근남면,계,1788,1131,234,133,560,57,57,1041,90,657
4200,강원도,철원군나선거구,6421802,4218,철원군,근남면,관내사전투표,370,366,67,42,201,14,13,337,29,4
4200,강원도,철원군나선거구,6421802,4218,철원군,근남면,선거일투표,1418,765,167,91,359,43,44,704,61,653
4200,강원도,철원군나선거구,6421802,4218,철원군,근북면,계,122,94,26,11,27,12,7,83,11,28
4200,강원도,철원군나선거구,6421802,4218,철원군,근북면,관내사전투표,51,50,16,7,15,7,3,48,2,1
4200,강원도,철원군나선거구,6421802,4218,철원군,근북면,선거일투표,71,44,10,4,12,5,4,35,9,27
4200,강원도,철원군나선거구,6421802,4218,철원군,잘못 투입·구분된 투표지,,0,13,0,1,6,2,4,13,0,-134300,충청북도,청주시가선거구,6430101,4301,청주시상당구,합계,,52363,26663,8731,3591,13086,25408,1255,25700
4300,충청북도,청주시가선거구,6430101,4301,청주시상당구,거소투표,,108,97,21,15,43,79,18,11
4300,충청북도,청주시가선거구,6430101,4301,청주시상당구,관외사전투표,,3543,3527,1275,455,1691,3421,106,16
4300,충청북도,청주시가선거구,6430101,4301,청주시상당구,낭성면,계,2025,1219,305,83,734,1122,97,806
4300,충청북도,청주시가선거구,6430101,4301,청주시상당구,낭성면,관내사전투표,564,560,150,46,331,527,33,4
4300,충청북도,청주시가선거구,6430101,4301,청주시상당구,낭성면,선거일투표,1461,659,155,37,403,595,64,802
4300,충청북도,청주시가선거구,6430101,4301,청주시상당구,미원면,계,4290,2324,689,175,1289,2153,171,1966
4300,충청북도,청주시가선거구,6430101,4301,청주시상당구,미원면,관내사전투표,1106,1106,358,85,616,1059,47,0
4300,충청북도,청주시가선거구,6430101,4301,청주시상당구,미원면,선거일투표,3184,1218,331,90,673,1094,124,1966
4300,충청북도,청주시가선거구,6430101,4301,청주시상당구,가덕면,계,3431,1867,557,181,1052,1790,77,1564
4300,충청북도,청주시가선거구,6430101,4301,청주시상당구,가덕면,관내사전투표,701,698,197,62,419,678,20,3
4300,충청북도,청주시가선거구,6430101,4301,청주시상당구,가덕면,선거일투표,2730,1169,360,119,633,1112,57,1561
4300,충청북도,청주시가선거구,6430101,4301,청주시상당구,남일면,계,5882,3002,1069,289,1537,2895,107,2880
4300,충청북도,청주시가선거구,6430101,4301,청주시상당구,남일면,관내사전투표,1186,1184,438,130,591,1159,25,2
4300,충청북도,청주시가선거구,6430101,4301,청주시상당구,남일면,선거일투표,4696,1818,631,159,946,1736,82,2878
4300,충청북도,청주시가선거구,6430101,4301,청주시상당구,문의면,계,3443,1858,572,170,992,1734,124,1585
4300,충청북도,청주시가선거구,6430101,4301,청주시상당구,문의면,관내사전투표,796,793,237,68,456,761,32,3
4300,충청북도,청주시가선거구,6430101,4301,청주시상당구,문의면,선거일투표,2647,1065,335,102,536,973,92,1582
4300,충청북도,청주시가선거구,6430101,4301,청주시상당구,용암제2동,계,29641,12714,4230,2211,5724,12165,549,16927
4300,충청북도,청주시가선거구,6430101,4301,청주시상당구,용암제2동,관내사전투표,2750,2737,943,494,1251,2688,49,13
4300,충청북도,청주시가선거구,6430101,4301,청주시상당구,용암제2동,선거일투표,26891,9977,3287,1717,4473,9477,500,16914
4300,충청북도,청주시가선거구,6430101,4301,청주시상당구,잘못 투입·구분된 투표지,,0,55,13,12,24,49,6,-55
4300,충청북도,청주시나선거구,6430102,4301,청주시상당구,합계,,55903,27486,5302,4137,4205,8317,3749,25710,1776,28417
4300,충청북도,청주시나선거구,6430102,4301,청주시상당구,거소투표,,83,78,10,12,13,27,7,69,9,5
4300,충청북도,청주시나선거구,6430102,4301,청주시상당구,관외사전투표,,2705,2699,629,445,411,783,263,2531,168,6
4300,충청북도,청주시나선거구,6430102,4301,청주시상당구,중앙동,계,5759,2724,596,346,233,998,346,2519,205,3035
4300,충청북도,청주시나선거구,6430102,4301,청주시상당구,중앙동,관내사전투표,937,914,222,125,95,297,100,839,75,23
4300,충청북도,청주시나선거구,6430102,4301,청주시상당구,중앙동,선거일투표,4822,1810,374,221,138,701,246,1680,130,3012
4300,충청북도,청주시나선거구,6430102,4301,청주시상당구,성안동,계,6247,2976,562,379,253,932,614,2740,236,3271
4300,충청북도,청주시나선거구,6430102,4301,청주시상당구,성안동,관내사전투표,1059,1025,207,137,123,307,184,958,67,34
4300,충청북도,청주시나선거구,6430102,4301,청주시상당구,성안동,선거일투표,5188,1951,355,242,130,625,430,1782,169,3237
4300,충청북도,청주시나선거구,6430102,4301,청주시상당구,탑·대성동,계,6682,2910,477,401,323,932,580,2713,197,3772
4300,충청북도,청주시나선거구,6430102,4301,청주시상당구,탑·대성동,관내사전투표,1157,1136,172,142,114,383,243,1054,82,21
4300,충청북도,청주시나선거구,6430102,4301,청주시상당구,탑·대성동,선거일투표,5525,1774,305,259,209,549,337,1659,115,3751
4300,충청북도,청주시나선거구,6430102,4301,청주시상당구,금천동,계,24747,11315,2014,1917,1929,3470,1308,10638,677,13432
4300,충청북도,청주시나선거구,6430102,4301,청주시상당구,금천동,관내사전투표,3381,3376,623,567,542,1055,372,3159,217,5
4300,충청북도,청주시나선거구,6430102,4301,청주시상당구,금천동,선거일투표,21366,7939,1391,1350,1387,2415,936,7479,460,13427
4300,충청북도,청주시나선거구,6430102,4301,청주시상당구,용담·명암·산성동,계,9680,4687,998,625,1034,1145,609,4411,276,4993
4300,충청북도,청주시나선거구,6430102,4301,청주시상당구,용담·명암·산성동,관내사전투표,1648,1644,356,204,375,392,210,1537,107,4
4300,충청북도,청주시나선거구,6430102,4301,청주시상당구,용담·명암·산성동,선거일투표,8032,3043,642,421,659,753,399,2874,169,4989
4300,충청북도,청주시나선거구,6430102,4301,청주시상당구,잘못 투입·구분된 투표지,,0,97,16,12,9,30,22,89,8,-97
4300,충청북도,청주시다선거구,6430103,4301,청주시상당구,합계,,54792,25448,5700,1957,4116,6432,4790,820,23815,1633,29344
4300,충청북도,청주시다선거구,6430103,4301,청주시상당구,거소투표,,75,69,18,9,4,21,10,0,62,7,6
4300,충청북도,청주시다선거구,6430103,4301,청주시상당구,관외사전투표,,3912,3912,1022,297,672,873,654,153,3671,241,0
4300,충청북도,청주시다선거구,6430103,4301,청주시상당구,영운동,계,9062,4041,871,500,322,1220,682,121,3716,325,5021
4300,충청북도,청주시다선거구,6430103,4301,청주시상당구,영운동,관내사전투표,1565,1565,341,219,125,473,238,49,1445,120,0
4300,충청북도,청주시다선거구,6430103,4301,청주시상당구,영운동,선거일투표,7497,2476,530,281,197,747,444,72,2271,205,5021
4300,충청북도,청주시다선거구,6430103,4301,청주시상당구,용암제1동,계,41743,17419,3789,1149,3118,4317,3442,546,16361,1058,24324
4300,충청북도,청주시다선거구,6430103,4301,청주시상당구,용암제1동,관내사전투표,4163,4163,852,250,711,1116,830,113,3872,291,0
4300,충청북도,청주시다선거구,6430103,4301,청주시상당구,용암제1동,선거일투표,37580,13256,2937,899,2407,3201,2612,433,12489,767,24324
4300,충청북도,청주시다선거구,6430103,4301,청주시상당구,잘못 투입·구분된 투표지,,0,7,0,2,0,1,2,0,5,2,-7
4300,충청북도,청주시라선거구,6431401,4314,청주시서원구,합계,,57738,28839,8279,5159,9388,3085,25911,2928,28899
4300,충청북도,청주시라선거구,6431401,4314,청주시서원구,거소투표,,182,169,48,25,49,18,140,29,13
4300,충청북도,청주시라선거구,6431401,4314,청주시서원구,관외사전투표,,3488,3479,1055,593,1145,337,3130,349,9
4300,충청북도,청주시라선거구,6431401,4314,청주시서원구,남이면,계,8287,3893,976,600,1395,461,3432,461,4394
4300,충청북도,청주시라선거구,6431401,4314,청주시서원구,남이면,관내사전투표,1018,1016,250,140,375,117,882,134,2
4300,충청북도,청주시라선거구,6431401,4314,청주시서원구,남이면,선거일투표,7269,2877,726,460,1020,344,2550,327,4392
4300,충청북도,청주시라선거구,6431401,4314,청주시서원구,현도면,계,2783,1353,290,173,587,137,1187,166,1430
4300,충청북도,청주시라선거구,6431401,4314,청주시서원구,현도면,관내사전투표,563,559,139,82,246,50,517,42,4
4300,충청북도,청주시라선거구,6431401,4314,청주시서원구,현도면,선거일투표,2220,794,151,91,341,87,670,124,1426
4300,충청북도,청주시라선거구,6431401,4314,청주시서원구,산남동,계,19469,8944,2388,2041,2711,932,8072,872,10525
4300,충청북도,청주시라선거구,6431401,4314,청주시서원구,산남동,관내사전투표,2693,2691,693,725,801,253,2472,219,2
4300,충청북도,청주시라선거구,6431401,4314,청주시서원구,산남동,선거일투표,16776,6253,1695,1316,1910,679,5600,653,10523
4300,충청북도,청주시라선거구,6431401,4314,청주시서원구,분평동,계,23529,10974,3516,1723,3490,1197,9926,1048,12555
4300,충청북도,청주시라선거구,6431401,4314,청주시서원구,분평동,관내사전투표,4299,4296,1344,741,1310,449,3844,452,3
4300,충청북도,청주시라선거구,6431401,4314,청주시서원구,분평동,선거일투표,19230,6678,2172,982,2180,748,6082,596,12552
4300,충청북도,청주시라선거구,6431401,4314,청주시서원구,잘못 투입·구분된 투표지,,0,27,6,4,11,3,24,3,-27
4300,충청북도,청주시마선거구,6431402,4314,청주시서원구,합계,,57884,28792,7891,3712,8344,5794,434,277,26452,2340,29092
4300,충청북도,청주시마선거구,6431402,4314,청주시서원구,거소투표,,121,117,34,14,30,18,0,1,97,20,4
4300,충청북도,청주시마선거구,6431402,4314,청주시서원구,관외사전투표,,3445,3444,1037,520,990,532,55,53,3187,257,1
4300,충청북도,청주시마선거구,6431402,4314,청주시서원구,사직제1동,계,5297,2596,683,263,807,545,40,24,2362,234,2701
4300,충청북도,청주시마선거구,6431402,4314,청주시서원구,사직제1동,관내사전투표,816,816,201,86,256,159,14,12,728,88,0
4300,충청북도,청주시마선거구,6431402,4314,청주시서원구,사직제1동,선거일투표,4481,1780,482,177,551,386,26,12,1634,146,2701
4300,충청북도,청주시마선거구,6431402,4314,청주시서원구,사직제2동,계,10144,5339,1343,723,1938,833,84,54,4975,364,4805
4300,충청북도,청주시마선거구,6431402,4314,청주시서원구,사직제2동,관내사전투표,1194,1194,301,175,390,183,20,13,1082,112,0
4300,충청북도,청주시마선거구,6431402,4314,청주시서원구,사직제2동,선거일투표,8950,4145,1042,548,1548,650,64,41,3893,252,4805
4300,충청북도,청주시마선거구,6431402,4314,청주시서원구,모충동,계,14047,5863,1657,800,1681,1101,79,53,5371,492,8184
4300,충청북도,청주시마선거구,6431402,4314,청주시서원구,모충동,관내사전투표,1505,1505,428,191,427,283,19,9,1357,148,0
4300,충청북도,청주시마선거구,6431402,4314,청주시서원구,모충동,선거일투표,12542,4358,1229,609,1254,818,60,44,4014,344,8184
4300,충청북도,청주시마선거구,6431402,4314,청주시서원구,수곡제1동,계,11491,4885,1288,572,1236,1249,86,48,4479,406,6606
4300,충청북도,청주시마선거구,6431402,4314,청주시서원구,수곡제1동,관내사전투표,1592,1592,425,184,366,401,27,19,1422,170,0
4300,충청북도,청주시마선거구,6431402,4314,청주시서원구,수곡제1동,선거일투표,9899,3293,863,388,870,848,59,29,3057,236,6606
4300,충청북도,청주시마선거구,6431402,4314,청주시서원구,수곡제2동,계,13339,6545,1849,819,1660,1516,90,44,5978,567,6794
4300,충청북도,청주시마선거구,6431402,4314,청주시서원구,수곡제2동,관내사전투표,2329,2329,662,259,588,558,20,17,2104,225,0
4300,충청북도,청주시마선거구,6431402,4314,청주시서원구,수곡제2동,선거일투표,11010,4216,1187,560,1072,958,70,27,3874,342,6794
4300,충청북도,청주시마선거구,6431402,4314,청주시서원구,잘못 투입·구분된 투표지,,0,3,0,1,2,0,0,0,3,0,-3
4300,충청북도,청주시바선거구,6431403,4314,청주시서원구,합계,,49831,22664,5898,4072,7800,2512,20282,2382,27167
4300,충청북도,청주시바선거구,6431403,4314,청주시서원구,거소투표,,77,74,23,11,20,9,63,11,3
4300,충청북도,청주시바선거구,6431403,4314,청주시서원구,관외사전투표,,2836,2829,897,523,892,245,2557,272,7
4300,충청북도,청주시바선거구,6431403,4314,청주시서원구,사창동,계,13433,5529,1284,756,2075,769,4884,645,7904
4300,충청북도,청주시바선거구,6431403,4314,청주시서원구,사창동,관내사전투표,2243,2234,542,331,809,319,2001,233,9
4300,충청북도,청주시바선거구,6431403,4314,청주시서원구,사창동,선거일투표,11190,3295,742,425,1266,450,2883,412,7895
4300,충청북도,청주시바선거구,6431403,4314,청주시서원구,성화·개신·죽림동,계,33485,14201,3688,2774,4806,1485,12753,1448,19284
4300,충청북도,청주시바선거구,6431403,4314,청주시서원구,성화·개신·죽림동,관내사전투표,3582,3576,869,780,1139,367,3155,421,6
4300,충청북도,청주시바선거구,6431403,4314,청주시서원구,성화·개신·죽림동,선거일투표,29903,10625,2819,1994,3667,1118,9598,1027,19278
4300,충청북도,청주시바선거구,6431403,4314,청주시서원구,잘못 투입·구분된 투표지,,0,31,6,8,7,4,25,6,-31
4300,충청북도,청주시사선거구,6430201,4302,청주시흥덕구,합계,,54581,24669,5817,3931,7205,4489,998,627,23067,1602,29912
4300,충청북도,청주시사선거구,6430201,4302,청주시흥덕구,거소투표,,64,58,11,13,19,9,2,0,54,4,6
4300,충청북도,청주시사선거구,6430201,4302,청주시흥덕구,관외사전투표,,3062,3061,802,501,899,484,144,37,2867,194,1
4300,충청북도,청주시사선거구,6430201,4302,청주시흥덕구,오송읍,계,18998,8091,1857,1245,3071,807,226,371,7577,514,10907
4300,충청북도,청주시사선거구,6430201,4302,청주시흥덕구,오송읍,관내사전투표,2017,2016,470,294,742,238,42,96,1882,134,1
4300,충청북도,청주시사선거구,6430201,4302,청주시흥덕구,오송읍,선거일투표,16981,6075,1387,951,2329,569,184,275,5695,380,10906
4300,충청북도,청주시사선거구,6430201,4302,청주시흥덕구,강내면,계,8980,4292,772,1008,1275,702,118,128,4003,289,4688
4300,충청북도,청주시사선거구,6430201,4302,청주시흥덕구,강내면,관내사전투표,1835,1834,343,438,533,278,49,58,1699,135,1
4300,충청북도,청주시사선거구,6430201,4302,청주시흥덕구,강내면,선거일투표,7145,2458,429,570,742,424,69,70,2304,154,4687
4300,충청북도,청주시사선거구,6430201,4302,청주시흥덕구,강서제1동,계,23477,9165,2374,1164,1940,2487,508,91,8564,601,14312
4300,충청북도,청주시사선거구,6430201,4302,청주시흥덕구,강서제1동,관내사전투표,2274,2274,622,260,401,698,89,24,2094,180,0
4300,충청북도,청주시사선거구,6430201,4302,청주시흥덕구,강서제1동,선거일투표,21203,6891,1752,904,1539,1789,419,67,6470,421,14312
4300,충청북도,청주시사선거구,6430201,4302,청주시흥덕구,잘못 투입·구분된 투표지,,0,2,1,0,1,0,0,0,2,0,-2
4300,충청북도,청주시아선거구,6430202,4302,청주시흥덕구,합계,,60155,25550,6435,3862,8484,4416,606,23803,1747,34605
4300,충청북도,청주시아선거구,6430202,4302,청주시흥덕구,거소투표,,85,76,14,15,27,7,5,68,8,9
4300,충청북도,청주시아선거구,6430202,4302,청주시흥덕구,관외사전투표,,2620,2617,722,407,906,305,98,2438,179,3
4300,충청북도,청주시아선거구,6430202,4302,청주시흥덕구,옥산면,계,14058,5856,1347,987,2630,470,81,5515,341,8202
4300,충청북도,청주시아선거구,6430202,4302,청주시흥덕구,옥산면,관내사전투표,1744,1741,404,302,797,115,15,1633,108,3
4300,충청북도,청주시아선거구,6430202,4302,청주시흥덕구,옥산면,선거일투표,12314,4115,943,685,1833,355,66,3882,233,8199
4300,충청북도,청주시아선거구,6430202,4302,청주시흥덕구,운천·신봉동,계,13968,6050,1589,774,1812,1267,172,5614,436,7918
4300,충청북도,청주시아선거구,6430202,4302,청주시흥덕구,운천·신봉동,관내사전투표,1360,1360,400,182,382,274,43,1281,79,0
4300,충청북도,청주시아선거구,6430202,4302,청주시흥덕구,운천·신봉동,선거일투표,12608,4690,1189,592,1430,993,129,4333,357,7918
4300,충청북도,청주시아선거구,6430202,4302,청주시흥덕구,봉명제2·송정동,계,19731,6963,1712,982,1766,1836,159,6455,508,12768
4300,충청북도,청주시아선거구,6430202,4302,청주시흥덕구,봉명제2·송정동,관내사전투표,2217,2215,562,304,524,597,40,2027,188,2
4300,충청북도,청주시아선거구,6430202,4302,청주시흥덕구,봉명제2·송정동,선거일투표,17514,4748,1150,678,1242,1239,119,4428,320,12766
4300,충청북도,청주시아선거구,6430202,4302,청주시흥덕구,강서제2동,계,9693,3979,1049,695,1342,529,91,3706,273,5714
4300,충청북도,청주시아선거구,6430202,4302,청주시흥덕구,강서제2동,관내사전투표,1322,1322,361,242,450,155,27,1235,87,0
4300,충청북도,청주시아선거구,6430202,4302,청주시흥덕구,강서제2동,선거일투표,8371,2657,688,453,892,374,64,2471,186,5714
4300,충청북도,청주시아선거구,6430202,4302,청주시흥덕구,잘못 투입·구분된 투표지,,0,9,2,2,1,2,0,7,2,-9
4300,충청북도,청주시자선거구,6430203,4302,청주시흥덕구,합계,,48561,20487,5536,3753,9588,868,19745,742,28074
4300,충청북도,청주시자선거구,6430203,4302,청주시흥덕구,거소투표,,51,49,21,6,18,3,48,1,2
4300,충청북도,청주시자선거구,6430203,4302,청주시흥덕구,관외사전투표,,2222,2217,679,357,1002,103,2141,76,5
4300,충청북도,청주시자선거구,6430203,4302,청주시흥덕구,복대제1동,계,37881,15290,4045,2992,7027,658,14722,568,22591
4300,충청북도,청주시자선거구,6430203,4302,청주시흥덕구,복대제1동,관내사전투표,3711,3705,976,809,1664,159,3608,97,6
4300,충청북도,청주시자선거구,6430203,4302,청주시흥덕구,복대제1동,선거일투표,34170,11585,3069,2183,5363,499,11114,471,22585
4300,충청북도,청주시자선거구,6430203,4302,청주시흥덕구,봉명제1동,계,8407,2914,789,394,1531,104,2818,96,5493
4300,충청북도,청주시자선거구,6430203,4302,청주시흥덕구,봉명제1동,관내사전투표,942,942,285,136,458,31,910,32,0
4300,충청북도,청주시자선거구,6430203,4302,청주시흥덕구,봉명제1동,선거일투표,7465,1972,504,258,1073,73,1908,64,5493
4300,충청북도,청주시자선거구,6430203,4302,청주시흥덕구,잘못 투입·구분된 투표지,,0,17,2,4,10,0,16,1,-17
4300,충청북도,청주시차선거구,6430601,4302,청주시흥덕구,합계,,60321,27563,7477,4663,9887,3062,600,25689,1874,32758
4300,충청북도,청주시차선거구,6430601,4302,청주시흥덕구,거소투표,,91,85,23,12,32,9,4,80,5,6
4300,충청북도,청주시차선거구,6430601,4302,청주시흥덕구,관외사전투표,,3893,3891,1111,759,1292,359,121,3642,249,2
4300,충청북도,청주시차선거구,6430601,4302,청주시흥덕구,복대제2동,계,14096,5525,1419,564,2521,475,117,5096,429,8571
4300,충청북도,청주시차선거구,6430601,4302,청주시흥덕구,복대제2동,관내사전투표,1644,1638,441,176,756,119,30,1522,116,6
4300,충청북도,청주시차선거구,6430601,4302,청주시흥덕구,복대제2동,선거일투표,12452,3887,978,388,1765,356,87,3574,313,8565
4300,충청북도,청주시차선거구,6430601,4302,청주시흥덕구,가경동,계,42241,18036,4916,3326,6031,2219,358,16850,1186,24205
4300,충청북도,청주시차선거구,6430601,4302,청주시흥덕구,가경동,관내사전투표,3885,3870,1105,727,1161,532,63,3588,282,15
4300,충청북도,청주시차선거구,6430601,4302,청주시흥덕구,가경동,선거일투표,38356,14166,3811,2599,4870,1687,295,13262,904,24190
4300,충청북도,청주시차선거구,6430601,4302,청주시흥덕구,잘못 투입·구분된 투표지,,0,26,8,2,11,0,0,21,5,-26
4300,충청북도,청주시카선거구,6430602,4306,청주시청원구,합계,,34592,16859,6643,5964,3514,16121,738,17733
4300,충청북도,청주시카선거구,6430602,4306,청주시청원구,거소투표,,60,47,14,18,11,43,4,13
4300,충청북도,청주시카선거구,6430602,4306,청주시청원구,관외사전투표,,2227,2227,1005,840,317,2162,65,0
4300,충청북도,청주시카선거구,6430602,4306,청주시청원구,내수읍,계,15644,7000,2820,2438,1440,6698,302,8644
4300,충청북도,청주시카선거구,6430602,4306,청주시청원구,내수읍,관내사전투표,2369,2342,920,801,556,2277,65,27
4300,충청북도,청주시카선거구,6430602,4306,청주시청원구,내수읍,선거일투표,13275,4658,1900,1637,884,4421,237,8617
4300,충청북도,청주시카선거구,6430602,4306,청주시청원구,북이면,계,3948,2097,438,596,920,1954,143,1851
4300,충청북도,청주시카선거구,6430602,4306,청주시청원구,북이면,관내사전투표,656,655,133,188,307,628,27,1
4300,충청북도,청주시카선거구,6430602,4306,청주시청원구,북이면,선거일투표,3292,1442,305,408,613,1326,116,1850
4300,충청북도,청주시카선거구,6430602,4306,청주시청원구,오근장동,계,12713,5453,2349,2063,817,5229,224,7260
4300,충청북도,청주시카선거구,6430602,4306,청주시청원구,오근장동,관내사전투표,1059,1054,374,452,203,1029,25,5
4300,충청북도,청주시카선거구,6430602,4306,청주시청원구,오근장동,선거일투표,11654,4399,1975,1611,614,4200,199,7255
4300,충청북도,청주시카선거구,6430602,4306,청주시청원구,잘못 투입·구분된 투표지,,0,35,17,9,9,35,0,-35
4300,충청북도,청주시타선거구,6430603,4306,청주시청원구,합계,,54363,22800,6056,4852,4782,5519,303,21512,1288,31563
4300,충청북도,청주시타선거구,6430603,4306,청주시청원구,거소투표,,89,83,15,14,14,32,1,76,7,6
4300,충청북도,청주시타선거구,6430603,4306,청주시청원구,관외사전투표,,2512,2511,718,436,605,538,52,2349,162,1
4300,충청북도,청주시타선거구,6430603,4306,청주시청원구,오창읍,계,51762,20191,5319,4398,4160,4945,250,19072,1119,31571
4300,충청북도,청주시타선거구,6430603,4306,청주시청원구,오창읍,관내사전투표,3640,3632,846,770,702,1031,39,3388,244,8
4300,충청북도,청주시타선거구,6430603,4306,청주시청원구,오창읍,선거일투표,48122,16559,4473,3628,3458,3914,211,15684,875,31563
4300,충청북도,청주시타선거구,6430603,4306,청주시청원구,잘못 투입·구분된 투표지,,0,15,4,4,3,4,0,15,0,-15
4300,충청북도,청주시파선거구,6430604,4306,청주시청원구,검색된 결과가 없습니다.
4300,충청북도,청주시하선거구,6430605,4306,청주시청원구,합계,,40542,18615,7867,8029,2153,18049,566,21927
4300,충청북도,청주시하선거구,6430605,4306,청주시청원구,거소투표,,58,53,23,19,9,51,2,5
4300,충청북도,청주시하선거구,6430605,4306,청주시청원구,관외사전투표,,2557,2554,1212,1018,273,2503,51,3
4300,충청북도,청주시하선거구,6430605,4306,청주시청원구,율량·사천동,계,37927,15987,6623,6984,1871,15478,509,21940
4300,충청북도,청주시하선거구,6430605,4306,청주시청원구,율량·사천동,관내사전투표,3345,3339,1445,1401,423,3269,70,6
4300,충청북도,청주시하선거구,6430605,4306,청주시청원구,율량·사천동,선거일투표,34582,12648,5178,5583,1448,12209,439,21934
4300,충청북도,청주시하선거구,6430605,4306,청주시청원구,잘못 투입·구분된 투표지,,0,21,9,8,0,17,4,-21
4300,충청북도,충주시가선거구,6430301,4303,충주시,합계,,19282,9227,1610,1858,2429,2507,8404,823,10055
4300,충청북도,충주시가선거구,6430301,4303,충주시,거소투표,,18,16,4,3,3,5,15,1,2
4300,충청북도,충주시가선거구,6430301,4303,충주시,관외사전투표,,1074,1072,253,186,396,157,992,80,2
4300,충청북도,충주시가선거구,6430301,4303,충주시,신니면,계,2650,1469,199,407,360,285,1251,218,1181
4300,충청북도,충주시가선거구,6430301,4303,충주시,신니면,관내사전투표,614,613,78,175,180,120,553,60,1
4300,충청북도,충주시가선거구,6430301,4303,충주시,신니면,선거일투표,2036,856,121,232,180,165,698,158,1180
4300,충청북도,충주시가선거구,6430301,4303,충주시,노은면,계,2021,1090,166,195,254,385,1000,90,931
4300,충청북도,충주시가선거구,6430301,4303,충주시,노은면,관내사전투표,567,567,77,89,140,203,509,58,0
4300,충청북도,충주시가선거구,6430301,4303,충주시,노은면,선거일투표,1454,523,89,106,114,182,491,32,931
4300,충청북도,충주시가선거구,6430301,4303,충주시,앙성면,계,3620,1910,250,187,259,1065,1761,149,1710
4300,충청북도,충주시가선거구,6430301,4303,충주시,앙성면,관내사전투표,758,758,105,98,95,401,699,59,0
4300,충청북도,충주시가선거구,6430301,4303,충주시,앙성면,선거일투표,2862,1152,145,89,164,664,1062,90,1710
4300,충청북도,충주시가선거구,6430301,4303,충주시,중앙탑면,계,9899,3658,737,874,1153,609,3373,285,6241
4300,충청북도,충주시가선거구,6430301,4303,충주시,중앙탑면,관내사전투표,968,960,204,220,302,152,878,82,8
4300,충청북도,충주시가선거구,6430301,4303,충주시,중앙탑면,선거일투표,8931,2698,533,654,851,457,2495,203,6233
4300,충청북도,충주시가선거구,6430301,4303,충주시,잘못 투입·구분된 투표지,,0,12,1,6,4,1,12,0,-12
4300,충청북도,충주시나선거구,6430302,4303,충주시,합계,,17540,8812,2240,4431,1801,8472,340,8728
4300,충청북도,충주시나선거구,6430302,4303,충주시,거소투표,,30,25,7,11,5,23,2,5
4300,충청북도,충주시나선거구,6430302,4303,충주시,관외사전투표,,912,910,371,419,92,882,28,2
4300,충청북도,충주시나선거구,6430302,4303,충주시,주덕읍,계,4372,2287,411,719,1074,2204,83,2085
4300,충청북도,충주시나선거구,6430302,4303,충주시,주덕읍,관내사전투표,1027,1002,194,321,452,967,35,25
4300,충청북도,충주시나선거구,6430302,4303,충주시,주덕읍,선거일투표,3345,1285,217,398,622,1237,48,2060
4300,충청북도,충주시나선거구,6430302,4303,충주시,살미면,계,1834,1074,228,748,59,1035,39,760
4300,충청북도,충주시나선거구,6430302,4303,충주시,살미면,관내사전투표,401,400,97,262,24,383,17,1
4300,충청북도,충주시나선거구,6430302,4303,충주시,살미면,선거일투표,1433,674,131,486,35,652,22,759
4300,충청북도,충주시나선거구,6430302,4303,충주시,수안보면,계,2600,1591,250,1214,64,1528,63,1009
4300,충청북도,충주시나선거구,6430302,4303,충주시,수안보면,관내사전투표,598,598,114,430,27,571,27,0
4300,충청북도,충주시나선거구,6430302,4303,충주시,수안보면,선거일투표,2002,993,136,784,37,957,36,1009
4300,충청북도,충주시나선거구,6430302,4303,충주시,대소원면,계,7792,2895,970,1313,490,2773,122,4897
4300,충청북도,충주시나선거구,6430302,4303,충주시,대소원면,관내사전투표,1075,1075,388,451,198,1037,38,0
4300,충청북도,충주시나선거구,6430302,4303,충주시,대소원면,선거일투표,6717,1820,582,862,292,1736,84,4897
4300,충청북도,충주시나선거구,6430302,4303,충주시,잘못 투입·구분된 투표지,,0,30,3,7,17,27,3,-30
4300,충청북도,충주시다선거구,6430303,4303,충주시,합계,,36462,17568,4361,2486,6984,2303,16134,1434,18894
4300,충청북도,충주시다선거구,6430303,4303,충주시,거소투표,,58,57,18,14,12,8,52,5,1
4300,충청북도,충주시다선거구,6430303,4303,충주시,관외사전투표,,2312,2311,568,336,972,265,2141,170,1
4300,충청북도,충주시다선거구,6430303,4303,충주시,용산동,계,11367,4926,1229,701,1834,728,4492,434,6441
4300,충청북도,충주시다선거구,6430303,4303,충주시,용산동,관내사전투표,1849,1849,438,282,706,299,1725,124,0
4300,충청북도,충주시다선거구,6430303,4303,충주시,용산동,선거일투표,9518,3077,791,419,1128,429,2767,310,6441
4300,충청북도,충주시다선거구,6430303,4303,충주시,지현동,계,4408,2203,537,272,901,310,2020,183,2205
4300,충청북도,충주시다선거구,6430303,4303,충주시,지현동,관내사전투표,930,928,239,114,361,141,855,73,2
4300,충청북도,충주시다선거구,6430303,4303,충주시,지현동,선거일투표,3478,1275,298,158,540,169,1165,110,2203
4300,충청북도,충주시다선거구,6430303,4303,충주시,호암·직동,계,14855,6484,1735,959,2431,848,5973,511,8371
4300,충청북도,충주시다선거구,6430303,4303,충주시,호암·직동,관내사전투표,2415,2414,652,363,887,309,2211,203,1
4300,충청북도,충주시다선거구,6430303,4303,충주시,호암·직동,선거일투표,12440,4070,1083,596,1544,539,3762,308,8370
4300,충청북도,충주시다선거구,6430303,4303,충주시,달천동,계,3462,1575,269,202,831,144,1446,129,1887
4300,충청북도,충주시다선거구,6430303,4303,충주시,달천동,관내사전투표,607,606,113,79,291,65,548,58,1
4300,충청북도,충주시다선거구,6430303,4303,충주시,달천동,선거일투표,2855,969,156,123,540,79,898,71,1886
4300,충청북도,충주시다선거구,6430303,4303,충주시,잘못 투입·구분된 투표지,,0,12,5,2,3,0,10,2,-12
4300,충청북도,충주시라선거구,6430304,4303,충주시,합계,,57251,27522,5709,2937,2415,6857,4143,3523,25584,1938,29729
4300,충청북도,충주시라선거구,6430304,4303,충주시,거소투표,,105,94,23,12,13,18,11,4,81,13,11
4300,충청북도,충주시라선거구,6430304,4303,충주시,관외사전투표,,3499,3495,871,370,299,883,513,321,3257,238,4
4300,충청북도,충주시라선거구,6430304,4303,충주시,교현·안림동,계,18492,8488,1632,779,951,1935,964,1689,7950,538,10004
4300,충청북도,충주시라선거구,6430304,4303,충주시,교현·안림동,관내사전투표,2721,2720,532,245,336,562,282,592,2549,171,1
4300,충청북도,충주시라선거구,6430304,4303,충주시,교현·안림동,선거일투표,15771,5768,1100,534,615,1373,682,1097,5401,367,10003
4300,충청북도,충주시라선거구,6430304,4303,충주시,교현2동,계,5881,2714,499,336,177,856,391,274,2533,181,3167
4300,충청북도,충주시라선거구,6430304,4303,충주시,교현2동,관내사전투표,984,984,179,130,77,303,135,101,925,59,0
4300,충청북도,충주시라선거구,6430304,4303,충주시,교현2동,선거일투표,4897,1730,320,206,100,553,256,173,1608,122,3167
4300,충청북도,충주시라선거구,6430304,4303,충주시,연수동,계,29274,12729,2684,1440,975,3164,2263,1235,11761,968,16545
4300,충청북도,충주시라선거구,6430304,4303,충주시,연수동,관내사전투표,3937,3937,815,491,270,937,736,399,3648,289,0
4300,충청북도,충주시라선거구,6430304,4303,충주시,연수동,선거일투표,25337,8792,1869,949,705,2227,1527,836,8113,679,16545
4300,충청북도,충주시라선거구,6430304,4303,충주시,잘못 투입·구분된 투표지,,0,2,0,0,0,1,1,0,2,0,-2
4300,충청북도,충주시마선거구,6430305,4303,충주시,합계,,13629,8029,2089,2781,1006,1838,7714,315,5600
4300,충청북도,충주시마선거구,6430305,4303,충주시,거소투표,,31,24,3,17,1,2,23,1,7
4300,충청북도,충주시마선거구,6430305,4303,충주시,관외사전투표,,802,800,304,309,81,91,785,15,2
4300,충청북도,충주시마선거구,6430305,4303,충주시,금가면,계,3228,1558,690,344,375,103,1512,46,1670
4300,충청북도,충주시마선거구,6430305,4303,충주시,금가면,관내사전투표,621,616,292,142,131,36,601,15,5
4300,충청북도,충주시마선거구,6430305,4303,충주시,금가면,선거일투표,2607,942,398,202,244,67,911,31,1665
4300,충청북도,충주시마선거구,6430305,4303,충주시,동량면,계,3087,1700,381,844,186,210,1621,79,1387
4300,충청북도,충주시마선거구,6430305,4303,충주시,동량면,관내사전투표,654,654,154,347,59,65,625,29,0
4300,충청북도,충주시마선거구,6430305,4303,충주시,동량면,선거일투표,2433,1046,227,497,127,145,996,50,1387
4300,충청북도,충주시마선거구,6430305,4303,충주시,산척면,계,2031,1230,234,462,164,296,1156,74,801
4300,충청북도,충주시마선거구,6430305,4303,충주시,산척면,관내사전투표,504,503,97,207,81,98,483,20,1
4300,충청북도,충주시마선거구,6430305,4303,충주시,산척면,선거일투표,1527,727,137,255,83,198,673,54,800
4300,충청북도,충주시마선거구,6430305,4303,충주시,엄정면,계,2846,1788,295,478,111,841,1725,63,1058
4300,충청북도,충주시마선거구,6430305,4303,충주시,엄정면,관내사전투표,916,914,146,274,46,402,868,46,2
4300,충청북도,충주시마선거구,6430305,4303,충주시,엄정면,선거일투표,1930,874,149,204,65,439,857,17,1056
4300,충청북도,충주시마선거구,6430305,4303,충주시,소태면,계,1604,916,179,325,85,290,879,37,688
4300,충청북도,충주시마선거구,6430305,4303,충주시,소태면,관내사전투표,322,321,59,128,25,104,316,5,1
4300,충청북도,충주시마선거구,6430305,4303,충주시,소태면,선거일투표,1282,595,120,197,60,186,563,32,687
4300,충청북도,충주시마선거구,6430305,4303,충주시,잘못 투입·구분된 투표지,,0,13,3,2,3,5,13,0,-13
4300,충청북도,충주시바선거구,6430306,4303,충주시,합계,,17756,8643,2503,1318,4532,8353,290,9113
4300,충청북도,충주시바선거구,6430306,4303,충주시,거소투표,,39,36,12,8,15,35,1,3
4300,충청북도,충주시바선거구,6430306,4303,충주시,관외사전투표,,1018,1017,311,189,480,980,37,1
4300,충청북도,충주시바선거구,6430306,4303,충주시,칠금·금릉동,계,11470,5202,1514,761,2754,5029,173,6268
4300,충청북도,충주시바선거구,6430306,4303,충주시,칠금·금릉동,관내사전투표,1471,1470,459,206,755,1420,50,1
4300,충청북도,충주시바선거구,6430306,4303,충주시,칠금·금릉동,선거일투표,9999,3732,1055,555,1999,3609,123,6267
4300,충청북도,충주시바선거구,6430306,4303,충주시,목행·용탄동,계,5229,2379,662,360,1279,2301,78,2850
4300,충청북도,충주시바선거구,6430306,4303,충주시,목행·용탄동,관내사전투표,877,876,249,148,461,858,18,1
4300,충청북도,충주시바선거구,6430306,4303,충주시,목행·용탄동,선거일투표,4352,1503,413,212,818,1443,60,2849
4300,충청북도,충주시바선거구,6430306,4303,충주시,잘못 투입·구분된 투표지,,0,9,4,0,4,8,1,-9
4300,충청북도,충주시사선거구,6430307,4303,충주시,합계,,19124,9925,2406,1222,3752,1716,9096,829,9199
4300,충청북도,충주시사선거구,6430307,4303,충주시,거소투표,,69,56,17,8,11,12,48,8,13
4300,충청북도,충주시사선거구,6430307,4303,충주시,관외사전투표,,933,932,272,154,307,125,858,74,1
4300,충청북도,충주시사선거구,6430307,4303,충주시,성내·충인동,계,2327,1112,232,125,479,162,998,114,1215
4300,충청북도,충주시사선거구,6430307,4303,충주시,성내·충인동,관내사전투표,342,341,71,50,141,55,317,24,1
4300,충청북도,충주시사선거구,6430307,4303,충주시,성내·충인동,선거일투표,1985,771,161,75,338,107,681,90,1214
4300,충청북도,충주시사선거구,6430307,4303,충주시,문화동,계,8039,4128,1029,477,1577,719,3802,326,3911
4300,충청북도,충주시사선거구,6430307,4303,충주시,문화동,관내사전투표,1153,1152,300,134,404,223,1061,91,1
4300,충청북도,충주시사선거구,6430307,4303,충주시,문화동,선거일투표,6886,2976,729,343,1173,496,2741,235,3910
4300,충청북도,충주시사선거구,6430307,4303,충주시,봉방동,계,7756,3689,855,455,1375,697,3382,307,4067
4300,충청북도,충주시사선거구,6430307,4303,충주시,봉방동,관내사전투표,1532,1529,376,184,552,281,1393,136,3
4300,충청북도,충주시사선거구,6430307,4303,충주시,봉방동,선거일투표,6224,2160,479,271,823,416,1989,171,4064
4300,충청북도,충주시사선거구,6430307,4303,충주시,잘못 투입·구분된 투표지,,0,8,1,3,3,1,8,0,-8
4300,충청북도,제천시가선거구,6430401,4304,제천시,합계,,13809,8334,2438,3414,2144,7996,338,5475
4300,충청북도,제천시가선거구,6430401,4304,제천시,거소투표,,17,16,8,5,3,16,0,1
4300,충청북도,제천시가선거구,6430401,4304,제천시,관외사전투표,,933,933,380,369,147,896,37,0
4300,충청북도,제천시가선거구,6430401,4304,제천시,봉양읍,계,5732,3283,1035,1618,474,3127,156,2449
4300,충청북도,제천시가선거구,6430401,4304,제천시,봉양읍,관내사전투표,1348,1346,450,663,176,1289,57,2
4300,충청북도,제천시가선거구,6430401,4304,제천시,봉양읍,선거일투표,4384,1937,585,955,298,1838,99,2447
4300,충청북도,제천시가선거구,6430401,4304,제천시,백운면,계,2988,1764,470,690,534,1694,70,1224
4300,충청북도,제천시가선거구,6430401,4304,제천시,백운면,관내사전투표,663,662,181,274,181,636,26,1
4300,충청북도,제천시가선거구,6430401,4304,제천시,백운면,선거일투표,2325,1102,289,416,353,1058,44,1223
4300,충청북도,제천시가선거구,6430401,4304,제천시,송학면,계,4139,2330,544,730,982,2256,74,1809
4300,충청북도,제천시가선거구,6430401,4304,제천시,송학면,관내사전투표,835,830,211,231,358,800,30,5
4300,충청북도,제천시가선거구,6430401,4304,제천시,송학면,선거일투표,3304,1500,333,499,624,1456,44,1804
4300,충청북도,제천시가선거구,6430401,4304,제천시,잘못 투입·구분된 투표지,,0,8,1,2,4,7,1,-8
4300,충청북도,제천시나선거구,6430402,4304,제천시,합계,,22574,12362,1930,2706,4083,2710,11429,933,10212
4300,충청북도,제천시나선거구,6430402,4304,제천시,거소투표,,34,31,6,5,9,6,26,5,3
4300,충청북도,제천시나선거구,6430402,4304,제천시,관외사전투표,,1412,1412,265,385,401,260,1311,101,0
4300,충청북도,제천시나선거구,6430402,4304,제천시,의림지동,계,8130,4197,732,991,1248,891,3862,335,3933
4300,충청북도,제천시나선거구,6430402,4304,제천시,의림지동,관내사전투표,1693,1687,299,417,494,314,1524,163,6
4300,충청북도,제천시나선거구,6430402,4304,제천시,의림지동,선거일투표,6437,2510,433,574,754,577,2338,172,3927
4300,충청북도,제천시나선거구,6430402,4304,제천시,청전동,계,12998,6711,925,1323,2422,1550,6220,491,6287
4300,충청북도,제천시나선거구,6430402,4304,제천시,청전동,관내사전투표,2441,2437,348,486,868,557,2259,178,4
4300,충청북도,제천시나선거구,6430402,4304,제천시,청전동,선거일투표,10557,4274,577,837,1554,993,3961,313,6283
4300,충청북도,제천시나선거구,6430402,4304,제천시,잘못 투입·구분된 투표지,,0,11,2,2,3,3,10,1,-11
4300,충청북도,제천시다선거구,6430403,4304,제천시,합계,,29862,15564,4090,2135,3865,3244,1391,14725,839,14298
4300,충청북도,제천시다선거구,6430403,4304,제천시,거소투표,,42,41,13,8,7,5,4,37,4,1
4300,충청북도,제천시다선거구,6430403,4304,제천시,관외사전투표,,1789,1789,601,272,407,271,147,1698,91,0
4300,충청북도,제천시다선거구,6430403,4304,제천시,중앙동,계,4988,2608,599,257,775,589,234,2454,154,2380
4300,충청북도,제천시다선거구,6430403,4304,제천시,중앙동,관내사전투표,1144,1142,296,119,325,238,103,1081,61,2
4300,충청북도,제천시다선거구,6430403,4304,제천시,중앙동,선거일투표,3844,1466,303,138,450,351,131,1373,93,2378
4300,충청북도,제천시다선거구,6430403,4304,제천시,영서동,계,8204,4162,1050,623,1113,827,331,3944,218,4042
4300,충청북도,제천시다선거구,6430403,4304,제천시,영서동,관내사전투표,1691,1687,426,255,452,318,152,1603,84,4
4300,충청북도,제천시다선거구,6430403,4304,제천시,영서동,선거일투표,6513,2475,624,368,661,509,179,2341,134,4038
4300,충청북도,제천시다선거구,6430403,4304,제천시,용두동,계,14839,6954,1824,972,1561,1551,674,6582,372,7885
4300,충청북도,제천시다선거구,6430403,4304,제천시,용두동,관내사전투표,2620,2616,700,362,544,598,251,2455,161,4
4300,충청북도,제천시다선거구,6430403,4304,제천시,용두동,선거일투표,12219,4338,1124,610,1017,953,423,4127,211,7881
4300,충청북도,제천시다선거구,6430403,4304,제천시,잘못 투입·구분된 투표지,,0,10,3,3,2,1,1,10,0,-10
4300,충청북도,제천시라선거구,6430404,4304,제천시,합계,,20006,11101,3168,1953,3810,1268,10199,902,8905
4300,충청북도,제천시라선거구,6430404,4304,제천시,거소투표,,28,27,13,1,6,3,23,4,1
4300,충청북도,제천시라선거구,6430404,4304,제천시,관외사전투표,,1284,1281,435,250,383,122,1190,91,3
4300,충청북도,제천시라선거구,6430404,4304,제천시,금성면,계,1722,1042,325,140,362,113,940,102,680
4300,충청북도,제천시라선거구,6430404,4304,제천시,금성면,관내사전투표,389,389,103,50,144,41,338,51,0
4300,충청북도,제천시라선거구,6430404,4304,제천시,금성면,선거일투표,1333,653,222,90,218,72,602,51,680
4300,충청북도,제천시라선거구,6430404,4304,제천시,청풍면,계,1116,682,186,98,292,62,638,44,434
4300,충청북도,제천시라선거구,6430404,4304,제천시,청풍면,관내사전투표,249,249,62,39,96,28,225,24,0
4300,충청북도,제천시라선거구,6430404,4304,제천시,청풍면,선거일투표,867,433,124,59,196,34,413,20,434
4300,충청북도,제천시라선거구,6430404,4304,제천시,수산면,계,1874,1080,308,144,411,109,972,108,794
4300,충청북도,제천시라선거구,6430404,4304,제천시,수산면,관내사전투표,441,441,122,65,161,55,403,38,0
4300,충청북도,제천시라선거구,6430404,4304,제천시,수산면,선거일투표,1433,639,186,79,250,54,569,70,794
4300,충청북도,제천시라선거구,6430404,4304,제천시,덕산면,계,1882,1091,335,170,407,103,1015,76,791
4300,충청북도,제천시라선거구,6430404,4304,제천시,덕산면,관내사전투표,465,464,152,70,161,42,425,39,1
4300,충청북도,제천시라선거구,6430404,4304,제천시,덕산면,선거일투표,1417,627,183,100,246,61,590,37,790
4300,충청북도,제천시라선거구,6430404,4304,제천시,한수면,계,616,341,94,39,144,27,304,37,275
4300,충청북도,제천시라선거구,6430404,4304,제천시,한수면,관내사전투표,134,134,36,17,56,7,116,18,0
4300,충청북도,제천시라선거구,6430404,4304,제천시,한수면,선거일투표,482,207,58,22,88,20,188,19,275
4300,충청북도,제천시라선거구,6430404,4304,제천시,화산동,계,11484,5554,1471,1111,1804,729,5115,439,5930
4300,충청북도,제천시라선거구,6430404,4304,제천시,화산동,관내사전투표,1575,1574,386,335,522,176,1419,155,1
4300,충청북도,제천시라선거구,6430404,4304,제천시,화산동,선거일투표,9909,3980,1085,776,1282,553,3696,284,5929
4300,충청북도,제천시라선거구,6430404,4304,제천시,잘못 투입·구분된 투표지,,0,3,1,0,1,0,2,1,-3
4300,충청북도,제천시마선거구,6430405,4304,제천시,합계,,29312,15438,3597,2410,4678,2518,233,204,987,14627,811,13874
4300,충청북도,제천시마선거구,6430405,4304,제천시,거소투표,,52,51,9,5,20,2,3,0,2,41,10,1
4300,충청북도,제천시마선거구,6430405,4304,제천시,관외사전투표,,1836,1836,535,329,503,206,20,39,95,1727,109,0
4300,충청북도,제천시마선거구,6430405,4304,제천시,교동,계,13901,6652,1470,1228,1861,1305,129,92,268,6353,299,7249
4300,충청북도,제천시마선거구,6430405,4304,제천시,교동,관내사전투표,2385,2385,539,472,690,455,41,33,68,2298,87,0
4300,충청북도,제천시마선거구,6430405,4304,제천시,교동,선거일투표,11516,4267,931,756,1171,850,88,59,200,4055,212,7249
4300,충청북도,제천시마선거구,6430405,4304,제천시,남현동,계,4366,2328,435,311,902,352,32,24,144,2200,128,2038
4300,충청북도,제천시마선거구,6430405,4304,제천시,남현동,관내사전투표,1170,1170,216,154,449,184,11,13,74,1101,69,0
4300,충청북도,제천시마선거구,6430405,4304,제천시,남현동,선거일투표,3196,1158,219,157,453,168,21,11,70,1099,59,2038
4300,충청북도,제천시마선거구,6430405,4304,제천시,신백동,계,9157,4571,1148,537,1392,653,49,49,478,4306,265,4586
4300,충청북도,제천시마선거구,6430405,4304,제천시,신백동,관내사전투표,1666,1665,464,180,477,218,20,20,165,1544,121,1
4300,충청북도,제천시마선거구,6430405,4304,제천시,신백동,선거일투표,7491,2906,684,357,915,435,29,29,313,2762,144,4585
4300,충청북도,제천시마선거구,6430405,4304,제천시,잘못 투입·구분된 투표지,,0,0,0,0,0,0,0,0,0,0,0,0
4300,충청북도,단양군가선거구,6430501,4305,단양군,합계,,14349,9825,2518,1838,2334,1302,264,498,738,9492,333,4524
4300,충청북도,단양군가선거구,6430501,4305,단양군,거소투표,,87,87,17,12,43,3,2,2,5,84,3,0
4300,충청북도,단양군가선거구,6430501,4305,단양군,관외사전투표,,872,872,299,229,136,99,14,35,38,850,22,0
4300,충청북도,단양군가선거구,6430501,4305,단양군,단양읍,계,8329,5552,1536,937,977,864,200,381,491,5386,166,2777
4300,충청북도,단양군가선거구,6430501,4305,단양군,단양읍,관내사전투표,2555,2555,789,392,447,384,88,184,211,2495,60,0
4300,충청북도,단양군가선거구,6430501,4305,단양군,단양읍,선거일투표,5774,2997,747,545,530,480,112,197,280,2891,106,2777
4300,충청북도,단양군가선거구,6430501,4305,단양군,단성면,계,1488,975,193,167,401,90,12,30,43,936,39,513
4300,충청북도,단양군가선거구,6430501,4305,단양군,단성면,관내사전투표,502,502,105,71,204,49,5,23,23,480,22,0
4300,충청북도,단양군가선거구,6430501,4305,단양군,단성면,선거일투표,986,473,88,96,197,41,7,7,20,456,17,513
4300,충청북도,단양군가선거구,6430501,4305,단양군,대강면,계,2277,1519,304,329,483,168,20,27,120,1451,68,758
4300,충청북도,단양군가선거구,6430501,4305,단양군,대강면,관내사전투표,780,780,166,162,237,94,13,20,59,751,29,0
4300,충청북도,단양군가선거구,6430501,4305,단양군,대강면,선거일투표,1497,739,138,167,246,74,7,7,61,700,39,758
4300,충청북도,단양군가선거구,6430501,4305,단양군,적성면,계,1296,820,169,164,294,78,16,23,41,785,35,476
4300,충청북도,단양군가선거구,6430501,4305,단양군,적성면,관내사전투표,239,239,55,34,84,33,4,7,15,232,7,0
4300,충청북도,단양군가선거구,6430501,4305,단양군,적성면,선거일투표,1057,581,114,130,210,45,12,16,26,553,28,476
4300,충청북도,단양군가선거구,6430501,4305,단양군,잘못 투입·구분된 투표지,,0,0,0,0,0,0,0,0,0,0,0,0
4300,충청북도,단양군나선거구,6430502,4305,단양군,합계,,11343,7600,1403,1323,2521,1296,644,7187,413,3743
4300,충청북도,단양군나선거구,6430502,4305,단양군,거소투표,,16,16,4,4,3,1,3,15,1,0
4300,충청북도,단양군나선거구,6430502,4305,단양군,관외사전투표,,614,613,139,117,219,79,31,585,28,1
4300,충청북도,단양군나선거구,6430502,4305,단양군,매포읍,계,4379,2852,281,785,1410,131,70,2677,175,1527
4300,충청북도,단양군나선거구,6430502,4305,단양군,매포읍,관내사전투표,1260,1256,118,357,620,69,35,1199,57,4
4300,충청북도,단양군나선거구,6430502,4305,단양군,매포읍,선거일투표,3119,1596,163,428,790,62,35,1478,118,1523
4300,충청북도,단양군나선거구,6430502,4305,단양군,가곡면,계,1778,1160,429,133,259,140,143,1104,56,618
4300,충청북도,단양군나선거구,6430502,4305,단양군,가곡면,관내사전투표,577,573,217,71,120,63,70,541,32,4
4300,충청북도,단양군나선거구,6430502,4305,단양군,가곡면,선거일투표,1201,587,212,62,139,77,73,563,24,614
4300,충청북도,단양군나선거구,6430502,4305,단양군,영춘면,계,2847,1920,324,161,344,855,137,1821,99,927
4300,충청북도,단양군나선거구,6430502,4305,단양군,영춘면,관내사전투표,695,693,139,67,92,320,45,663,30,2
4300,충청북도,단양군나선거구,6430502,4305,단양군,영춘면,선거일투표,2152,1227,185,94,252,535,92,1158,69,925
4300,충청북도,단양군나선거구,6430502,4305,단양군,어상천면,계,1709,1028,224,120,282,88,260,974,54,681
4300,충청북도,단양군나선거구,6430502,4305,단양군,어상천면,관내사전투표,458,458,103,57,131,44,99,434,24,0
4300,충청북도,단양군나선거구,6430502,4305,단양군,어상천면,선거일투표,1251,570,121,63,151,44,161,540,30,681
4300,충청북도,단양군나선거구,6430502,4305,단양군,잘못 투입·구분된 투표지,,0,11,2,3,4,2,0,11,0,-11
4300,충청북도,영동군가선거구,6430701,4307,영동군,합계,,20077,13364,1232,2884,1206,2154,2661,2582,12719,645,6713
4300,충청북도,영동군가선거구,6430701,4307,영동군,거소투표,,48,43,9,7,5,4,13,4,42,1,5
4300,충청북도,영동군가선거구,6430701,4307,영동군,관외사전투표,,1517,1517,225,347,140,273,228,212,1425,92,0
4300,충청북도,영동군가선거구,6430701,4307,영동군,영동읍,계,15587,9847,870,2101,921,1597,2135,1770,9394,453,5740
4300,충청북도,영동군가선거구,6430701,4307,영동군,영동읍,관내사전투표,4234,4233,351,892,416,671,951,755,4036,197,1
4300,충청북도,영동군가선거구,6430701,4307,영동군,영동읍,선거일투표,11353,5614,519,1209,505,926,1184,1015,5358,256,5739
4300,충청북도,영동군가선거구,6430701,4307,영동군,양강면,계,2925,1957,128,429,140,280,285,596,1858,99,968
4300,충청북도,영동군가선거구,6430701,4307,영동군,양강면,관내사전투표,1112,1112,74,263,89,146,171,317,1060,52,0
4300,충청북도,영동군가선거구,6430701,4307,영동군,양강면,선거일투표,1813,845,54,166,51,134,114,279,798,47,968
4300,충청북도,영동군가선거구,6430701,4307,영동군,잘못 투입·구분된 투표지,,0,0,0,0,0,0,0,0,0,0,0
4300,충청북도,영동군나선거구,6430702,4307,영동군,합계,,11235,7319,2153,2755,2105,7013,306,3916
4300,충청북도,영동군나선거구,6430702,4307,영동군,거소투표,,21,21,8,7,3,18,3,0
4300,충청북도,영동군나선거구,6430702,4307,영동군,관외사전투표,,721,721,257,283,160,700,21,0
4300,충청북도,영동군나선거구,6430702,4307,영동군,용산면,계,2896,1828,945,520,290,1755,73,1068
4300,충청북도,영동군나선거구,6430702,4307,영동군,용산면,관내사전투표,1094,1094,581,296,170,1047,47,0
4300,충청북도,영동군나선거구,6430702,4307,영동군,용산면,선거일투표,1802,734,364,224,120,708,26,1068
4300,충청북도,영동군나선거구,6430702,4307,영동군,용화면,계,855,582,129,263,161,553,29,273
4300,충청북도,영동군나선거구,6430702,4307,영동군,용화면,관내사전투표,324,324,67,157,78,302,22,0
4300,충청북도,영동군나선거구,6430702,4307,영동군,용화면,선거일투표,531,258,62,106,83,251,7,273
4300,충청북도,영동군나선거구,6430702,4307,영동군,학산면,계,2425,1513,338,805,311,1454,59,912
4300,충청북도,영동군나선거구,6430702,4307,영동군,학산면,관내사전투표,682,682,140,391,127,658,24,0
4300,충청북도,영동군나선거구,6430702,4307,영동군,학산면,선거일투표,1743,831,198,414,184,796,35,912
4300,충청북도,영동군나선거구,6430702,4307,영동군,양산면,계,1609,1002,216,425,319,960,42,607
4300,충청북도,영동군나선거구,6430702,4307,영동군,양산면,관내사전투표,491,490,107,210,150,467,23,1
4300,충청북도,영동군나선거구,6430702,4307,영동군,양산면,선거일투표,1118,512,109,215,169,493,19,606
4300,충청북도,영동군나선거구,6430702,4307,영동군,심천면,계,2708,1651,260,451,861,1572,79,1057
4300,충청북도,영동군나선거구,6430702,4307,영동군,심천면,관내사전투표,703,703,109,192,365,666,37,0
4300,충청북도,영동군나선거구,6430702,4307,영동군,심천면,선거일투표,2005,948,151,259,496,906,42,1057
4300,충청북도,영동군나선거구,6430702,4307,영동군,잘못 투입·구분된 투표지,,0,1,0,1,0,1,0,-1
4300,충청북도,영동군다선거구,6430703,4307,영동군,합계,,9811,6465,1909,2821,1467,6197,268,3346
4300,충청북도,영동군다선거구,6430703,4307,영동군,거소투표,,18,17,7,4,4,15,2,1
4300,충청북도,영동군다선거구,6430703,4307,영동군,관외사전투표,,492,492,184,223,76,483,9,0
4300,충청북도,영동군다선거구,6430703,4307,영동군,황간면,계,3597,2294,802,1126,264,2192,102,1303
4300,충청북도,영동군다선거구,6430703,4307,영동군,황간면,관내사전투표,1030,1030,357,529,92,978,52,0
4300,충청북도,영동군다선거구,6430703,4307,영동군,황간면,선거일투표,2567,1264,445,597,172,1214,50,1303
4300,충청북도,영동군다선거구,6430703,4307,영동군,추풍령면,계,2013,1271,350,613,257,1220,51,742
4300,충청북도,영동군다선거구,6430703,4307,영동군,추풍령면,관내사전투표,532,532,146,246,117,509,23,0
4300,충청북도,영동군다선거구,6430703,4307,영동군,추풍령면,선거일투표,1481,739,204,367,140,711,28,742
4300,충청북도,영동군다선거구,6430703,4307,영동군,매곡면,계,1674,1050,305,472,222,999,51,624
4300,충청북도,영동군다선거구,6430703,4307,영동군,매곡면,관내사전투표,465,465,140,211,81,432,33,0
4300,충청북도,영동군다선거구,6430703,4307,영동군,매곡면,선거일투표,1209,585,165,261,141,567,18,624
4300,충청북도,영동군다선거구,6430703,4307,영동군,상촌면,계,2017,1341,261,383,644,1288,53,676
4300,충청북도,영동군다선거구,6430703,4307,영동군,상촌면,관내사전투표,673,673,142,199,301,642,31,0
4300,충청북도,영동군다선거구,6430703,4307,영동군,상촌면,선거일투표,1344,668,119,184,343,646,22,676
4300,충청북도,영동군다선거구,6430703,4307,영동군,잘못 투입·구분된 투표지,,0,0,0,0,0,0,0,0
4300,충청북도,보은군가선거구,6430801,4308,보은군,합계,,12796,8459,1896,844,2669,1462,1193,8064,395,4337
4300,충청북도,보은군가선거구,6430801,4308,보은군,거소투표,,30,30,8,4,5,5,3,25,5,0
4300,충청북도,보은군가선거구,6430801,4308,보은군,관외사전투표,,1393,1392,334,138,474,216,180,1342,50,1
4300,충청북도,보은군가선거구,6430801,4308,보은군,보은읍,계,11373,7032,1553,701,2189,1240,1009,6692,340,4341
4300,충청북도,보은군가선거구,6430801,4308,보은군,보은읍,관내사전투표,3256,3253,704,346,991,566,496,3103,150,3
4300,충청북도,보은군가선거구,6430801,4308,보은군,보은읍,선거일투표,8117,3779,849,355,1198,674,513,3589,190,4338
4300,충청북도,보은군가선거구,6430801,4308,보은군,잘못 투입·구분된 투표지,,0,5,1,1,1,1,1,5,0,-5
4300,충청북도,보은군나선거구,6430802,4308,보은군,합계,,8843,6036,1288,1854,1487,1074,5703,333,2807
4300,충청북도,보은군나선거구,6430802,4308,보은군,거소투표,,27,26,8,11,5,1,25,1,1
4300,충청북도,보은군나선거구,6430802,4308,보은군,관외사전투표,,663,661,196,231,129,80,636,25,2
4300,충청북도,보은군나선거구,6430802,4308,보은군,속리산면,계,1622,1107,225,593,185,78,1081,26,515
4300,충청북도,보은군나선거구,6430802,4308,보은군,속리산면,관내사전투표,528,522,127,253,93,43,516,6,6
4300,충청북도,보은군나선거구,6430802,4308,보은군,속리산면,선거일투표,1094,585,98,340,92,35,565,20,509
4300,충청북도,보은군나선거구,6430802,4308,보은군,장안면,계,1238,738,186,243,200,53,682,56,500
4300,충청북도,보은군나선거구,6430802,4308,보은군,장안면,관내사전투표,336,336,92,119,94,21,326,10,0
4300,충청북도,보은군나선거구,6430802,4308,보은군,장안면,선거일투표,902,402,94,124,106,32,356,46,500
4300,충청북도,보은군나선거구,6430802,4308,보은군,마로면,계,1946,1315,296,289,560,77,1222,93,631
4300,충청북도,보은군나선거구,6430802,4308,보은군,마로면,관내사전투표,490,489,126,96,223,30,475,14,1
4300,충청북도,보은군나선거구,6430802,4308,보은군,마로면,선거일투표,1456,826,170,193,337,47,747,79,630
4300,충청북도,보은군나선거구,6430802,4308,보은군,탄부면,계,1383,905,195,295,261,106,857,48,478
4300,충청북도,보은군나선거구,6430802,4308,보은군,탄부면,관내사전투표,416,414,94,143,118,44,399,15,2
4300,충청북도,보은군나선거구,6430802,4308,보은군,탄부면,선거일투표,967,491,101,152,143,62,458,33,476
4300,충청북도,보은군나선거구,6430802,4308,보은군,삼승면,계,1964,1270,182,187,142,676,1187,83,694
4300,충청북도,보은군나선거구,6430802,4308,보은군,삼승면,관내사전투표,769,768,88,125,73,428,714,54,1
4300,충청북도,보은군나선거구,6430802,4308,보은군,삼승면,선거일투표,1195,502,94,62,69,248,473,29,693
4300,충청북도,보은군나선거구,6430802,4308,보은군,잘못 투입·구분된 투표지,,0,14,0,5,5,3,13,1,-14
4300,충청북도,보은군다선거구,6430803,4308,보은군,합계,,7324,5048,1332,1900,1186,331,4749,299,2276
4300,충청북도,보은군다선거구,6430803,4308,보은군,거소투표,,44,44,15,14,9,2,40,4,0
4300,충청북도,보은군다선거구,6430803,4308,보은군,관외사전투표,,614,614,200,251,117,28,596,18,0
4300,충청북도,보은군다선거구,6430803,4308,보은군,수한면,계,1615,991,170,469,170,103,912,79,624
4300,충청북도,보은군다선거구,6430803,4308,보은군,수한면,관내사전투표,470,470,95,226,82,45,448,22,0
4300,충청북도,보은군다선거구,6430803,4308,보은군,수한면,선거일투표,1145,521,75,243,88,58,464,57,624
4300,충청북도,보은군다선거구,6430803,4308,보은군,회남면,계,614,414,131,130,81,43,385,29,200
4300,충청북도,보은군다선거구,6430803,4308,보은군,회남면,관내사전투표,202,201,66,70,43,16,195,6,1
4300,충청북도,보은군다선거구,6430803,4308,보은군,회남면,선거일투표,412,213,65,60,38,27,190,23,199
4300,충청북도,보은군다선거구,6430803,4308,보은군,회인면,계,1506,1020,551,220,123,79,973,47,486
4300,충청북도,보은군다선거구,6430803,4308,보은군,회인면,관내사전투표,520,520,277,123,56,38,494,26,0
4300,충청북도,보은군다선거구,6430803,4308,보은군,회인면,선거일투표,986,500,274,97,67,41,479,21,486
4300,충청북도,보은군다선거구,6430803,4308,보은군,내북면,계,1426,941,115,174,561,29,879,62,485
4300,충청북도,보은군다선거구,6430803,4308,보은군,내북면,관내사전투표,508,507,68,98,306,13,485,22,1
4300,충청북도,보은군다선거구,6430803,4308,보은군,내북면,선거일투표,918,434,47,76,255,16,394,40,484
4300,충청북도,보은군다선거구,6430803,4308,보은군,산외면,계,1505,1021,150,639,125,47,961,60,484
4300,충청북도,보은군다선거구,6430803,4308,보은군,산외면,관내사전투표,462,461,70,318,47,15,450,11,1
4300,충청북도,보은군다선거구,6430803,4308,보은군,산외면,선거일투표,1043,560,80,321,78,32,511,49,483
4300,충청북도,보은군다선거구,6430803,4308,보은군,잘못 투입·구분된 투표지,,0,3,0,3,0,0,3,0,-3
4300,충청북도,옥천군가선거구,6430901,4309,옥천군,합계,,24662,15453,3325,2235,3437,2958,190,2500,14645,808,9209
4300,충청북도,옥천군가선거구,6430901,4309,옥천군,거소투표,,88,85,20,19,20,15,1,7,82,3,3
4300,충청북도,옥천군가선거구,6430901,4309,옥천군,관외사전투표,,1434,1434,378,232,284,227,16,218,1355,79,0
4300,충청북도,옥천군가선거구,6430901,4309,옥천군,옥천읍,계,23140,13934,2927,1984,3133,2716,173,2275,13208,726,9206
4300,충청북도,옥천군가선거구,6430901,4309,옥천군,옥천읍,관내사전투표,5847,5846,1293,884,1247,1117,55,980,5576,270,1
4300,충청북도,옥천군가선거구,6430901,4309,옥천군,옥천읍,선거일투표,17293,8088,1634,1100,1886,1599,118,1295,7632,456,9205
4300,충청북도,옥천군가선거구,6430901,4309,옥천군,잘못 투입·구분된 투표지,,0,0,0,0,0,0,0,0,0,0,0
4300,충청북도,옥천군나선거구,6430902,4309,옥천군,합계,,11808,7596,1703,1760,1915,1478,6856,740,4212
4300,충청북도,옥천군나선거구,6430902,4309,옥천군,거소투표,,16,14,1,7,2,2,12,2,2
4300,충청북도,옥천군나선거구,6430902,4309,옥천군,관외사전투표,,801,800,207,133,234,151,725,75,1
4300,충청북도,옥천군나선거구,6430902,4309,옥천군,동이면,계,2823,1822,475,304,711,201,1691,131,1001
4300,충청북도,옥천군나선거구,6430902,4309,옥천군,동이면,관내사전투표,765,765,223,135,296,81,735,30,0
4300,충청북도,옥천군나선거구,6430902,4309,옥천군,동이면,선거일투표,2058,1057,252,169,415,120,956,101,1001
4300,충청북도,옥천군나선거구,6430902,4309,옥천군,이원면,계,3635,2182,366,876,397,294,1933,249,1453
4300,충청북도,옥천군나선거구,6430902,4309,옥천군,이원면,관내사전투표,1083,1083,189,447,184,158,978,105,0
4300,충청북도,옥천군나선거구,6430902,4309,옥천군,이원면,선거일투표,2552,1099,177,429,213,136,955,144,1453
4300,충청북도,옥천군나선거구,6430902,4309,옥천군,군서면,계,1962,1287,256,196,203,520,1175,112,675
4300,충청북도,옥천군나선거구,6430902,4309,옥천군,군서면,관내사전투표,563,563,104,94,95,229,522,41,0
4300,충청북도,옥천군나선거구,6430902,4309,옥천군,군서면,선거일투표,1399,724,152,102,108,291,653,71,675
4300,충청북도,옥천군나선거구,6430902,4309,옥천군,군북면,계,2571,1486,395,244,367,310,1316,170,1085
4300,충청북도,옥천군나선거구,6430902,4309,옥천군,군북면,관내사전투표,588,587,159,118,137,110,524,63,1
4300,충청북도,옥천군나선거구,6430902,4309,옥천군,군북면,선거일투표,1983,899,236,126,230,200,792,107,1084
4300,충청북도,옥천군나선거구,6430902,4309,옥천군,잘못 투입·구분된 투표지,,0,5,3,0,1,0,4,1,-5
4300,충청북도,옥천군다선거구,6430903,4309,옥천군,합계,,8216,5797,688,981,1404,862,1543,5478,319,2419
4300,충청북도,옥천군다선거구,6430903,4309,옥천군,거소투표,,29,25,3,2,4,3,13,25,0,4
4300,충청북도,옥천군다선거구,6430903,4309,옥천군,관외사전투표,,683,683,125,140,219,79,86,649,34,0
4300,충청북도,옥천군다선거구,6430903,4309,옥천군,안남면,계,1228,919,60,45,157,31,570,863,56,309
4300,충청북도,옥천군다선거구,6430903,4309,옥천군,안남면,관내사전투표,436,436,30,16,69,19,275,409,27,0
4300,충청북도,옥천군다선거구,6430903,4309,옥천군,안남면,선거일투표,792,483,30,29,88,12,295,454,29,309
4300,충청북도,옥천군다선거구,6430903,4309,옥천군,안내면,계,1673,1188,145,89,530,47,318,1129,59,485
4300,충청북도,옥천군다선거구,6430903,4309,옥천군,안내면,관내사전투표,668,668,76,55,313,28,161,633,35,0
4300,충청북도,옥천군다선거구,6430903,4309,옥천군,안내면,선거일투표,1005,520,69,34,217,19,157,496,24,485
4300,충청북도,옥천군다선거구,6430903,4309,옥천군,청성면,계,1913,1126,184,361,230,116,177,1068,58,787
4300,충청북도,옥천군다선거구,6430903,4309,옥천군,청성면,관내사전투표,597,597,94,195,113,59,109,570,27,0
4300,충청북도,옥천군다선거구,6430903,4309,옥천군,청성면,선거일투표,1316,529,90,166,117,57,68,498,31,787
4300,충청북도,옥천군다선거구,6430903,4309,옥천군,청산면,계,2690,1855,171,343,264,586,379,1743,112,835
4300,충청북도,옥천군다선거구,6430903,4309,옥천군,청산면,관내사전투표,911,911,78,185,131,279,182,855,56,0
4300,충청북도,옥천군다선거구,6430903,4309,옥천군,청산면,선거일투표,1779,944,93,158,133,307,197,888,56,835
4300,충청북도,옥천군다선거구,6430903,4309,옥천군,잘못 투입·구분된 투표지,,0,1,0,1,0,0,0,1,0,-1
4300,충청북도,음성군가선거구,6431001,4310,음성군,합계,,31128,17169,4358,2087,4029,3356,522,1665,16017,1152,13959
4300,충청북도,음성군가선거구,6431001,4310,음성군,거소투표,,191,171,61,25,35,18,2,11,152,19,20
4300,충청북도,음성군가선거구,6431001,4310,음성군,관외사전투표,,1554,1554,500,213,389,205,38,97,1442,112,0
4300,충청북도,음성군가선거구,6431001,4310,음성군,음성읍,계,14018,8151,2158,323,1975,2010,50,1140,7656,495,5867
4300,충청북도,음성군가선거구,6431001,4310,음성군,음성읍,관내사전투표,3786,3785,1065,151,871,902,20,550,3559,226,1
4300,충청북도,음성군가선거구,6431001,4310,음성군,음성읍,선거일투표,10232,4366,1093,172,1104,1108,30,590,4097,269,5866
4300,충청북도,음성군가선거구,6431001,4310,음성군,소이면,계,2651,1620,393,88,355,444,13,169,1462,158,1031
4300,충청북도,음성군가선거구,6431001,4310,음성군,소이면,관내사전투표,921,921,238,56,179,270,5,102,850,71,0
4300,충청북도,음성군가선거구,6431001,4310,음성군,소이면,선거일투표,1730,699,155,32,176,174,8,67,612,87,1031
4300,충청북도,음성군가선거구,6431001,4310,음성군,원남면,계,2675,1635,477,97,379,402,14,172,1541,94,1040
4300,충청북도,음성군가선거구,6431001,4310,음성군,원남면,관내사전투표,806,806,241,49,170,211,8,85,764,42,0
4300,충청북도,음성군가선거구,6431001,4310,음성군,원남면,선거일투표,1869,829,236,48,209,191,6,87,777,52,1040
4300,충청북도,음성군가선거구,6431001,4310,음성군,맹동면,계,10039,4036,769,1340,896,277,405,75,3762,274,6003
4300,충청북도,음성군가선거구,6431001,4310,음성군,맹동면,관내사전투표,1410,1409,260,477,324,95,108,40,1304,105,1
4300,충청북도,음성군가선거구,6431001,4310,음성군,맹동면,선거일투표,8629,2627,509,863,572,182,297,35,2458,169,6002
4300,충청북도,음성군가선거구,6431001,4310,음성군,잘못 투입·구분된 투표지,,0,2,0,1,0,0,0,1,2,0,-2
4300,충청북도,음성군나선거구,6431002,4310,음성군,합계,,30271,14758,4691,2390,6929,14010,748,15513
4300,충청북도,음성군나선거구,6431002,4310,음성군,거소투표,,44,41,18,6,17,41,0,3
4300,충청북도,음성군나선거구,6431002,4310,음성군,관외사전투표,,1226,1226,415,179,603,1197,29,0
4300,충청북도,음성군나선거구,6431002,4310,음성군,금왕읍,계,16277,7376,2701,836,3485,7022,354,8901
4300,충청북도,음성군나선거구,6431002,4310,음성군,금왕읍,관내사전투표,2810,2802,1091,341,1256,2688,114,8
4300,충청북도,음성군나선거구,6431002,4310,음성군,금왕읍,선거일투표,13467,4574,1610,495,2229,4334,240,8893
4300,충청북도,음성군나선거구,6431002,4310,음성군,생극면,계,4082,2169,680,207,1106,1993,176,1913
4300,충청북도,음성군나선거구,6431002,4310,음성군,생극면,관내사전투표,950,950,291,109,474,874,76,0
4300,충청북도,음성군나선거구,6431002,4310,음성군,생극면,선거일투표,3132,1219,389,98,632,1119,100,1913
4300,충청북도,음성군나선거구,6431002,4310,음성군,감곡면,계,8642,3932,872,1160,1711,3743,189,4710
4300,충청북도,음성군나선거구,6431002,4310,음성군,감곡면,관내사전투표,1761,1760,423,538,751,1712,48,1
4300,충청북도,음성군나선거구,6431002,4310,음성군,감곡면,선거일투표,6881,2172,449,622,960,2031,141,4709
4300,충청북도,음성군나선거구,6431002,4310,음성군,잘못 투입·구분된 투표지,,0,14,5,2,7,14,0,-14
4300,충청북도,음성군다선거구,6431003,4310,음성군,검색된 결과가 없습니다.
4300,충청북도,진천군가선거구,6431101,4311,진천군,합계,,30974,16241,3598,2432,3937,3482,1699,15148,1093,14733
4300,충청북도,진천군가선거구,6431101,4311,진천군,거소투표,,69,67,25,8,21,9,2,65,2,2
4300,충청북도,진천군가선거구,6431101,4311,진천군,관외사전투표,,1297,1297,384,173,312,224,110,1203,94,0
4300,충청북도,진천군가선거구,6431101,4311,진천군,진천읍,계,24610,11911,2498,1876,2770,2672,1352,11168,743,12699
4300,충청북도,진천군가선거구,6431101,4311,진천군,진천읍,관내사전투표,4393,4391,976,760,968,944,485,4133,258,2
4300,충청북도,진천군가선거구,6431101,4311,진천군,진천읍,선거일투표,20217,7520,1522,1116,1802,1728,867,7035,485,12697
4300,충청북도,진천군가선거구,6431101,4311,진천군,문백면,계,3093,1765,448,244,478,347,118,1635,130,1328
4300,충청북도,진천군가선거구,6431101,4311,진천군,문백면,관내사전투표,611,607,175,96,150,115,40,576,31,4
4300,충청북도,진천군가선거구,6431101,4311,진천군,문백면,선거일투표,2482,1158,273,148,328,232,78,1059,99,1324
4300,충청북도,진천군가선거구,6431101,4311,진천군,백곡면,계,1905,1194,243,128,354,229,117,1071,123,711
4300,충청북도,진천군가선거구,6431101,4311,진천군,백곡면,관내사전투표,541,540,104,60,179,108,40,491,49,1
4300,충청북도,진천군가선거구,6431101,4311,진천군,백곡면,선거일투표,1364,654,139,68,175,121,77,580,74,710
4300,충청북도,진천군가선거구,6431101,4311,진천군,잘못 투입·구분된 투표지,,0,7,0,3,2,1,0,6,1,-7
4300,충청북도,진천군나선거구,6431102,4311,진천군,합계,,40751,18310,6021,3120,3317,2532,600,1683,17273,1037,22441
4300,충청북도,진천군나선거구,6431102,4311,진천군,거소투표,,48,44,11,8,8,4,4,4,39,5,4
4300,충청북도,진천군나선거구,6431102,4311,진천군,관외사전투표,,2097,2097,748,349,461,229,57,143,1987,110,0
4300,충청북도,진천군나선거구,6431102,4311,진천군,덕산읍,계,21540,8131,2458,1241,1127,1276,372,1213,7687,444,13409
4300,충청북도,진천군나선거구,6431102,4311,진천군,덕산읍,관내사전투표,2604,2604,766,402,331,451,99,417,2466,138,0
4300,충청북도,진천군나선거구,6431102,4311,진천군,덕산읍,선거일투표,18936,5527,1692,839,796,825,273,796,5221,306,13409
4300,충청북도,진천군나선거구,6431102,4311,진천군,초평면,계,2713,1568,186,782,207,205,19,49,1448,120,1145
4300,충청북도,진천군나선거구,6431102,4311,진천군,초평면,관내사전투표,671,671,93,322,76,90,8,31,620,51,0
4300,충청북도,진천군나선거구,6431102,4311,진천군,초평면,선거일투표,2042,897,93,460,131,115,11,18,828,69,1145
4300,충청북도,진천군나선거구,6431102,4311,진천군,이월면,계,5570,2765,696,418,803,423,50,187,2577,188,2805
4300,충청북도,진천군나선거구,6431102,4311,진천군,이월면,관내사전투표,1238,1238,332,188,344,174,30,88,1156,82,0
4300,충청북도,진천군나선거구,6431102,4311,진천군,이월면,선거일투표,4332,1527,364,230,459,249,20,99,1421,106,2805
4300,충청북도,진천군나선거구,6431102,4311,진천군,광혜원면,계,8783,3704,1922,322,711,395,98,87,3535,169,5079
4300,충청북도,진천군나선거구,6431102,4311,진천군,광혜원면,관내사전투표,1752,1751,920,158,319,199,44,45,1685,66,1
4300,충청북도,진천군나선거구,6431102,4311,진천군,광혜원면,선거일투표,7031,1953,1002,164,392,196,54,42,1850,103,5078
4300,충청북도,진천군나선거구,6431102,4311,진천군,잘못 투입·구분된 투표지,,0,1,0,0,0,0,0,0,0,1,-1
4300,충청북도,괴산군가선거구,6431201,4312,괴산군,합계,,15346,10365,2314,1714,2447,2167,1351,9993,372,4981
4300,충청북도,괴산군가선거구,6431201,4312,괴산군,거소투표,,58,57,13,8,20,9,3,53,4,1
4300,충청북도,괴산군가선거구,6431201,4312,괴산군,관외사전투표,,933,930,263,148,287,114,99,911,19,3
4300,충청북도,괴산군가선거구,6431201,4312,괴산군,괴산읍,계,7811,5050,1275,680,1154,950,854,4913,137,2761
4300,충청북도,괴산군가선거구,6431201,4312,괴산군,괴산읍,관내사전투표,2555,2551,646,383,527,477,455,2488,63,4
4300,충청북도,괴산군가선거구,6431201,4312,괴산군,괴산읍,선거일투표,5256,2499,629,297,627,473,399,2425,74,2757
4300,충청북도,괴산군가선거구,6431201,4312,괴산군,칠성면,계,2738,1833,349,196,397,609,195,1746,87,905
4300,충청북도,괴산군가선거구,6431201,4312,괴산군,칠성면,관내사전투표,985,984,178,108,236,319,104,945,39,1
4300,충청북도,괴산군가선거구,6431201,4312,괴산군,칠성면,선거일투표,1753,849,171,88,161,290,91,801,48,904
4300,충청북도,괴산군가선거구,6431201,4312,괴산군,문광면,계,1964,1286,255,193,330,319,142,1239,47,678
4300,충청북도,괴산군가선거구,6431201,4312,괴산군,문광면,관내사전투표,674,674,133,96,179,168,77,653,21,0
4300,충청북도,괴산군가선거구,6431201,4312,괴산군,문광면,선거일투표,1290,612,122,97,151,151,65,586,26,678
4300,충청북도,괴산군가선거구,6431201,4312,괴산군,소수면,계,1842,1201,157,488,259,163,57,1124,77,641
4300,충청북도,괴산군가선거구,6431201,4312,괴산군,소수면,관내사전투표,616,616,81,267,132,82,35,597,19,0
4300,충청북도,괴산군가선거구,6431201,4312,괴산군,소수면,선거일투표,1226,585,76,221,127,81,22,527,58,641
4300,충청북도,괴산군가선거구,6431201,4312,괴산군,잘못 투입·구분된 투표지,,0,8,2,1,0,3,1,7,1,-8
4300,충청북도,괴산군나선거구,6431202,4312,괴산군,합계,,8612,6075,1497,1843,1546,809,5695,380,2537
4300,충청북도,괴산군나선거구,6431202,4312,괴산군,거소투표,,33,33,9,4,17,1,31,2,0
4300,충청북도,괴산군나선거구,6431202,4312,괴산군,관외사전투표,,691,691,221,231,143,71,666,25,0
4300,충청북도,괴산군나선거구,6431202,4312,괴산군,감물면,계,1767,1197,560,288,208,33,1089,108,570
4300,충청북도,괴산군나선거구,6431202,4312,괴산군,감물면,관내사전투표,499,479,208,132,108,15,463,16,20
4300,충청북도,괴산군나선거구,6431202,4312,괴산군,감물면,선거일투표,1268,718,352,156,100,18,626,92,550
4300,충청북도,괴산군나선거구,6431202,4312,괴산군,장연면,계,1612,1003,232,482,144,98,956,47,609
4300,충청북도,괴산군나선거구,6431202,4312,괴산군,장연면,관내사전투표,545,545,135,270,67,50,522,23,0
4300,충청북도,괴산군나선거구,6431202,4312,괴산군,장연면,선거일투표,1067,458,97,212,77,48,434,24,609
4300,충청북도,괴산군나선거구,6431202,4312,괴산군,연풍면,계,2087,1469,134,556,108,573,1371,98,618
4300,충청북도,괴산군나선거구,6431202,4312,괴산군,연풍면,관내사전투표,858,857,84,334,63,346,827,30,1
4300,충청북도,괴산군나선거구,6431202,4312,괴산군,연풍면,선거일투표,1229,612,50,222,45,227,544,68,617
4300,충청북도,괴산군나선거구,6431202,4312,괴산군,불정면,계,2422,1661,332,276,922,31,1561,100,761
4300,충청북도,괴산군나선거구,6431202,4312,괴산군,불정면,관내사전투표,896,896,181,140,510,15,846,50,0
4300,충청북도,괴산군나선거구,6431202,4312,괴산군,불정면,선거일투표,1526,765,151,136,412,16,715,50,761
4300,충청북도,괴산군나선거구,6431202,4312,괴산군,잘못 투입·구분된 투표지,,0,21,9,6,4,2,21,0,-21
4300,충청북도,괴산군다선거구,6431203,4312,괴산군,합계,,10716,7279,1512,2730,1312,718,586,6858,421,3437
4300,충청북도,괴산군다선거구,6431203,4312,괴산군,거소투표,,35,33,11,10,3,1,4,29,4,2
4300,충청북도,괴산군다선거구,6431203,4312,괴산군,관외사전투표,,939,938,281,393,109,83,55,921,17,1
4300,충청북도,괴산군다선거구,6431203,4312,괴산군,청천면,계,4464,2957,413,592,1016,597,98,2716,241,1507
4300,충청북도,괴산군다선거구,6431203,4312,괴산군,청천면,관내사전투표,1237,1237,175,232,539,190,40,1176,61,0
4300,충청북도,괴산군다선거구,6431203,4312,괴산군,청천면,선거일투표,3227,1720,238,360,477,407,58,1540,180,1507
4300,충청북도,괴산군다선거구,6431203,4312,괴산군,청안면,계,2931,1788,635,765,146,19,119,1684,104,1143
4300,충청북도,괴산군다선거구,6431203,4312,괴산군,청안면,관내사전투표,717,717,290,299,39,7,61,696,21,0
4300,충청북도,괴산군다선거구,6431203,4312,괴산군,청안면,선거일투표,2214,1071,345,466,107,12,58,988,83,1143
4300,충청북도,괴산군다선거구,6431203,4312,괴산군,사리면,계,2347,1561,171,970,38,18,310,1507,54,786
4300,충청북도,괴산군다선거구,6431203,4312,괴산군,사리면,관내사전투표,721,721,76,435,19,13,157,700,21,0
4300,충청북도,괴산군다선거구,6431203,4312,괴산군,사리면,선거일투표,1626,840,95,535,19,5,153,807,33,786
4300,충청북도,괴산군다선거구,6431203,4312,괴산군,잘못 투입·구분된 투표지,,0,2,1,0,0,0,0,1,1,-2
4300,충청북도,증평군가선거구,6431301,4313,증평군,합계,,11883,6220,1475,1275,2573,641,5964,256,5663
4300,충청북도,증평군가선거구,6431301,4313,증평군,거소투표,,21,20,8,2,6,1,17,3,1
4300,충청북도,증평군가선거구,6431301,4313,증평군,관외사전투표,,492,492,150,100,197,31,478,14,0
4300,충청북도,증평군가선거구,6431301,4313,증평군,증평읍,계,11370,5701,1316,1173,2366,608,5463,238,5669
4300,충청북도,증평군가선거구,6431301,4313,증평군,증평읍,관내사전투표,2241,2238,558,504,904,188,2154,84,3
4300,충청북도,증평군가선거구,6431301,4313,증평군,증평읍,선거일투표,9129,3463,758,669,1462,420,3309,154,5666
4300,충청북도,증평군가선거구,6431301,4313,증평군,잘못 투입·구분된 투표지,,0,7,1,0,4,1,6,1,-7
4300,충청북도,증평군나선거구,6431302,4313,증평군,합계,,10421,5853,1837,1560,2260,5657,196,4568
4300,충청북도,증평군나선거구,6431302,4313,증평군,거소투표,,12,12,3,4,3,10,2,0
4300,충청북도,증평군나선거구,6431302,4313,증평군,관외사전투표,,441,441,141,92,190,423,18,0
4300,충청북도,증평군나선거구,6431302,4313,증평군,증평읍,계,9968,5397,1692,1464,2065,5221,176,4571
4300,충청북도,증평군나선거구,6431302,4313,증평군,증평읍,관내사전투표,2270,2269,743,644,819,2206,63,1
4300,충청북도,증평군나선거구,6431302,4313,증평군,증평읍,선거일투표,7698,3128,949,820,1246,3015,113,4570
4300,충청북도,증평군나선거구,6431302,4313,증평군,잘못 투입·구분된 투표지,,0,3,1,0,2,3,0,-3
4300,충청북도,증평군다선거구,6431303,4313,증평군,합계,,9062,4968,1536,1331,1936,4803,165,4094
4300,충청북도,증평군다선거구,6431303,4313,증평군,거소투표,,12,11,3,4,2,9,2,1
4300,충청북도,증평군다선거구,6431303,4313,증평군,관외사전투표,,556,556,147,167,229,543,13,0
4300,충청북도,증평군다선거구,6431303,4313,증평군,증평읍,계,6941,3488,1204,745,1440,3389,99,3453
4300,충청북도,증평군다선거구,6431303,4313,증평군,증평읍,관내사전투표,1408,1404,508,311,539,1358,46,4
4300,충청북도,증평군다선거구,6431303,4313,증평군,증평읍,선거일투표,5533,2084,696,434,901,2031,53,3449
4300,충청북도,증평군다선거구,6431303,4313,증평군,도안면,계,1553,908,178,415,264,857,51,645
4300,충청북도,증평군다선거구,6431303,4313,증평군,도안면,관내사전투표,375,375,77,177,106,360,15,0
4300,충청북도,증평군다선거구,6431303,4313,증평군,도안면,선거일투표,1178,533,101,238,158,497,36,645
4300,충청북도,증평군다선거구,6431303,4313,증평군,잘못 투입·구분된 투표지,,0,5,4,0,1,5,0,-54400,충청남도,천안시라선거구,6441804,4417,천안시서북구,합계,,51742,23853,8601,2785,7334,3526,530,22776,1077,27889
4400,충청남도,천안시라선거구,6441804,4417,천안시서북구,거소투표,,54,49,16,3,19,5,1,44,5,5
4400,충청남도,천안시라선거구,6441804,4417,천안시서북구,관외사전투표,,3079,3075,1088,413,919,429,87,2936,139,4
4400,충청남도,천안시라선거구,6441804,4417,천안시서북구,불당1동,계,23850,10006,3523,1221,2950,1646,249,9589,417,13844
4400,충청남도,천안시라선거구,6441804,4417,천안시서북구,불당1동,관내사전투표,1865,1859,704,251,454,324,47,1780,79,6
4400,충청남도,천안시라선거구,6441804,4417,천안시서북구,불당1동,선거일투표,21985,8147,2819,970,2496,1322,202,7809,338,13838
4400,충청남도,천안시라선거구,6441804,4417,천안시서북구,불당2동,계,24759,10702,3965,1144,3441,1443,193,10186,516,14057
4400,충청남도,천안시라선거구,6441804,4417,천안시서북구,불당2동,관내사전투표,2907,2901,1116,354,854,379,48,2751,150,6
4400,충청남도,천안시라선거구,6441804,4417,천안시서북구,불당2동,선거일투표,21852,7801,2849,790,2587,1064,145,7435,366,14051
4400,충청남도,천안시라선거구,6441804,4417,천안시서북구,잘못 투입·구분된 투표지,,0,21,9,4,5,3,0,21,0,-21
4400,충청남도,천안시마선거구,6441701,4417,천안시서북구,합계,,46359,19947,6930,9387,2761,306,19384,563,26412
4400,충청남도,천안시마선거구,6441701,4417,천안시서북구,거소투표,,62,61,23,18,9,5,55,6,1
4400,충청남도,천안시마선거구,6441701,4417,천안시서북구,관외사전투표,,1535,1531,628,662,159,39,1488,43,4
4400,충청남도,천안시마선거구,6441701,4417,천안시서북구,성환읍,계,20494,8966,2643,4241,1724,104,8712,254,11528
4400,충청남도,천안시마선거구,6441701,4417,천안시서북구,성환읍,관내사전투표,2866,2859,890,1335,530,26,2781,78,7
4400,충청남도,천안시마선거구,6441701,4417,천안시서북구,성환읍,선거일투표,17628,6107,1753,2906,1194,78,5931,176,11521
4400,충청남도,천안시마선거구,6441701,4417,천안시서북구,직산읍,계,16744,6117,2652,2648,547,112,5959,158,10627
4400,충청남도,천안시마선거구,6441701,4417,천안시서북구,직산읍,관내사전투표,2009,2008,872,849,186,26,1933,75,1
4400,충청남도,천안시마선거구,6441701,4417,천안시서북구,직산읍,선거일투표,14735,4109,1780,1799,361,86,4026,83,10626
4400,충청남도,천안시마선거구,6441701,4417,천안시서북구,입장면,계,7524,3252,979,1808,319,45,3151,101,4272
4400,충청남도,천안시마선거구,6441701,4417,천안시서북구,입장면,관내사전투표,1240,1238,392,663,123,17,1195,43,2
4400,충청남도,천안시마선거구,6441701,4417,천안시서북구,입장면,선거일투표,6284,2014,587,1145,196,28,1956,58,4270
4400,충청남도,천안시마선거구,6441701,4417,천안시서북구,잘못 투입·구분된 투표지,,0,20,5,10,3,1,19,1,-20
4400,충청남도,천안시바선거구,6441702,4417,천안시서북구,합계,,59420,22866,8440,3036,7691,2067,21234,1632,36554
4400,충청남도,천안시바선거구,6441702,4417,천안시서북구,거소투표,,74,69,14,10,24,5,53,16,5
4400,충청남도,천안시바선거구,6441702,4417,천안시서북구,관외사전투표,,3270,3265,1189,462,1056,289,2996,269,5
4400,충청남도,천안시바선거구,6441702,4417,천안시서북구,성거읍,계,16718,5845,1900,891,2104,526,5421,424,10873
4400,충청남도,천안시바선거구,6441702,4417,천안시서북구,성거읍,관내사전투표,1622,1615,501,273,560,136,1470,145,7
4400,충청남도,천안시바선거구,6441702,4417,천안시서북구,성거읍,선거일투표,15096,4230,1399,618,1544,390,3951,279,10866
4400,충청남도,천안시바선거구,6441702,4417,천안시서북구,부성1동,계,39358,13676,5331,1671,4505,1247,12754,922,25682
4400,충청남도,천안시바선거구,6441702,4417,천안시서북구,부성1동,관내사전투표,2717,2715,1117,367,783,221,2488,227,2
4400,충청남도,천안시바선거구,6441702,4417,천안시서북구,부성1동,선거일투표,36641,10961,4214,1304,3722,1026,10266,695,25680
4400,충청남도,천안시바선거구,6441702,4417,천안시서북구,잘못 투입·구분된 투표지,,0,11,6,2,2,0,10,1,-11
4400,충청남도,천안시사선거구,6441703,4417,천안시서북구,합계,,44288,15836,6202,2439,6292,599,15532,304,28452
4400,충청남도,천안시사선거구,6441703,4417,천안시서북구,거소투표,,40,37,16,7,9,2,34,3,3
4400,충청남도,천안시사선거구,6441703,4417,천안시서북구,관외사전투표,,1891,1884,669,309,774,75,1827,57,7
4400,충청남도,천안시사선거구,6441703,4417,천안시서북구,부성2동,계,42357,13899,5512,2122,5500,522,13656,243,28458
4400,충청남도,천안시사선거구,6441703,4417,천안시서북구,부성2동,관내사전투표,2131,2130,812,352,867,63,2094,36,1
4400,충청남도,천안시사선거구,6441703,4417,천안시서북구,부성2동,선거일투표,40226,11769,4700,1770,4633,459,11562,207,28457
4400,충청남도,천안시사선거구,6441703,4417,천안시서북구,잘못 투입·구분된 투표지,,0,16,5,1,9,0,15,1,-16
4400,충청남도,천안시아선거구,6441704,4417,천안시서북구,검색된 결과가 없습니다.
4400,충청남도,천안시카선거구,6441706,4417,천안시서북구,합계,,58129,26494,9267,3529,8766,3094,24656,1838,31635
4400,충청남도,천안시카선거구,6441706,4417,천안시서북구,거소투표,,60,56,13,8,26,3,50,6,4
4400,충청남도,천안시카선거구,6441706,4417,천안시서북구,관외사전투표,,2909,2905,1100,331,971,289,2691,214,4
4400,충청남도,천안시카선거구,6441706,4417,천안시서북구,쌍용1동,계,11460,4801,1343,743,1788,587,4461,340,6659
4400,충청남도,천안시카선거구,6441706,4417,천안시서북구,쌍용1동,관내사전투표,1484,1481,416,242,504,174,1336,145,3
4400,충청남도,천안시카선거구,6441706,4417,천안시서북구,쌍용1동,선거일투표,9976,3320,927,501,1284,413,3125,195,6656
4400,충청남도,천안시카선거구,6441706,4417,천안시서북구,쌍용2동,계,28714,11860,4303,1564,3754,1468,11089,771,16854
4400,충청남도,천안시카선거구,6441706,4417,천안시서북구,쌍용2동,관내사전투표,3228,3226,1202,469,976,336,2983,243,2
4400,충청남도,천안시카선거구,6441706,4417,천안시서북구,쌍용2동,선거일투표,25486,8634,3101,1095,2778,1132,8106,528,16852
4400,충청남도,천안시카선거구,6441706,4417,천안시서북구,쌍용3동,계,14986,6853,2501,880,2221,745,6347,506,8133
4400,충청남도,천안시카선거구,6441706,4417,천안시서북구,쌍용3동,관내사전투표,2109,2106,807,298,631,196,1932,174,3
4400,충청남도,천안시카선거구,6441706,4417,천안시서북구,쌍용3동,선거일투표,12877,4747,1694,582,1590,549,4415,332,8130
4400,충청남도,천안시카선거구,6441706,4417,천안시서북구,잘못 투입·구분된 투표지,,0,19,7,3,6,2,18,1,-19
4400,충청남도,천안시가선거구,6441801,4418,천안시동남구,합계,,53986,24580,7264,3108,7732,4741,22845,1735,29406
4400,충청남도,천안시가선거구,6441801,4418,천안시동남구,거소투표,,61,58,19,8,20,8,55,3,3
4400,충청남도,천안시가선거구,6441801,4418,천안시동남구,관외사전투표,,2327,2317,757,330,723,309,2119,198,10
4400,충청남도,천안시가선거구,6441801,4418,천안시동남구,목천읍,계,19701,7774,2480,1132,1745,1920,7277,497,11927
4400,충청남도,천안시가선거구,6441801,4418,천안시동남구,목천읍,관내사전투표,1919,1918,591,314,401,452,1758,160,1
4400,충청남도,천안시가선거구,6441801,4418,천안시동남구,목천읍,선거일투표,17782,5856,1889,818,1344,1468,5519,337,11926
4400,충청남도,천안시가선거구,6441801,4418,천안시동남구,북면,계,3684,1584,422,198,422,419,1461,123,2100
4400,충청남도,천안시가선거구,6441801,4418,천안시동남구,북면,관내사전투표,456,446,117,59,122,99,397,49,10
4400,충청남도,천안시가선거구,6441801,4418,천안시동남구,북면,선거일투표,3228,1138,305,139,300,320,1064,74,2090
4400,충청남도,천안시가선거구,6441801,4418,천안시동남구,성남면,계,2876,1514,690,105,359,254,1408,106,1362
4400,충청남도,천안시가선거구,6441801,4418,천안시동남구,성남면,관내사전투표,644,638,282,47,145,105,579,59,6
4400,충청남도,천안시가선거구,6441801,4418,천안시동남구,성남면,선거일투표,2232,876,408,58,214,149,829,47,1356
4400,충청남도,천안시가선거구,6441801,4418,천안시동남구,수신면,계,2089,965,317,101,275,202,895,70,1124
4400,충청남도,천안시가선거구,6441801,4418,천안시동남구,수신면,관내사전투표,391,387,125,44,107,73,349,38,4
4400,충청남도,천안시가선거구,6441801,4418,천안시동남구,수신면,선거일투표,1698,578,192,57,168,129,546,32,1120
4400,충청남도,천안시가선거구,6441801,4418,천안시동남구,병천면,계,5732,2619,728,292,1004,407,2431,188,3113
4400,충청남도,천안시가선거구,6441801,4418,천안시동남구,병천면,관내사전투표,1080,1079,299,125,397,168,989,90,1
4400,충청남도,천안시가선거구,6441801,4418,천안시동남구,병천면,선거일투표,4652,1540,429,167,607,239,1442,98,3112
4400,충청남도,천안시가선거구,6441801,4418,천안시동남구,동면,계,1858,1016,199,96,502,156,953,63,842
4400,충청남도,천안시가선거구,6441801,4418,천안시동남구,동면,관내사전투표,441,441,93,41,213,63,410,31,0
4400,충청남도,천안시가선거구,6441801,4418,천안시동남구,동면,선거일투표,1417,575,106,55,289,93,543,32,842
4400,충청남도,천안시가선거구,6441801,4418,천안시동남구,원성1동,계,7435,3148,784,379,1224,502,2889,259,4287
4400,충청남도,천안시가선거구,6441801,4418,천안시동남구,원성1동,관내사전투표,1089,1088,292,139,368,175,974,114,1
4400,충청남도,천안시가선거구,6441801,4418,천안시동남구,원성1동,선거일투표,6346,2060,492,240,856,327,1915,145,4286
4400,충청남도,천안시가선거구,6441801,4418,천안시동남구,원성2동,계,8223,3548,852,465,1447,560,3324,224,4675
4400,충청남도,천안시가선거구,6441801,4418,천안시동남구,원성2동,관내사전투표,1336,1335,357,185,468,234,1244,91,1
4400,충청남도,천안시가선거구,6441801,4418,천안시동남구,원성2동,선거일투표,6887,2213,495,280,979,326,2080,133,4674
4400,충청남도,천안시가선거구,6441801,4418,천안시동남구,잘못 투입·구분된 투표지,,0,37,16,2,11,4,33,4,-37
4400,충청남도,천안시나선거구,6441802,4418,천안시동남구,검색된 결과가 없습니다.
4400,충청남도,천안시다선거구,6441803,4418,천안시동남구,합계,,60705,20754,7125,2323,10790,20238,516,39951
4400,충청남도,천안시다선거구,6441803,4418,천안시동남구,거소투표,,48,45,22,4,18,44,1,3
4400,충청남도,천안시다선거구,6441803,4418,천안시동남구,관외사전투표,,2601,2598,962,310,1237,2509,89,3
4400,충청남도,천안시다선거구,6441803,4418,천안시동남구,문성동,계,4096,1655,544,165,900,1609,46,2441
4400,충청남도,천안시다선거구,6441803,4418,천안시동남구,문성동,관내사전투표,749,749,244,65,416,725,24,0
4400,충청남도,천안시다선거구,6441803,4418,천안시동남구,문성동,선거일투표,3347,906,300,100,484,884,22,2441
4400,충청남도,천안시다선거구,6441803,4418,천안시동남구,봉명동,계,15276,5476,1889,616,2854,5359,117,9800
4400,충청남도,천안시다선거구,6441803,4418,천안시동남구,봉명동,관내사전투표,1605,1605,559,168,832,1559,46,0
4400,충청남도,천안시다선거구,6441803,4418,천안시동남구,봉명동,선거일투표,13671,3871,1330,448,2022,3800,71,9800
4400,충청남도,천안시다선거구,6441803,4418,천안시동남구,성정1동,계,15162,5257,1654,596,2880,5130,127,9905
4400,충청남도,천안시다선거구,6441803,4418,천안시동남구,성정1동,관내사전투표,1254,1254,408,138,664,1210,44,0
4400,충청남도,천안시다선거구,6441803,4418,천안시동남구,성정1동,선거일투표,13908,4003,1246,458,2216,3920,83,9905
4400,충청남도,천안시다선거구,6441803,4418,천안시동남구,성정2동,계,23522,5714,2051,631,2897,5579,135,17808
4400,충청남도,천안시다선거구,6441803,4418,천안시동남구,성정2동,관내사전투표,1644,1641,631,178,801,1610,31,3
4400,충청남도,천안시다선거구,6441803,4418,천안시동남구,성정2동,선거일투표,21878,4073,1420,453,2096,3969,104,17805
4400,충청남도,천안시다선거구,6441803,4418,천안시동남구,잘못 투입·구분된 투표지,,0,9,3,1,4,8,1,-9
4400,충청남도,천안시자선거구,6441705,4418,천안시동남구,합계,,43400,18790,5879,3023,5858,2631,17391,1399,24610
4400,충청남도,천안시자선거구,6441705,4418,천안시동남구,거소투표,,46,43,19,5,13,5,42,1,3
4400,충청남도,천안시자선거구,6441705,4418,천안시동남구,관외사전투표,,1982,1981,664,327,629,202,1822,159,1
4400,충청남도,천안시자선거구,6441705,4418,천안시동남구,풍세면,계,3699,1787,455,195,690,279,1619,168,1912
4400,충청남도,천안시자선거구,6441705,4418,천안시동남구,풍세면,관내사전투표,658,658,160,76,249,87,572,86,0
4400,충청남도,천안시자선거구,6441705,4418,천안시동남구,풍세면,선거일투표,3041,1129,295,119,441,192,1047,82,1912
4400,충청남도,천안시자선거구,6441705,4418,천안시동남구,광덕면,계,3760,2049,520,198,755,410,1883,166,1711
4400,충청남도,천안시자선거구,6441705,4418,천안시동남구,광덕면,관내사전투표,584,584,169,71,209,85,534,50,0
4400,충청남도,천안시자선거구,6441705,4418,천안시동남구,광덕면,선거일투표,3176,1465,351,127,546,325,1349,116,1711
4400,충청남도,천안시자선거구,6441705,4418,천안시동남구,신방동,계,33913,12917,4219,2296,3768,1731,12014,903,20996
4400,충청남도,천안시자선거구,6441705,4418,천안시동남구,신방동,관내사전투표,2810,2808,969,469,750,381,2569,239,2
4400,충청남도,천안시자선거구,6441705,4418,천안시동남구,신방동,선거일투표,31103,10109,3250,1827,3018,1350,9445,664,20994
4400,충청남도,천안시자선거구,6441705,4418,천안시동남구,잘못 투입·구분된 투표지,,0,13,2,2,3,4,11,2,-13
4400,충청남도,천안시차선거구,6441805,4418,천안시동남구,합계,,43645,19841,8941,6967,3497,19405,436,23804
4400,충청남도,천안시차선거구,6441805,4418,천안시동남구,거소투표,,48,45,25,12,7,44,1,3
4400,충청남도,천안시차선거구,6441805,4418,천안시동남구,관외사전투표,,2699,2699,1245,927,426,2598,101,0
4400,충청남도,천안시차선거구,6441805,4418,천안시동남구,청룡동,계,40898,17091,7669,6026,3063,16758,333,23807
4400,충청남도,천안시차선거구,6441805,4418,천안시동남구,청룡동,관내사전투표,3852,3849,1886,1262,637,3785,64,3
4400,충청남도,천안시차선거구,6441805,4418,천안시동남구,청룡동,선거일투표,37046,13242,5783,4764,2426,12973,269,23804
4400,충청남도,천안시차선거구,6441805,4418,천안시동남구,잘못 투입·구분된 투표지,,0,6,2,2,1,5,1,-6
4400,충청남도,공주시가선거구,6440201,4402,공주시,합계,,17093,10452,2691,1531,3022,2516,9760,692,6641
4400,충청남도,공주시가선거구,6440201,4402,공주시,거소투표,,28,27,5,1,10,7,23,4,1
4400,충청남도,공주시가선거구,6440201,4402,공주시,관외사전투표,,1259,1259,380,186,357,251,1174,85,0
4400,충청남도,공주시가선거구,6440201,4402,공주시,유구읍,계,6386,3770,1335,277,1654,262,3528,242,2616
4400,충청남도,공주시가선거구,6440201,4402,공주시,유구읍,관내사전투표,1446,1445,545,93,604,78,1320,125,1
4400,충청남도,공주시가선거구,6440201,4402,공주시,유구읍,선거일투표,4940,2325,790,184,1050,184,2208,117,2615
4400,충청남도,공주시가선거구,6440201,4402,공주시,우성면,계,4350,2501,339,597,319,1082,2337,164,1849
4400,충청남도,공주시가선거구,6440201,4402,공주시,우성면,관내사전투표,565,563,93,127,77,225,522,41,2
4400,충청남도,공주시가선거구,6440201,4402,공주시,우성면,선거일투표,3785,1938,246,470,242,857,1815,123,1847
4400,충청남도,공주시가선거구,6440201,4402,공주시,사곡면,계,2420,1405,258,242,268,530,1298,107,1015
4400,충청남도,공주시가선거구,6440201,4402,공주시,사곡면,관내사전투표,527,527,89,87,106,190,472,55,0
4400,충청남도,공주시가선거구,6440201,4402,공주시,사곡면,선거일투표,1893,878,169,155,162,340,826,52,1015
4400,충청남도,공주시가선거구,6440201,4402,공주시,신풍면,계,2650,1482,372,227,412,381,1392,90,1168
4400,충청남도,공주시가선거구,6440201,4402,공주시,신풍면,관내사전투표,693,691,180,86,207,169,642,49,2
4400,충청남도,공주시가선거구,6440201,4402,공주시,신풍면,선거일투표,1957,791,192,141,205,212,750,41,1166
4400,충청남도,공주시가선거구,6440201,4402,공주시,잘못 투입·구분된 투표지,,0,8,2,1,2,3,8,0,-8
4400,충청남도,공주시나선거구,6440202,4402,공주시,합계,,36870,19927,4688,2338,1600,4615,3210,1457,1096,19004,923,16943
4400,충청남도,공주시나선거구,6440202,4402,공주시,거소투표,,57,51,10,3,4,20,8,3,0,48,3,6
4400,충청남도,공주시나선거구,6440202,4402,공주시,관외사전투표,,2459,2458,658,285,200,609,310,145,122,2329,129,1
4400,충청남도,공주시나선거구,6440202,4402,공주시,의당면,계,4248,2348,536,458,104,522,365,100,139,2224,124,1900
4400,충청남도,공주시나선거구,6440202,4402,공주시,의당면,관내사전투표,1115,1115,281,190,50,250,163,63,57,1054,61,0
4400,충청남도,공주시나선거구,6440202,4402,공주시,의당면,선거일투표,3133,1233,255,268,54,272,202,37,82,1170,63,1900
4400,충청남도,공주시나선거구,6440202,4402,공주시,정안면,계,4074,2217,339,299,64,375,418,406,188,2089,128,1857
4400,충청남도,공주시나선거구,6440202,4402,공주시,정안면,관내사전투표,860,860,132,115,28,141,152,176,64,808,52,0
4400,충청남도,공주시나선거구,6440202,4402,공주시,정안면,선거일투표,3214,1357,207,184,36,234,266,230,124,1281,76,1857
4400,충청남도,공주시나선거구,6440202,4402,공주시,신관동,계,15117,6971,1706,709,588,1764,1122,412,368,6669,302,8146
4400,충청남도,공주시나선거구,6440202,4402,공주시,신관동,관내사전투표,2602,2600,648,258,241,639,406,150,129,2471,129,2
4400,충청남도,공주시나선거구,6440202,4402,공주시,신관동,선거일투표,12515,4371,1058,451,347,1125,716,262,239,4198,173,8144
4400,충청남도,공주시나선거구,6440202,4402,공주시,월송동,계,10915,5876,1438,584,640,1323,984,391,279,5639,237,5039
4400,충청남도,공주시나선거구,6440202,4402,공주시,월송동,관내사전투표,2951,2949,729,304,342,638,483,197,138,2831,118,2
4400,충청남도,공주시나선거구,6440202,4402,공주시,월송동,선거일투표,7964,2927,709,280,298,685,501,194,141,2808,119,5037
4400,충청남도,공주시나선거구,6440202,4402,공주시,잘못 투입·구분된 투표지,,0,6,1,0,0,2,3,0,0,6,0,-6
4400,충청남도,공주시다선거구,6440203,4402,공주시,합계,,14656,8476,2758,3859,1501,8118,358,6180
4400,충청남도,공주시다선거구,6440203,4402,공주시,거소투표,,17,16,7,5,4,16,0,1
4400,충청남도,공주시다선거구,6440203,4402,공주시,관외사전투표,,954,954,370,416,148,934,20,0
4400,충청남도,공주시다선거구,6440203,4402,공주시,이인면,계,2793,1617,418,953,182,1553,64,1176
4400,충청남도,공주시다선거구,6440203,4402,공주시,이인면,관내사전투표,574,574,166,320,60,546,28,0
4400,충청남도,공주시다선거구,6440203,4402,공주시,이인면,선거일투표,2219,1043,252,633,122,1007,36,1176
4400,충청남도,공주시다선거구,6440203,4402,공주시,탄천면,계,2549,1425,519,677,144,1340,85,1124
4400,충청남도,공주시다선거구,6440203,4402,공주시,탄천면,관내사전투표,524,524,200,231,58,489,35,0
4400,충청남도,공주시다선거구,6440203,4402,공주시,탄천면,선거일투표,2025,901,319,446,86,851,50,1124
4400,충청남도,공주시다선거구,6440203,4402,공주시,계룡면,계,4658,2523,715,881,838,2434,89,2135
4400,충청남도,공주시다선거구,6440203,4402,공주시,계룡면,관내사전투표,751,751,241,252,225,718,33,0
4400,충청남도,공주시다선거구,6440203,4402,공주시,계룡면,선거일투표,3907,1772,474,629,613,1716,56,2135
4400,충청남도,공주시다선거구,6440203,4402,공주시,반포면,계,3685,1940,729,927,185,1841,99,1745
4400,충청남도,공주시다선거구,6440203,4402,공주시,반포면,관내사전투표,721,721,280,311,83,674,47,0
4400,충청남도,공주시다선거구,6440203,4402,공주시,반포면,선거일투표,2964,1219,449,616,102,1167,52,1745
4400,충청남도,공주시다선거구,6440203,4402,공주시,잘못 투입·구분된 투표지,,0,1,0,0,0,0,1,-1
4400,충청남도,공주시라선거구,6440204,4402,공주시,합계,,23228,12603,3301,1807,3443,1351,385,1658,11945,658,10625
4400,충청남도,공주시라선거구,6440204,4402,공주시,거소투표,,34,31,7,8,9,3,1,2,30,1,3
4400,충청남도,공주시라선거구,6440204,4402,공주시,관외사전투표,,1284,1280,410,192,374,123,33,84,1216,64,4
4400,충청남도,공주시라선거구,6440204,4402,공주시,중학동,계,4005,2083,532,272,567,247,56,288,1962,121,1922
4400,충청남도,공주시라선거구,6440204,4402,공주시,중학동,관내사전투표,722,720,207,121,172,72,24,85,681,39,2
4400,충청남도,공주시라선거구,6440204,4402,공주시,중학동,선거일투표,3283,1363,325,151,395,175,32,203,1281,82,1920
4400,충청남도,공주시라선거구,6440204,4402,공주시,웅진동,계,6877,3672,906,529,983,366,132,588,3504,168,3205
4400,충청남도,공주시라선거구,6440204,4402,공주시,웅진동,관내사전투표,1713,1713,434,259,471,148,64,257,1633,80,0
4400,충청남도,공주시라선거구,6440204,4402,공주시,웅진동,선거일투표,5164,1959,472,270,512,218,68,331,1871,88,3205
4400,충청남도,공주시라선거구,6440204,4402,공주시,금학동,계,4326,2133,575,351,554,247,66,227,2020,113,2193
4400,충청남도,공주시라선거구,6440204,4402,공주시,금학동,관내사전투표,873,873,240,149,214,101,34,85,823,50,0
4400,충청남도,공주시라선거구,6440204,4402,공주시,금학동,선거일투표,3453,1260,335,202,340,146,32,142,1197,63,2193
4400,충청남도,공주시라선거구,6440204,4402,공주시,옥룡동,계,6702,3396,868,453,955,365,97,469,3207,189,3306
4400,충청남도,공주시라선거구,6440204,4402,공주시,옥룡동,관내사전투표,1284,1284,331,167,341,138,42,181,1200,84,0
4400,충청남도,공주시라선거구,6440204,4402,공주시,옥룡동,선거일투표,5418,2112,537,286,614,227,55,288,2007,105,3306
4400,충청남도,공주시라선거구,6440204,4402,공주시,잘못 투입·구분된 투표지,,0,8,3,2,1,0,0,0,6,2,-8
4400,충청남도,보령시가선거구,6440301,4403,보령시,합계,,16359,10560,2893,4111,3094,10098,462,5799
4400,충청남도,보령시가선거구,6440301,4403,보령시,거소투표,,30,27,8,8,10,26,1,3
4400,충청남도,보령시가선거구,6440301,4403,보령시,관외사전투표,,1050,1049,384,381,255,1020,29,1
4400,충청남도,보령시가선거구,6440301,4403,보령시,웅천읍,계,5407,3365,850,1910,468,3228,137,2042
4400,충청남도,보령시가선거구,6440301,4403,보령시,웅천읍,관내사전투표,1435,1435,406,778,173,1357,78,0
4400,충청남도,보령시가선거구,6440301,4403,보령시,웅천읍,선거일투표,3972,1930,444,1132,295,1871,59,2042
4400,충청남도,보령시가선거구,6440301,4403,보령시,남포면,계,4368,2548,564,613,1265,2442,106,1820
4400,충청남도,보령시가선거구,6440301,4403,보령시,남포면,관내사전투표,1030,1028,243,247,488,978,50,2
4400,충청남도,보령시가선거구,6440301,4403,보령시,남포면,선거일투표,3338,1520,321,366,777,1464,56,1818
4400,충청남도,보령시가선거구,6440301,4403,보령시,주산면,계,2145,1380,513,490,305,1308,72,765
4400,충청남도,보령시가선거구,6440301,4403,보령시,주산면,관내사전투표,550,549,193,192,134,519,30,1
4400,충청남도,보령시가선거구,6440301,4403,보령시,주산면,선거일투표,1595,831,320,298,171,789,42,764
4400,충청남도,보령시가선거구,6440301,4403,보령시,미산면,계,1440,952,214,364,302,880,72,488
4400,충청남도,보령시가선거구,6440301,4403,보령시,미산면,관내사전투표,283,282,66,104,85,255,27,1
4400,충청남도,보령시가선거구,6440301,4403,보령시,미산면,선거일투표,1157,670,148,260,217,625,45,487
4400,충청남도,보령시가선거구,6440301,4403,보령시,성주면,계,1919,1227,355,340,487,1182,45,692
4400,충청남도,보령시가선거구,6440301,4403,보령시,성주면,관내사전투표,544,543,155,158,213,526,17,1
4400,충청남도,보령시가선거구,6440301,4403,보령시,성주면,선거일투표,1375,684,200,182,274,656,28,691
4400,충청남도,보령시가선거구,6440301,4403,보령시,잘못 투입·구분된 투표지,,0,12,5,5,2,12,0,-12
4400,충청남도,보령시나선거구,6440302,4403,보령시,합계,,32360,18649,3520,2033,1871,2673,2825,2091,1993,650,17656,993,13711
4400,충청남도,보령시나선거구,6440302,4403,보령시,거소투표,,79,71,16,7,8,9,12,7,3,3,65,6,8
4400,충청남도,보령시나선거구,6440302,4403,보령시,관외사전투표,,2691,2689,525,349,330,450,299,237,251,93,2534,155,2
4400,충청남도,보령시나선거구,6440302,4403,보령시,대천3동,계,11460,6016,1215,725,700,802,705,757,655,174,5733,283,5444
4400,충청남도,보령시나선거구,6440302,4403,보령시,대천3동,관내사전투표,1948,1948,426,246,233,253,196,253,207,46,1860,88,0
4400,충청남도,보령시나선거구,6440302,4403,보령시,대천3동,선거일투표,9512,4068,789,479,467,549,509,504,448,128,3873,195,5444
4400,충청남도,보령시나선거구,6440302,4403,보령시,대천4동,계,12806,7055,1246,716,688,999,1144,714,848,323,6678,377,5751
4400,충청남도,보령시나선거구,6440302,4403,보령시,대천4동,관내사전투표,3202,3199,565,329,312,462,547,351,366,109,3041,158,3
4400,충청남도,보령시나선거구,6440302,4403,보령시,대천4동,선거일투표,9604,3856,681,387,376,537,597,363,482,214,3637,219,5748
4400,충청남도,보령시나선거구,6440302,4403,보령시,대천5동,계,5324,2816,518,236,145,413,664,376,236,56,2644,172,2508
4400,충청남도,보령시나선거구,6440302,4403,보령시,대천5동,관내사전투표,1060,1061,181,87,80,157,228,149,86,17,985,76,-1
4400,충청남도,보령시나선거구,6440302,4403,보령시,대천5동,선거일투표,4264,1755,337,149,65,256,436,227,150,39,1659,96,2509
4400,충청남도,보령시나선거구,6440302,4403,보령시,잘못 투입·구분된 투표지,,0,2,0,0,0,0,1,0,0,1,2,0,-2
4400,충청남도,보령시다선거구,6440303,4403,보령시,합계,,19963,12875,2383,1757,3670,2108,2259,12177,698,7088
4400,충청남도,보령시다선거구,6440303,4403,보령시,거소투표,,66,54,9,9,24,4,5,51,3,12
4400,충청남도,보령시다선거구,6440303,4403,보령시,관외사전투표,,1878,1875,452,274,545,247,265,1783,92,3
4400,충청남도,보령시다선거구,6440303,4403,보령시,주포면,계,1398,913,436,76,170,40,145,867,46,485
4400,충청남도,보령시다선거구,6440303,4403,보령시,주포면,관내사전투표,478,477,234,36,93,17,73,453,24,1
4400,충청남도,보령시다선거구,6440303,4403,보령시,주포면,선거일투표,920,436,202,40,77,23,72,414,22,484
4400,충청남도,보령시다선거구,6440303,4403,보령시,주교면,계,4235,2253,464,471,564,229,336,2064,189,1982
4400,충청남도,보령시다선거구,6440303,4403,보령시,주교면,관내사전투표,972,971,209,198,216,92,129,844,127,1
4400,충청남도,보령시다선거구,6440303,4403,보령시,주교면,선거일투표,3263,1282,255,273,348,137,207,1220,62,1981
4400,충청남도,보령시다선거구,6440303,4403,보령시,오천면,계,3920,2324,319,336,443,131,967,2196,128,1596
4400,충청남도,보령시다선거구,6440303,4403,보령시,오천면,관내사전투표,539,539,78,82,87,20,248,515,24,0
4400,충청남도,보령시다선거구,6440303,4403,보령시,오천면,선거일투표,3381,1785,241,254,356,111,719,1681,104,1596
4400,충청남도,보령시다선거구,6440303,4403,보령시,천북면,계,2949,1914,181,224,1262,86,93,1846,68,1035
4400,충청남도,보령시다선거구,6440303,4403,보령시,천북면,관내사전투표,724,724,69,81,465,40,26,681,43,0
4400,충청남도,보령시다선거구,6440303,4403,보령시,천북면,선거일투표,2225,1190,112,143,797,46,67,1165,25,1035
4400,충청남도,보령시다선거구,6440303,4403,보령시,청소면,계,2292,1435,293,173,367,160,367,1360,75,857
4400,충청남도,보령시다선거구,6440303,4403,보령시,청소면,관내사전투표,687,687,128,86,177,80,180,651,36,0
4400,충청남도,보령시다선거구,6440303,4403,보령시,청소면,선거일투표,1605,748,165,87,190,80,187,709,39,857
4400,충청남도,보령시다선거구,6440303,4403,보령시,청라면,계,3225,2103,227,194,294,1210,81,2006,97,1122
4400,충청남도,보령시다선거구,6440303,4403,보령시,청라면,관내사전투표,778,778,65,68,126,449,31,739,39,0
4400,충청남도,보령시다선거구,6440303,4403,보령시,청라면,선거일투표,2447,1325,162,126,168,761,50,1267,58,1122
4400,충청남도,보령시다선거구,6440303,4403,보령시,잘못 투입·구분된 투표지,,0,4,2,0,1,1,0,4,0,-4
4400,충청남도,보령시라선거구,6440304,4403,보령시,합계,,17582,10445,2391,1401,4756,1205,9753,692,7137
4400,충청남도,보령시라선거구,6440304,4403,보령시,거소투표,,42,41,11,5,20,1,37,4,1
4400,충청남도,보령시라선거구,6440304,4403,보령시,관외사전투표,,1491,1489,407,198,644,140,1389,100,2
4400,충청남도,보령시라선거구,6440304,4403,보령시,대천1동,계,10406,5540,1242,802,2497,600,5141,399,4866
4400,충청남도,보령시라선거구,6440304,4403,보령시,대천1동,관내사전투표,1849,1847,406,264,833,190,1693,154,2
4400,충청남도,보령시라선거구,6440304,4403,보령시,대천1동,선거일투표,8557,3693,836,538,1664,410,3448,245,4864
4400,충청남도,보령시라선거구,6440304,4403,보령시,대천2동,계,5643,3368,728,396,1594,463,3181,187,2275
4400,충청남도,보령시라선거구,6440304,4403,보령시,대천2동,관내사전투표,1730,1728,376,210,794,233,1613,115,2
4400,충청남도,보령시라선거구,6440304,4403,보령시,대천2동,선거일투표,3913,1640,352,186,800,230,1568,72,2273
4400,충청남도,보령시라선거구,6440304,4403,보령시,잘못 투입·구분된 투표지,,0,7,3,0,1,1,5,2,-7
4400,충청남도,아산시가선거구,6440401,4404,아산시,검색된 결과가 없습니다.
4400,충청남도,아산시나선거구,6440402,4404,아산시,합계,,47459,21590,7065,2572,5045,5059,19741,1849,25869
4400,충청남도,아산시나선거구,6440402,4404,아산시,거소투표,,50,48,19,5,9,6,39,9,2
4400,충청남도,아산시나선거구,6440402,4404,아산시,관외사전투표,,2200,2197,806,251,528,440,2025,172,3
4400,충청남도,아산시나선거구,6440402,4404,아산시,온양1동,계,7617,3129,988,365,780,726,2859,270,4488
4400,충청남도,아산시나선거구,6440402,4404,아산시,온양1동,관내사전투표,1142,1142,357,143,261,274,1035,107,0
4400,충청남도,아산시나선거구,6440402,4404,아산시,온양1동,선거일투표,6475,1987,631,222,519,452,1824,163,4488
4400,충청남도,아산시나선거구,6440402,4404,아산시,온양2동,계,9429,3863,1040,419,1102,930,3491,372,5566
4400,충청남도,아산시나선거구,6440402,4404,아산시,온양2동,관내사전투표,1546,1543,397,170,429,374,1370,173,3
4400,충청남도,아산시나선거구,6440402,4404,아산시,온양2동,선거일투표,7883,2320,643,249,673,556,2121,199,5563
4400,충청남도,아산시나선거구,6440402,4404,아산시,온양3동,계,28163,12343,4209,1531,2625,2952,11317,1026,15820
4400,충청남도,아산시나선거구,6440402,4404,아산시,온양3동,관내사전투표,3700,3695,1197,483,762,896,3338,357,5
4400,충청남도,아산시나선거구,6440402,4404,아산시,온양3동,선거일투표,24463,8648,3012,1048,1863,2056,7979,669,15815
4400,충청남도,아산시나선거구,6440402,4404,아산시,잘못 투입·구분된 투표지,,0,10,3,1,1,5,10,0,-10
4400,충청남도,아산시다선거구,6440403,4404,아산시,합계,,39859,18206,5289,4036,8497,17822,384,21653
4400,충청남도,아산시다선거구,6440403,4404,아산시,거소투표,,45,43,10,6,22,38,5,2
4400,충청남도,아산시다선거구,6440403,4404,아산시,관외사전투표,,2229,2224,687,415,1063,2165,59,5
4400,충청남도,아산시다선거구,6440403,4404,아산시,온양5동,계,16156,6627,1984,1339,3173,6496,131,9529
4400,충청남도,아산시다선거구,6440403,4404,아산시,온양5동,관내사전투표,1786,1784,580,398,770,1748,36,2
4400,충청남도,아산시다선거구,6440403,4404,아산시,온양5동,선거일투표,14370,4843,1404,941,2403,4748,95,9527
4400,충청남도,아산시다선거구,6440403,4404,아산시,온양6동,계,21429,9307,2606,2274,4238,9118,189,12122
4400,충청남도,아산시다선거구,6440403,4404,아산시,온양6동,관내사전투표,1901,1898,571,455,831,1857,41,3
4400,충청남도,아산시다선거구,6440403,4404,아산시,온양6동,선거일투표,19528,7409,2035,1819,3407,7261,148,12119
4400,충청남도,아산시다선거구,6440403,4404,아산시,잘못 투입·구분된 투표지,,0,5,2,2,1,5,0,-5
4400,충청남도,아산시라선거구,6440404,4404,아산시,합계,,50533,23317,6712,5351,6214,3111,21388,1929,27216
4400,충청남도,아산시라선거구,6440404,4404,아산시,거소투표,,41,39,14,8,11,2,35,4,2
4400,충청남도,아산시라선거구,6440404,4404,아산시,관외사전투표,,3727,3723,1074,805,1015,464,3358,365,4
4400,충청남도,아산시라선거구,6440404,4404,아산시,염치읍,계,5326,2208,510,345,826,313,1994,214,3118
4400,충청남도,아산시라선거구,6440404,4404,아산시,염치읍,관내사전투표,639,639,150,106,225,89,570,69,0
4400,충청남도,아산시라선거구,6440404,4404,아산시,염치읍,선거일투표,4687,1569,360,239,601,224,1424,145,3118
4400,충청남도,아산시라선거구,6440404,4404,아산시,배방읍,계,21248,8865,2695,2096,2122,1219,8132,733,12383
4400,충청남도,아산시라선거구,6440404,4404,아산시,배방읍,관내사전투표,861,860,262,219,179,113,773,87,1
4400,충청남도,아산시라선거구,6440404,4404,아산시,배방읍,선거일투표,20387,8005,2433,1877,1943,1106,7359,646,12382
4400,충청남도,아산시라선거구,6440404,4404,아산시,탕정면,계,20191,8477,2418,2095,2239,1112,7864,613,11714
4400,충청남도,아산시라선거구,6440404,4404,아산시,탕정면,관내사전투표,2248,2247,642,480,613,312,2047,200,1
4400,충청남도,아산시라선거구,6440404,4404,아산시,탕정면,선거일투표,17943,6230,1776,1615,1626,800,5817,413,11713
4400,충청남도,아산시라선거구,6440404,4404,아산시,잘못 투입·구분된 투표지,,0,5,1,2,1,1,5,0,-5
4400,충청남도,아산시마선거구,6440405,4404,아산시,합계,,45642,19269,4672,5357,4524,3204,17757,1512,26373
4400,충청남도,아산시마선거구,6440405,4404,아산시,거소투표,,34,31,8,3,8,4,23,8,3
4400,충청남도,아산시마선거구,6440405,4404,아산시,관외사전투표,,2072,2065,548,499,529,298,1874,191,7
4400,충청남도,아산시마선거구,6440405,4404,아산시,배방읍,계,40086,15315,3823,4327,3413,2601,14164,1151,24771
4400,충청남도,아산시마선거구,6440405,4404,아산시,배방읍,관내사전투표,3831,3831,943,1207,762,555,3467,364,0
4400,충청남도,아산시마선거구,6440405,4404,아산시,배방읍,선거일투표,36255,11484,2880,3120,2651,2046,10697,787,24771
4400,충청남도,아산시마선거구,6440405,4404,아산시,송악면,계,3450,1854,292,526,574,300,1692,162,1596
4400,충청남도,아산시마선거구,6440405,4404,아산시,송악면,관내사전투표,697,696,104,208,204,104,620,76,1
4400,충청남도,아산시마선거구,6440405,4404,아산시,송악면,선거일투표,2753,1158,188,318,370,196,1072,86,1595
4400,충청남도,아산시마선거구,6440405,4404,아산시,잘못 투입·구분된 투표지,,0,4,1,2,0,1,4,0,-4
4400,충청남도,아산시바선거구,6440406,4404,아산시,합계,,46281,19357,6022,2684,10136,18842,515,26924
4400,충청남도,아산시바선거구,6440406,4404,아산시,거소투표,,45,42,7,5,27,39,3,3
4400,충청남도,아산시바선거구,6440406,4404,아산시,관외사전투표,,2013,2008,705,199,1046,1950,58,5
4400,충청남도,아산시바선거구,6440406,4404,아산시,음봉면,계,15547,5887,2377,544,2851,5772,115,9660
4400,충청남도,아산시바선거구,6440406,4404,아산시,음봉면,관내사전투표,1307,1297,526,119,615,1260,37,10
4400,충청남도,아산시바선거구,6440406,4404,아산시,음봉면,선거일투표,14240,4590,1851,425,2236,4512,78,9650
4400,충청남도,아산시바선거구,6440406,4404,아산시,둔포면,계,18443,6619,1436,1351,3693,6480,139,11824
4400,충청남도,아산시바선거구,6440406,4404,아산시,둔포면,관내사전투표,2077,2075,450,439,1142,2031,44,2
4400,충청남도,아산시바선거구,6440406,4404,아산시,둔포면,선거일투표,16366,4544,986,912,2551,4449,95,11822
4400,충청남도,아산시바선거구,6440406,4404,아산시,영인면,계,4941,2530,727,313,1379,2419,111,2411
4400,충청남도,아산시바선거구,6440406,4404,아산시,영인면,관내사전투표,853,852,260,82,459,801,51,1
4400,충청남도,아산시바선거구,6440406,4404,아산시,영인면,선거일투표,4088,1678,467,231,920,1618,60,2410
4400,충청남도,아산시바선거구,6440406,4404,아산시,인주면,계,5292,2251,763,268,1132,2163,88,3041
4400,충청남도,아산시바선거구,6440406,4404,아산시,인주면,관내사전투표,900,900,307,97,463,867,33,0
4400,충청남도,아산시바선거구,6440406,4404,아산시,인주면,선거일투표,4392,1351,456,171,669,1296,55,3041
4400,충청남도,아산시바선거구,6440406,4404,아산시,잘못 투입·구분된 투표지,,0,20,7,4,8,19,1,-20
4400,충청남도,서산시가선거구,6440501,4405,서산시,합계,,19046,8937,3270,2922,2234,8426,511,10109
4400,충청남도,서산시가선거구,6440501,4405,서산시,거소투표,,67,65,14,37,10,61,4,2
4400,충청남도,서산시가선거구,6440501,4405,서산시,관외사전투표,,890,886,391,295,170,856,30,4
4400,충청남도,서산시가선거구,6440501,4405,서산시,대산읍,계,11443,4973,1981,1080,1610,4671,302,6470
4400,충청남도,서산시가선거구,6440501,4405,서산시,대산읍,관내사전투표,1842,1842,790,416,582,1788,54,0
4400,충청남도,서산시가선거구,6440501,4405,서산시,대산읍,선거일투표,9601,3131,1191,664,1028,2883,248,6470
4400,충청남도,서산시가선거구,6440501,4405,서산시,지곡면,계,6646,3007,883,1507,442,2832,175,3639
4400,충청남도,서산시가선거구,6440501,4405,서산시,지곡면,관내사전투표,1077,1076,266,606,144,1016,60,1
4400,충청남도,서산시가선거구,6440501,4405,서산시,지곡면,선거일투표,5569,1931,617,901,298,1816,115,3638
4400,충청남도,서산시가선거구,6440501,4405,서산시,잘못 투입·구분된 투표지,,0,6,1,3,2,6,0,-6
4400,충청남도,서산시나선거구,6440502,4405,서산시,합계,,14482,7927,2641,3165,1784,7590,337,6555
4400,충청남도,서산시나선거구,6440502,4405,서산시,거소투표,,43,41,10,11,18,39,2,2
4400,충청남도,서산시나선거구,6440502,4405,서산시,관외사전투표,,737,736,273,309,132,714,22,1
4400,충청남도,서산시나선거구,6440502,4405,서산시,인지면,계,6027,3103,1557,1007,421,2985,118,2924
4400,충청남도,서산시나선거구,6440502,4405,서산시,인지면,관내사전투표,1266,1266,661,393,165,1219,47,0
4400,충청남도,서산시나선거구,6440502,4405,서산시,인지면,선거일투표,4761,1837,896,614,256,1766,71,2924
4400,충청남도,서산시나선거구,6440502,4405,서산시,부석면,계,4713,2342,500,609,1094,2203,139,2371
4400,충청남도,서산시나선거구,6440502,4405,서산시,부석면,관내사전투표,787,787,179,175,397,751,36,0
4400,충청남도,서산시나선거구,6440502,4405,서산시,부석면,선거일투표,3926,1555,321,434,697,1452,103,2371
4400,충청남도,서산시나선거구,6440502,4405,서산시,팔봉면,계,2962,1696,299,1222,119,1640,56,1266
4400,충청남도,서산시나선거구,6440502,4405,서산시,팔봉면,관내사전투표,645,641,135,459,38,632,9,4
4400,충청남도,서산시나선거구,6440502,4405,서산시,팔봉면,선거일투표,2317,1055,164,763,81,1008,47,1262
4400,충청남도,서산시나선거구,6440502,4405,서산시,잘못 투입·구분된 투표지,,0,9,2,7,0,9,0,-9
4400,충청남도,서산시다선거구,6440503,4405,서산시,합계,,27727,12573,3539,1978,4956,976,776,12225,348,15154
4400,충청남도,서산시다선거구,6440503,4405,서산시,거소투표,,54,51,13,4,20,6,5,48,3,3
4400,충청남도,서산시다선거구,6440503,4405,서산시,관외사전투표,,1484,1484,466,246,551,110,77,1450,34,0
4400,충청남도,서산시다선거구,6440503,4405,서산시,성연면,계,10969,4379,1205,967,1514,357,213,4256,123,6590
4400,충청남도,서산시다선거구,6440503,4405,서산시,성연면,관내사전투표,1475,1473,397,335,506,124,73,1435,38,2
4400,충청남도,서산시다선거구,6440503,4405,서산시,성연면,선거일투표,9494,2906,808,632,1008,233,140,2821,85,6588
4400,충청남도,서산시다선거구,6440503,4405,서산시,부춘동,계,15220,6656,1855,760,2869,503,481,6468,188,8564
4400,충청남도,서산시다선거구,6440503,4405,서산시,부춘동,관내사전투표,2285,2284,675,281,960,175,148,2239,45,1
4400,충청남도,서산시다선거구,6440503,4405,서산시,부춘동,선거일투표,12935,4372,1180,479,1909,328,333,4229,143,8563
4400,충청남도,서산시다선거구,6440503,4405,서산시,잘못 투입·구분된 투표지,,0,3,0,1,2,0,0,3,0,-3
4400,충청남도,서산시라선거구,6440504,4405,서산시,검색된 결과가 없습니다.
4400,충청남도,서산시마선거구,6440505,4405,서산시,합계,,25147,12944,3399,6165,2206,305,12075,869,12203
4400,충청남도,서산시마선거구,6440505,4405,서산시,거소투표,,96,83,25,25,8,7,65,18,13
4400,충청남도,서산시마선거구,6440505,4405,서산시,관외사전투표,,1208,1208,433,546,167,19,1165,43,0
4400,충청남도,서산시마선거구,6440505,4405,서산시,음암면,계,7774,3580,931,1347,976,41,3295,285,4194
4400,충청남도,서산시마선거구,6440505,4405,서산시,음암면,관내사전투표,1042,1042,261,401,320,6,988,54,0
4400,충청남도,서산시마선거구,6440505,4405,서산시,음암면,선거일투표,6732,2538,670,946,656,35,2307,231,4194
4400,충청남도,서산시마선거구,6440505,4405,서산시,운산면,계,4446,2575,365,1763,276,23,2427,148,1871
4400,충청남도,서산시마선거구,6440505,4405,서산시,운산면,관내사전투표,1014,1014,159,703,111,5,978,36,0
4400,충청남도,서산시마선거구,6440505,4405,서산시,운산면,선거일투표,3432,1561,206,1060,165,18,1449,112,1871
4400,충청남도,서산시마선거구,6440505,4405,서산시,해미면,계,6603,3346,1066,1494,489,113,3162,184,3257
4400,충청남도,서산시마선거구,6440505,4405,서산시,해미면,관내사전투표,1337,1334,474,564,212,31,1281,53,3
4400,충청남도,서산시마선거구,6440505,4405,서산시,해미면,선거일투표,5266,2012,592,930,277,82,1881,131,3254
4400,충청남도,서산시마선거구,6440505,4405,서산시,고북면,계,5020,2148,578,987,290,102,1957,191,2872
4400,충청남도,서산시마선거구,6440505,4405,서산시,고북면,관내사전투표,659,659,168,342,95,21,626,33,0
4400,충청남도,서산시마선거구,6440505,4405,서산시,고북면,선거일투표,4361,1489,410,645,195,81,1331,158,2872
4400,충청남도,서산시마선거구,6440505,4405,서산시,잘못 투입·구분된 투표지,,0,4,1,3,0,0,4,0,-4
4400,충청남도,서산시바선거구,6440506,4405,서산시,합계,,35934,17459,4830,1684,3806,4989,1230,16539,920,18475
4400,충청남도,서산시바선거구,6440506,4405,서산시,거소투표,,73,68,24,7,14,18,4,67,1,5
4400,충청남도,서산시바선거구,6440506,4405,서산시,관외사전투표,,2226,2226,667,214,517,529,173,2100,126,0
4400,충청남도,서산시바선거구,6440506,4405,서산시,동문1동,계,13958,6279,1800,552,1179,2065,398,5994,285,7679
4400,충청남도,서산시바선거구,6440506,4405,서산시,동문1동,관내사전투표,2486,2484,714,227,445,827,147,2360,124,2
4400,충청남도,서산시바선거구,6440506,4405,서산시,동문1동,선거일투표,11472,3795,1086,325,734,1238,251,3634,161,7677
4400,충청남도,서산시바선거구,6440506,4405,서산시,동문2동,계,7350,3505,880,313,784,1084,266,3327,178,3845
4400,충청남도,서산시바선거구,6440506,4405,서산시,동문2동,관내사전투표,1261,1261,365,125,255,377,87,1209,52,0
4400,충청남도,서산시바선거구,6440506,4405,서산시,동문2동,선거일투표,6089,2244,515,188,529,707,179,2118,126,3845
4400,충청남도,서산시바선거구,6440506,4405,서산시,수석동,계,12327,5377,1459,597,1312,1291,388,5047,330,6950
4400,충청남도,서산시바선거구,6440506,4405,서산시,수석동,관내사전투표,1737,1737,511,203,433,376,107,1630,107,0
4400,충청남도,서산시바선거구,6440506,4405,서산시,수석동,선거일투표,10590,3640,948,394,879,915,281,3417,223,6950
4400,충청남도,서산시바선거구,6440506,4405,서산시,잘못 투입·구분된 투표지,,0,4,0,1,0,2,1,4,0,-4
4400,충청남도,태안군가선거구,6440601,4406,태안군,합계,,31331,19233,3929,3723,3330,2862,963,3430,18237,996,12098
4400,충청남도,태안군가선거구,6440601,4406,태안군,거소투표,,62,58,10,16,4,12,2,7,51,7,4
4400,충청남도,태안군가선거구,6440601,4406,태안군,관외사전투표,,1553,1551,407,333,366,170,57,150,1483,68,2
4400,충청남도,태안군가선거구,6440601,4406,태안군,태안읍,계,23865,13862,2989,3098,2574,2453,464,1557,13135,727,10003
4400,충청남도,태안군가선거구,6440601,4406,태안군,태안읍,관내사전투표,5790,5784,1271,1328,1035,974,168,691,5467,317,6
4400,충청남도,태안군가선거구,6440601,4406,태안군,태안읍,선거일투표,18075,8078,1718,1770,1539,1479,296,866,7668,410,9997
4400,충청남도,태안군가선거구,6440601,4406,태안군,원북면,계,3922,2507,346,169,254,142,332,1123,2366,141,1415
4400,충청남도,태안군가선거구,6440601,4406,태안군,원북면,관내사전투표,1001,1000,164,75,102,67,130,401,939,61,1
4400,충청남도,태안군가선거구,6440601,4406,태안군,원북면,선거일투표,2921,1507,182,94,152,75,202,722,1427,80,1414
4400,충청남도,태안군가선거구,6440601,4406,태안군,이원면,계,1929,1241,171,106,129,85,106,591,1188,53,688
4400,충청남도,태안군가선거구,6440601,4406,태안군,이원면,관내사전투표,541,540,86,52,45,47,42,244,516,24,1
4400,충청남도,태안군가선거구,6440601,4406,태안군,이원면,선거일투표,1388,701,85,54,84,38,64,347,672,29,687
4400,충청남도,태안군가선거구,6440601,4406,태안군,잘못 투입·구분된 투표지,,0,14,6,1,3,0,2,2,14,0,-14
4400,충청남도,태안군나선거구,6440602,4406,태안군,합계,,24104,15478,2026,2335,2482,3751,1695,1440,629,14358,1120,8626
4400,충청남도,태안군나선거구,6440602,4406,태안군,거소투표,,45,43,5,4,4,7,5,10,6,41,2,2
4400,충청남도,태안군나선거구,6440602,4406,태안군,관외사전투표,,1382,1382,235,201,108,461,135,76,60,1276,106,0
4400,충청남도,태안군나선거구,6440602,4406,태안군,안면읍,계,7336,4457,590,249,1453,518,1094,80,135,4119,338,2879
4400,충청남도,태안군나선거구,6440602,4406,태안군,안면읍,관내사전투표,1941,1938,256,110,633,191,480,42,66,1778,160,3
4400,충청남도,태안군나선거구,6440602,4406,태안군,안면읍,선거일투표,5395,2519,334,139,820,327,614,38,69,2341,178,2876
4400,충청남도,태안군나선거구,6440602,4406,태안군,고남면,계,2025,1294,131,59,695,132,153,10,20,1200,94,731
4400,충청남도,태안군나선거구,6440602,4406,태안군,고남면,관내사전투표,612,612,67,33,314,54,81,6,7,562,50,0
4400,충청남도,태안군나선거구,6440602,4406,태안군,고남면,선거일투표,1413,682,64,26,381,78,72,4,13,638,44,731
4400,충청남도,태안군나선거구,6440602,4406,태안군,남면,계,3760,2166,320,343,124,620,144,89,347,1987,179,1594
4400,충청남도,태안군나선거구,6440602,4406,태안군,남면,관내사전투표,819,817,136,118,51,226,57,43,110,741,76,2
4400,충청남도,태안군나선거구,6440602,4406,태안군,남면,선거일투표,2941,1349,184,225,73,394,87,46,237,1246,103,1592
4400,충청남도,태안군나선거구,6440602,4406,태안군,근흥면,계,4750,3056,525,405,54,1669,78,87,38,2856,200,1694
4400,충청남도,태안군나선거구,6440602,4406,태안군,근흥면,관내사전투표,1244,1243,222,167,23,680,24,34,9,1159,84,1
4400,충청남도,태안군나선거구,6440602,4406,태안군,근흥면,선거일투표,3506,1813,303,238,31,989,54,53,29,1697,116,1693
4400,충청남도,태안군나선거구,6440602,4406,태안군,소원면,계,4806,3068,219,1073,41,339,86,1088,23,2869,199,1738
4400,충청남도,태안군나선거구,6440602,4406,태안군,소원면,관내사전투표,1401,1400,106,523,15,162,35,449,10,1300,100,1
4400,충청남도,태안군나선거구,6440602,4406,태안군,소원면,선거일투표,3405,1668,113,550,26,177,51,639,13,1569,99,1737
4400,충청남도,태안군나선거구,6440602,4406,태안군,잘못 투입·구분된 투표지,,0,12,1,1,3,5,0,0,0,10,2,-12
4400,충청남도,금산군가선거구,6440701,4407,금산군,합계,,25580,16618,3857,2113,1611,2400,2144,2577,941,15643,975,8962
4400,충청남도,금산군가선거구,6440701,4407,금산군,거소투표,,39,35,4,7,9,4,2,7,1,34,1,4
4400,충청남도,금산군가선거구,6440701,4407,금산군,관외사전투표,,1230,1228,359,150,122,229,121,132,47,1160,68,2
4400,충청남도,금산군가선거구,6440701,4407,금산군,금산읍,계,18096,11367,2639,1513,1157,1619,1498,1664,687,10777,590,6729
4400,충청남도,금산군가선거구,6440701,4407,금산군,금산읍,관내사전투표,4006,3998,1021,502,475,546,478,509,244,3775,223,8
4400,충청남도,금산군가선거구,6440701,4407,금산군,금산읍,선거일투표,14090,7369,1618,1011,682,1073,1020,1155,443,7002,367,6721
4400,충청남도,금산군가선거구,6440701,4407,금산군,부리면,계,2183,1355,229,203,104,209,202,226,74,1247,108,828
4400,충청남도,금산군가선거구,6440701,4407,금산군,부리면,관내사전투표,458,458,77,64,33,90,64,63,24,415,43,0
4400,충청남도,금산군가선거구,6440701,4407,금산군,부리면,선거일투표,1725,897,152,139,71,119,138,163,50,832,65,828
4400,충청남도,금산군가선거구,6440701,4407,금산군,남일면,계,2338,1574,383,133,106,201,155,388,87,1453,121,764
4400,충청남도,금산군가선거구,6440701,4407,금산군,남일면,관내사전투표,633,633,180,53,43,82,61,130,35,584,49,0
4400,충청남도,금산군가선거구,6440701,4407,금산군,남일면,선거일투표,1705,941,203,80,63,119,94,258,52,869,72,764
4400,충청남도,금산군가선거구,6440701,4407,금산군,남이면,계,1694,1050,243,106,109,138,165,158,44,963,87,644
4400,충청남도,금산군가선거구,6440701,4407,금산군,남이면,관내사전투표,361,361,101,37,51,34,53,42,11,329,32,0
4400,충청남도,금산군가선거구,6440701,4407,금산군,남이면,선거일투표,1333,689,142,69,58,104,112,116,33,634,55,644
4400,충청남도,금산군가선거구,6440701,4407,금산군,잘못 투입·구분된 투표지,,0,9,0,1,4,0,1,2,1,9,0,-9
4400,충청남도,금산군나선거구,6440702,4407,금산군,합계,,19167,12057,2914,1666,3712,1996,1095,11383,674,7110
4400,충청남도,금산군나선거구,6440702,4407,금산군,거소투표,,32,28,7,10,6,3,0,26,2,4
4400,충청남도,금산군나선거구,6440702,4407,금산군,관외사전투표,,1375,1373,362,168,441,247,68,1286,87,2
4400,충청남도,금산군나선거구,6440702,4407,금산군,금성면,계,2701,1539,237,115,459,594,47,1452,87,1162
4400,충청남도,금산군나선거구,6440702,4407,금산군,금성면,관내사전투표,459,459,85,33,161,131,13,423,36,0
4400,충청남도,금산군나선거구,6440702,4407,금산군,금성면,선거일투표,2242,1080,152,82,298,463,34,1029,51,1162
4400,충청남도,금산군나선거구,6440702,4407,금산군,제원면,계,2462,1519,315,207,521,310,76,1429,90,943
4400,충청남도,금산군나선거구,6440702,4407,금산군,제원면,관내사전투표,618,618,151,79,214,106,23,573,45,0
4400,충청남도,금산군나선거구,6440702,4407,금산군,제원면,선거일투표,1844,901,164,128,307,204,53,856,45,943
4400,충청남도,금산군나선거구,6440702,4407,금산군,군북면,계,1978,1219,253,189,345,285,71,1143,76,759
4400,충청남도,금산군나선거구,6440702,4407,금산군,군북면,관내사전투표,228,228,52,37,79,23,25,216,12,0
4400,충청남도,금산군나선거구,6440702,4407,금산군,군북면,선거일투표,1750,991,201,152,266,262,46,927,64,759
4400,충청남도,금산군나선거구,6440702,4407,금산군,진산면,계,2724,1667,245,111,837,160,219,1572,95,1057
4400,충청남도,금산군나선거구,6440702,4407,금산군,진산면,관내사전투표,648,648,99,48,335,63,62,607,41,0
4400,충청남도,금산군나선거구,6440702,4407,금산군,진산면,선거일투표,2076,1019,146,63,502,97,157,965,54,1057
4400,충청남도,금산군나선거구,6440702,4407,금산군,복수면,계,2628,1547,250,95,486,139,495,1465,82,1081
4400,충청남도,금산군나선거구,6440702,4407,금산군,복수면,관내사전투표,532,531,101,32,174,53,141,501,30,1
4400,충청남도,금산군나선거구,6440702,4407,금산군,복수면,선거일투표,2096,1016,149,63,312,86,354,964,52,1080
4400,충청남도,금산군나선거구,6440702,4407,금산군,추부면,계,5267,3160,1243,771,616,258,117,3005,155,2107
4400,충청남도,금산군나선거구,6440702,4407,금산군,추부면,관내사전투표,1212,1209,471,315,245,96,30,1157,52,3
4400,충청남도,금산군나선거구,6440702,4407,금산군,추부면,선거일투표,4055,1951,772,456,371,162,87,1848,103,2104
4400,충청남도,금산군나선거구,6440702,4407,금산군,잘못 투입·구분된 투표지,,0,5,2,0,1,0,2,5,0,-5
4400,충청남도,논산시가선거구,6440901,4409,논산시,합계,,40909,22225,4246,1982,2225,1518,1068,3324,1627,2407,1704,433,20534,1691,18684
4400,충청남도,논산시가선거구,6440901,4409,논산시,거소투표,,64,61,15,4,6,6,5,5,6,8,1,1,57,4,3
4400,충청남도,논산시가선거구,6440901,4409,논산시,관외사전투표,,1877,1877,421,167,126,123,62,345,135,177,97,58,1711,166,0
4400,충청남도,논산시가선거구,6440901,4409,논산시,강경읍,계,6870,3491,406,130,1589,24,38,186,724,81,70,37,3285,206,3379
4400,충청남도,논산시가선거구,6440901,4409,논산시,강경읍,관내사전투표,1298,1298,156,35,637,11,13,66,255,21,20,14,1228,70,0
4400,충청남도,논산시가선거구,6440901,4409,논산시,강경읍,선거일투표,5572,2193,250,95,952,13,25,120,469,60,50,23,2057,136,3379
4400,충청남도,논산시가선거구,6440901,4409,논산시,연무읍,계,11069,5448,2172,278,125,67,81,358,334,247,1239,130,5031,417,5621
4400,충청남도,논산시가선거구,6440901,4409,논산시,연무읍,관내사전투표,2186,2186,855,86,52,25,35,140,161,106,519,50,2029,157,0
4400,충청남도,논산시가선거구,6440901,4409,논산시,연무읍,선거일투표,8883,3262,1317,192,73,42,46,218,173,141,720,80,3002,260,5621
4400,충청남도,논산시가선거구,6440901,4409,논산시,연산면,계,5373,2850,244,124,29,665,52,332,71,1014,38,62,2631,219,2523
4400,충청남도,논산시가선거구,6440901,4409,논산시,연산면,관내사전투표,1014,1014,105,43,11,220,20,148,24,326,12,28,937,77,0
4400,충청남도,논산시가선거구,6440901,4409,논산시,연산면,선거일투표,4359,1836,139,81,18,445,32,184,47,688,26,34,1694,142,2523
4400,충청남도,논산시가선거구,6440901,4409,논산시,벌곡면,계,2145,1199,125,98,22,190,35,265,41,277,25,20,1098,101,946
4400,충청남도,논산시가선거구,6440901,4409,논산시,벌곡면,관내사전투표,440,440,52,32,8,74,18,89,13,102,9,5,402,38,0
4400,충청남도,논산시가선거구,6440901,4409,논산시,벌곡면,선거일투표,1705,759,73,66,14,116,17,176,28,175,16,15,696,63,946
4400,충청남도,논산시가선거구,6440901,4409,논산시,양촌면,계,5019,2545,258,176,27,295,81,1214,64,173,36,38,2362,183,2474
4400,충청남도,논산시가선거구,6440901,4409,논산시,양촌면,관내사전투표,1162,1162,114,87,11,108,42,597,24,65,14,15,1077,85,0
4400,충청남도,논산시가선거구,6440901,4409,논산시,양촌면,선거일투표,3857,1383,144,89,16,187,39,617,40,108,22,23,1285,98,2474
4400,충청남도,논산시가선거구,6440901,4409,논산시,가야곡면,계,3053,1784,161,807,18,54,32,216,50,209,59,47,1653,131,1269
4400,충청남도,논산시가선거구,6440901,4409,논산시,가야곡면,관내사전투표,768,768,81,347,7,15,9,90,24,83,30,17,703,65,0
4400,충청남도,논산시가선거구,6440901,4409,논산시,가야곡면,선거일투표,2285,1016,80,460,11,39,23,126,26,126,29,30,950,66,1269
4400,충청남도,논산시가선거구,6440901,4409,논산시,은진면,계,3522,1853,239,124,43,63,644,266,95,113,66,24,1677,176,1669
4400,충청남도,논산시가선거구,6440901,4409,논산시,은진면,관내사전투표,714,714,78,38,19,20,282,93,40,32,27,4,633,81,0
4400,충청남도,논산시가선거구,6440901,4409,논산시,은진면,선거일투표,2808,1139,161,86,24,43,362,173,55,81,39,20,1044,95,1669
4400,충청남도,논산시가선거구,6440901,4409,논산시,채운면,계,1917,1116,205,74,240,31,38,136,107,108,73,16,1028,88,801
4400,충청남도,논산시가선거구,6440901,4409,논산시,채운면,관내사전투표,410,410,68,35,109,12,23,35,38,39,20,1,380,30,0
4400,충청남도,논산시가선거구,6440901,4409,논산시,채운면,선거일투표,1507,706,137,39,131,19,15,101,69,69,53,15,648,58,801
4400,충청남도,논산시가선거구,6440901,4409,논산시,잘못 투입·구분된 투표지,,0,1,0,0,0,0,0,1,0,0,0,0,1,0,-1
4400,충청남도,논산시나선거구,6440902,4409,논산시,합계,,30113,16921,3966,2456,3959,2795,633,2154,15963,958,13192
4400,충청남도,논산시나선거구,6440902,4409,논산시,거소투표,,75,71,17,9,11,11,0,18,66,5,4
4400,충청남도,논산시나선거구,6440902,4409,논산시,관외사전투표,,1859,1856,480,328,427,283,81,162,1761,95,3
4400,충청남도,논산시나선거구,6440902,4409,논산시,성동면,계,3565,1928,329,149,333,809,30,156,1806,122,1637
4400,충청남도,논산시나선거구,6440902,4409,논산시,성동면,관내사전투표,607,607,116,51,97,248,11,44,567,40,0
4400,충청남도,논산시나선거구,6440902,4409,논산시,성동면,선거일투표,2958,1321,213,98,236,561,19,112,1239,82,1637
4400,충청남도,논산시나선거구,6440902,4409,논산시,광석면,계,3637,2217,763,136,811,150,37,220,2117,100,1420
4400,충청남도,논산시나선거구,6440902,4409,논산시,광석면,관내사전투표,737,735,269,52,260,56,14,55,706,29,2
4400,충청남도,논산시나선거구,6440902,4409,논산시,광석면,선거일투표,2900,1482,494,84,551,94,23,165,1411,71,1418
4400,충청남도,논산시나선거구,6440902,4409,논산시,노성면,계,2520,1366,366,88,377,108,12,323,1274,92,1154
4400,충청남도,논산시나선거구,6440902,4409,논산시,노성면,관내사전투표,399,399,110,34,106,34,6,85,375,24,0
4400,충청남도,논산시나선거구,6440902,4409,논산시,노성면,선거일투표,2121,967,256,54,271,74,6,238,899,68,1154
4400,충청남도,논산시나선거구,6440902,4409,논산시,상월면,계,3111,1705,391,150,264,81,12,714,1612,93,1406
4400,충청남도,논산시나선거구,6440902,4409,논산시,상월면,관내사전투표,698,695,182,72,108,27,3,260,652,43,3
4400,충청남도,논산시나선거구,6440902,4409,논산시,상월면,선거일투표,2413,1010,209,78,156,54,9,454,960,50,1403
4400,충청남도,논산시나선거구,6440902,4409,논산시,부적면,계,3162,1862,340,510,456,237,58,140,1741,121,1300
4400,충청남도,논산시나선거구,6440902,4409,논산시,부적면,관내사전투표,607,606,111,172,130,74,27,49,563,43,1
4400,충청남도,논산시나선거구,6440902,4409,논산시,부적면,선거일투표,2555,1256,229,338,326,163,31,91,1178,78,1299
4400,충청남도,논산시나선거구,6440902,4409,논산시,부창동,계,12184,5899,1276,1084,1278,1114,403,418,5573,326,6285
4400,충청남도,논산시나선거구,6440902,4409,논산시,부창동,관내사전투표,1683,1676,349,360,308,319,119,132,1587,89,7
4400,충청남도,논산시나선거구,6440902,4409,논산시,부창동,선거일투표,10501,4223,927,724,970,795,284,286,3986,237,6278
4400,충청남도,논산시나선거구,6440902,4409,논산시,잘못 투입·구분된 투표지,,0,17,4,2,2,2,0,3,13,4,-17
4400,충청남도,논산시다선거구,6440903,4409,논산시,합계,,28920,14666,3335,2348,903,2776,2224,1333,392,526,13837,829,14254
4400,충청남도,논산시다선거구,6440903,4409,논산시,거소투표,,50,45,10,8,3,10,4,4,2,1,42,3,5
4400,충청남도,논산시다선거구,6440903,4409,논산시,관외사전투표,,2135,2133,552,393,108,381,262,183,53,77,2009,124,2
4400,충청남도,논산시다선거구,6440903,4409,논산시,취암동,계,26735,12486,2772,1946,792,2385,1958,1146,337,448,11784,702,14249
4400,충청남도,논산시다선거구,6440903,4409,논산시,취암동,관내사전투표,3815,3814,984,602,258,644,625,279,114,109,3615,199,1
4400,충청남도,논산시다선거구,6440903,4409,논산시,취암동,선거일투표,22920,8672,1788,1344,534,1741,1333,867,223,339,8169,503,14248
4400,충청남도,논산시다선거구,6440903,4409,논산시,잘못 투입·구분된 투표지,,0,2,1,1,0,0,0,0,0,0,2,0,-2
4400,충청남도,계룡시가선거구,6441001,4410,계룡시,합계,,19518,10823,2894,1344,2827,1172,2258,10495,328,8695
4400,충청남도,계룡시가선거구,6441001,4410,계룡시,거소투표,,51,49,13,4,20,3,3,43,6,2
4400,충청남도,계룡시가선거구,6441001,4410,계룡시,관외사전투표,,1150,1149,298,161,377,110,147,1093,56,1
4400,충청남도,계룡시가선거구,6441001,4410,계룡시,두마면,계,6278,3387,819,461,647,249,1127,3303,84,2891
4400,충청남도,계룡시가선거구,6441001,4410,계룡시,두마면,관내사전투표,1414,1412,342,194,265,116,458,1375,37,2
4400,충청남도,계룡시가선거구,6441001,4410,계룡시,두마면,선거일투표,4864,1975,477,267,382,133,669,1928,47,2889
4400,충청남도,계룡시가선거구,6441001,4410,계룡시,신도안면,계,5437,2464,719,313,591,514,271,2408,56,2973
4400,충청남도,계룡시가선거구,6441001,4410,계룡시,신도안면,관내사전투표,1156,1154,329,142,283,250,124,1128,26,2
4400,충청남도,계룡시가선거구,6441001,4410,계룡시,신도안면,선거일투표,4281,1310,390,171,308,264,147,1280,30,2971
4400,충청남도,계룡시가선거구,6441001,4410,계룡시,금암동,계,6602,3769,1042,404,1191,296,710,3643,126,2833
4400,충청남도,계룡시가선거구,6441001,4410,계룡시,금암동,관내사전투표,1668,1667,460,188,546,124,280,1598,69,1
4400,충청남도,계룡시가선거구,6441001,4410,계룡시,금암동,선거일투표,4934,2102,582,216,645,172,430,2045,57,2832
4400,충청남도,계룡시가선거구,6441001,4410,계룡시,잘못 투입·구분된 투표지,,0,5,3,1,1,0,0,5,0,-5
4400,충청남도,계룡시나선거구,6441002,4410,계룡시,합계,,15357,8483,1898,1547,1453,872,977,72,1008,288,8115,368,6874
4400,충청남도,계룡시나선거구,6441002,4410,계룡시,거소투표,,39,36,9,4,8,7,2,0,3,0,33,3,3
4400,충청남도,계룡시나선거구,6441002,4410,계룡시,관외사전투표,,976,975,275,157,208,83,80,3,91,30,927,48,1
4400,충청남도,계룡시나선거구,6441002,4410,계룡시,엄사면,계,14342,7471,1614,1386,1237,781,895,69,914,258,7154,317,6871
4400,충청남도,계룡시나선거구,6441002,4410,계룡시,엄사면,관내사전투표,2656,2656,604,510,435,226,337,24,300,95,2531,125,0
4400,충청남도,계룡시나선거구,6441002,4410,계룡시,엄사면,선거일투표,11686,4815,1010,876,802,555,558,45,614,163,4623,192,6871
4400,충청남도,계룡시나선거구,6441002,4410,계룡시,잘못 투입·구분된 투표지,,0,1,0,0,0,1,0,0,0,0,1,0,-1
4400,충청남도,당진시가선거구,6441601,4416,당진시,합계,,20859,11246,2953,2111,3196,2052,10312,934,9613
4400,충청남도,당진시가선거구,6441601,4416,당진시,거소투표,,58,53,19,10,16,6,51,2,5
4400,충청남도,당진시가선거구,6441601,4416,당진시,관외사전투표,,945,945,320,126,314,128,888,57,0
4400,충청남도,당진시가선거구,6441601,4416,당진시,합덕읍,계,7823,4095,1153,1069,1246,267,3735,360,3728
4400,충청남도,당진시가선거구,6441601,4416,당진시,합덕읍,관내사전투표,1778,1778,525,494,535,116,1670,108,0
4400,충청남도,당진시가선거구,6441601,4416,당진시,합덕읍,선거일투표,6045,2317,628,575,711,151,2065,252,3728
4400,충청남도,당진시가선거구,6441601,4416,당진시,면천면,계,3088,1740,270,150,278,949,1647,93,1348
4400,충청남도,당진시가선거구,6441601,4416,당진시,면천면,관내사전투표,713,711,102,67,111,396,676,35,2
4400,충청남도,당진시가선거구,6441601,4416,당진시,면천면,선거일투표,2375,1029,168,83,167,553,971,58,1346
4400,충청남도,당진시가선거구,6441601,4416,당진시,순성면,계,4348,2118,547,277,596,530,1950,168,2230
4400,충청남도,당진시가선거구,6441601,4416,당진시,순성면,관내사전투표,777,777,212,89,239,181,721,56,0
4400,충청남도,당진시가선거구,6441601,4416,당진시,순성면,선거일투표,3571,1341,335,188,357,349,1229,112,2230
4400,충청남도,당진시가선거구,6441601,4416,당진시,우강면,계,4597,2287,642,478,744,170,2034,253,2310
4400,충청남도,당진시가선거구,6441601,4416,당진시,우강면,관내사전투표,737,734,229,141,254,57,681,53,3
4400,충청남도,당진시가선거구,6441601,4416,당진시,우강면,선거일투표,3860,1553,413,337,490,113,1353,200,2307
4400,충청남도,당진시가선거구,6441601,4416,당진시,잘못 투입·구분된 투표지,,0,8,2,1,2,2,7,1,-8
4400,충청남도,당진시나선거구,6441602,4416,당진시,합계,,23881,11471,4262,2966,3786,11014,457,12410
4400,충청남도,당진시나선거구,6441602,4416,당진시,거소투표,,54,52,19,18,13,50,2,2
4400,충청남도,당진시나선거구,6441602,4416,당진시,관외사전투표,,1942,1942,817,526,551,1894,48,0
4400,충청남도,당진시나선거구,6441602,4416,당진시,당진2동,계,16684,6842,2809,1544,2247,6600,242,9842
4400,충청남도,당진시나선거구,6441602,4416,당진시,당진2동,관내사전투표,1813,1812,797,352,617,1766,46,1
4400,충청남도,당진시나선거구,6441602,4416,당진시,당진2동,선거일투표,14871,5030,2012,1192,1630,4834,196,9841
4400,충청남도,당진시나선거구,6441602,4416,당진시,대호지면,계,2099,1113,249,411,382,1042,71,986
4400,충청남도,당진시나선거구,6441602,4416,당진시,대호지면,관내사전투표,327,326,85,128,99,312,14,1
4400,충청남도,당진시나선거구,6441602,4416,당진시,대호지면,선거일투표,1772,787,164,283,283,730,57,985
4400,충청남도,당진시나선거구,6441602,4416,당진시,정미면,계,3102,1511,365,464,590,1419,92,1591
4400,충청남도,당진시나선거구,6441602,4416,당진시,정미면,관내사전투표,517,515,124,168,202,494,21,2
4400,충청남도,당진시나선거구,6441602,4416,당진시,정미면,선거일투표,2585,996,241,296,388,925,71,1589
4400,충청남도,당진시나선거구,6441602,4416,당진시,잘못 투입·구분된 투표지,,0,11,3,3,3,9,2,-11
4400,충청남도,당진시다선거구,6441603,4416,당진시,합계,,47206,20119,4932,3280,1141,4855,3539,815,480,19042,1077,27087
4400,충청남도,당진시다선거구,6441603,4416,당진시,거소투표,,51,48,17,6,1,10,9,0,1,44,4,3
4400,충청남도,당진시다선거구,6441603,4416,당진시,관외사전투표,,1844,1843,473,290,90,490,278,49,44,1714,129,1
4400,충청남도,당진시다선거구,6441603,4416,당진시,송악읍,계,23470,8835,2030,1209,734,1572,2231,409,215,8400,435,14635
4400,충청남도,당진시다선거구,6441603,4416,당진시,송악읍,관내사전투표,2705,2702,589,361,241,465,717,112,61,2546,156,3
4400,충청남도,당진시다선거구,6441603,4416,당진시,송악읍,선거일투표,20765,6133,1441,848,493,1107,1514,297,154,5854,279,14632
4400,충청남도,당진시다선거구,6441603,4416,당진시,신평면,계,12286,5562,1798,484,162,2001,516,166,168,5295,267,6724
4400,충청남도,당진시다선거구,6441603,4416,당진시,신평면,관내사전투표,1938,1935,636,176,59,676,185,66,59,1857,78,3
4400,충청남도,당진시다선거구,6441603,4416,당진시,신평면,선거일투표,10348,3627,1162,308,103,1325,331,100,109,3438,189,6721
4400,충청남도,당진시다선거구,6441603,4416,당진시,송산면,계,9555,3813,613,1288,154,775,503,188,51,3572,241,5742
4400,충청남도,당진시다선거구,6441603,4416,당진시,송산면,관내사전투표,1309,1308,235,435,51,257,149,74,16,1217,91,1
4400,충청남도,당진시다선거구,6441603,4416,당진시,송산면,선거일투표,8246,2505,378,853,103,518,354,114,35,2355,150,5741
4400,충청남도,당진시다선거구,6441603,4416,당진시,잘못 투입·구분된 투표지,,0,18,1,3,0,7,2,3,1,17,1,-18
4400,충청남도,당진시라선거구,6441604,4416,당진시,합계,,48062,22036,4084,2888,1339,4684,2659,2267,1366,893,449,20629,1407,26026
4400,충청남도,당진시라선거구,6441604,4416,당진시,거소투표,,64,59,19,7,4,7,6,3,1,7,3,57,2,5
4400,충청남도,당진시라선거구,6441604,4416,당진시,관외사전투표,,2642,2640,597,341,131,661,293,194,150,67,41,2475,165,2
4400,충청남도,당진시라선거구,6441604,4416,당진시,당진1동,계,18905,7081,1378,804,296,1810,692,667,506,345,151,6649,432,11824
4400,충청남도,당진시라선거구,6441604,4416,당진시,당진1동,관내사전투표,2509,2509,509,297,129,634,236,234,139,124,55,2357,152,0
4400,충청남도,당진시라선거구,6441604,4416,당진시,당진1동,선거일투표,16396,4572,869,507,167,1176,456,433,367,221,96,4292,280,11824
4400,충청남도,당진시라선거구,6441604,4416,당진시,당진3동,계,13475,6216,1262,809,241,1385,593,556,488,299,184,5817,399,7259
4400,충청남도,당진시라선거구,6441604,4416,당진시,당진3동,관내사전투표,2366,2366,486,328,111,513,243,183,202,114,42,2222,144,0
4400,충청남도,당진시라선거구,6441604,4416,당진시,당진3동,선거일투표,11109,3850,776,481,130,872,350,373,286,185,142,3595,255,7259
4400,충청남도,당진시라선거구,6441604,4416,당진시,고대면,계,4863,2565,306,688,76,452,380,242,103,118,45,2410,155,2298
4400,충청남도,당진시라선거구,6441604,4416,당진시,고대면,관내사전투표,1183,1183,162,301,38,202,158,114,49,49,17,1090,93,0
4400,충청남도,당진시라선거구,6441604,4416,당진시,고대면,선거일투표,3680,1382,144,387,38,250,222,128,54,69,28,1320,62,2298
4400,충청남도,당진시라선거구,6441604,4416,당진시,석문면,계,8113,3473,522,239,591,368,695,604,118,57,25,3219,254,4640
4400,충청남도,당진시라선거구,6441604,4416,당진시,석문면,관내사전투표,1226,1226,186,98,236,108,233,209,46,15,4,1135,91,0
4400,충청남도,당진시라선거구,6441604,4416,당진시,석문면,선거일투표,6887,2247,336,141,355,260,462,395,72,42,21,2084,163,4640
4400,충청남도,당진시라선거구,6441604,4416,당진시,잘못 투입·구분된 투표지,,0,2,0,0,0,1,0,1,0,0,0,2,0,-2
4400,충청남도,부여군가선거구,6441101,4411,부여군,합계,,27226,17131,3717,2086,2063,796,2504,2132,1354,752,707,16111,1020,10095
4400,충청남도,부여군가선거구,6441101,4411,부여군,거소투표,,107,101,16,11,13,8,10,4,7,13,10,92,9,6
4400,충청남도,부여군가선거구,6441101,4411,부여군,관외사전투표,,1623,1623,449,189,222,68,269,135,70,48,72,1522,101,0
4400,충청남도,부여군가선거구,6441101,4411,부여군,부여읍,계,16327,10218,2240,1222,1413,293,1161,1308,990,539,472,9638,580,6109
4400,충청남도,부여군가선거구,6441101,4411,부여군,부여읍,관내사전투표,3902,3902,923,498,603,140,452,473,297,192,157,3735,167,0
4400,충청남도,부여군가선거구,6441101,4411,부여군,부여읍,선거일투표,12425,6316,1317,724,810,153,709,835,693,347,315,5903,413,6109
4400,충청남도,부여군가선거구,6441101,4411,부여군,규암면,계,9169,5188,1012,664,415,427,1064,685,287,152,153,4859,329,3981
4400,충청남도,부여군가선거구,6441101,4411,부여군,규암면,관내사전투표,1896,1896,399,250,162,145,380,229,94,62,58,1779,117,0
4400,충청남도,부여군가선거구,6441101,4411,부여군,규암면,선거일투표,7273,3292,613,414,253,282,684,456,193,90,95,3080,212,3981
4400,충청남도,부여군가선거구,6441101,4411,부여군,잘못 투입·구분된 투표지,,0,1,0,0,0,0,0,0,0,0,0,0,1,-1
4400,충청남도,부여군나선거구,6441102,4411,부여군,합계,,15931,10461,2440,1302,1251,2061,1044,1694,9792,669,5470
4400,충청남도,부여군나선거구,6441102,4411,부여군,거소투표,,56,52,9,10,11,5,3,8,46,6,4
4400,충청남도,부여군나선거구,6441102,4411,부여군,관외사전투표,,782,781,224,102,75,200,51,73,725,56,1
4400,충청남도,부여군나선거구,6441102,4411,부여군,은산면,계,3234,2015,1100,106,42,201,407,43,1899,116,1219
4400,충청남도,부여군나선거구,6441102,4411,부여군,은산면,관내사전투표,1049,1049,535,58,20,108,225,29,975,74,0
4400,충청남도,부여군나선거구,6441102,4411,부여군,은산면,선거일투표,2185,966,565,48,22,93,182,14,924,42,1219
4400,충청남도,부여군나선거구,6441102,4411,부여군,외산면,계,2078,1441,204,96,100,614,271,50,1335,106,637
4400,충청남도,부여군나선거구,6441102,4411,부여군,외산면,관내사전투표,746,744,91,59,49,354,119,18,690,54,2
4400,충청남도,부여군나선거구,6441102,4411,부여군,외산면,선거일투표,1332,697,113,37,51,260,152,32,645,52,635
4400,충청남도,부여군나선거구,6441102,4411,부여군,내산면,계,1327,873,150,98,139,235,76,114,812,61,454
4400,충청남도,부여군나선거구,6441102,4411,부여군,내산면,관내사전투표,389,381,67,45,53,112,27,42,346,35,8
4400,충청남도,부여군나선거구,6441102,4411,부여군,내산면,선거일투표,938,492,83,53,86,123,49,72,466,26,446
4400,충청남도,부여군나선거구,6441102,4411,부여군,구룡면,계,2053,1202,248,170,218,281,82,124,1123,79,851
4400,충청남도,부여군나선거구,6441102,4411,부여군,구룡면,관내사전투표,460,460,91,59,77,135,32,37,431,29,0
4400,충청남도,부여군나선거구,6441102,4411,부여군,구룡면,선거일투표,1593,742,157,111,141,146,50,87,692,50,851
4400,충청남도,부여군나선거구,6441102,4411,부여군,홍산면,계,2560,1709,185,397,167,150,53,666,1618,91,851
4400,충청남도,부여군나선거구,6441102,4411,부여군,홍산면,관내사전투표,814,814,91,190,76,69,26,321,773,41,0
4400,충청남도,부여군나선거구,6441102,4411,부여군,홍산면,선거일투표,1746,895,94,207,91,81,27,345,845,50,851
4400,충청남도,부여군나선거구,6441102,4411,부여군,옥산면,계,1242,775,121,123,106,110,36,235,731,44,467
4400,충청남도,부여군나선거구,6441102,4411,부여군,옥산면,관내사전투표,336,335,65,41,46,43,16,100,311,24,1
4400,충청남도,부여군나선거구,6441102,4411,부여군,옥산면,선거일투표,906,440,56,82,60,67,20,135,420,20,466
4400,충청남도,부여군나선거구,6441102,4411,부여군,남면,계,1603,979,122,111,275,147,38,227,920,59,624
4400,충청남도,부여군나선거구,6441102,4411,부여군,남면,관내사전투표,378,377,51,50,104,57,12,78,352,25,1
4400,충청남도,부여군나선거구,6441102,4411,부여군,남면,선거일투표,1225,602,71,61,171,90,26,149,568,34,623
4400,충청남도,부여군나선거구,6441102,4411,부여군,충화면,계,996,622,75,87,117,114,26,154,573,49,374
4400,충청남도,부여군나선거구,6441102,4411,부여군,충화면,관내사전투표,266,266,40,28,56,56,6,55,241,25,0
4400,충청남도,부여군나선거구,6441102,4411,부여군,충화면,선거일투표,730,356,35,59,61,58,20,99,332,24,374
4400,충청남도,부여군나선거구,6441102,4411,부여군,잘못 투입·구분된 투표지,,0,12,2,2,1,4,1,0,10,2,-12
4400,충청남도,부여군다선거구,6441103,4411,부여군,합계,,14165,8844,2378,2151,846,855,801,1455,8486,358,5321
4400,충청남도,부여군다선거구,6441103,4411,부여군,거소투표,,85,81,18,16,10,5,5,21,75,6,4
4400,충청남도,부여군다선거구,6441103,4411,부여군,관외사전투표,,673,673,250,204,58,41,28,70,651,22,0
4400,충청남도,부여군다선거구,6441103,4411,부여군,양화면,계,1513,977,291,189,81,28,116,227,932,45,536
4400,충청남도,부여군다선거구,6441103,4411,부여군,양화면,관내사전투표,491,490,146,108,35,13,45,114,461,29,1
4400,충청남도,부여군다선거구,6441103,4411,부여군,양화면,선거일투표,1022,487,145,81,46,15,71,113,471,16,535
4400,충청남도,부여군다선거구,6441103,4411,부여군,임천면,계,2435,1533,509,206,90,36,94,543,1478,55,902
4400,충청남도,부여군다선거구,6441103,4411,부여군,임천면,관내사전투표,759,758,272,100,43,15,47,246,723,35,1
4400,충청남도,부여군다선거구,6441103,4411,부여군,임천면,선거일투표,1676,775,237,106,47,21,47,297,755,20,901
4400,충청남도,부여군다선거구,6441103,4411,부여군,장암면,계,2372,1324,356,309,105,78,162,247,1257,67,1048
4400,충청남도,부여군다선거구,6441103,4411,부여군,장암면,관내사전투표,498,498,132,136,30,35,52,80,465,33,0
4400,충청남도,부여군다선거구,6441103,4411,부여군,장암면,선거일투표,1874,826,224,173,75,43,110,167,792,34,1048
4400,충청남도,부여군다선거구,6441103,4411,부여군,세도면,계,2827,1712,504,180,374,35,348,203,1644,68,1115
4400,충청남도,부여군다선거구,6441103,4411,부여군,세도면,관내사전투표,857,855,256,96,178,13,142,127,812,43,2
4400,충청남도,부여군다선거구,6441103,4411,부여군,세도면,선거일투표,1970,857,248,84,196,22,206,76,832,25,1113
4400,충청남도,부여군다선거구,6441103,4411,부여군,석성면,계,2438,1444,265,709,73,220,32,104,1403,41,994
4400,충청남도,부여군다선거구,6441103,4411,부여군,석성면,관내사전투표,629,629,115,301,28,104,16,49,613,16,0
4400,충청남도,부여군다선거구,6441103,4411,부여군,석성면,선거일투표,1809,815,150,408,45,116,16,55,790,25,994
4400,충청남도,부여군다선거구,6441103,4411,부여군,초촌면,계,1822,1093,183,338,54,411,15,40,1041,52,729
4400,충청남도,부여군다선거구,6441103,4411,부여군,초촌면,관내사전투표,411,411,71,133,24,141,10,12,391,20,0
4400,충청남도,부여군다선거구,6441103,4411,부여군,초촌면,선거일투표,1411,682,112,205,30,270,5,28,650,32,729
4400,충청남도,부여군다선거구,6441103,4411,부여군,잘못 투입·구분된 투표지,,0,7,2,0,1,1,1,0,5,2,-7
4400,충청남도,서천군가선거구,6441201,4412,서천군,합계,,21741,13599,4038,3173,2374,1547,1896,13028,571,8142
4400,충청남도,서천군가선거구,6441201,4412,서천군,거소투표,,138,113,26,19,33,19,13,110,3,25
4400,충청남도,서천군가선거구,6441201,4412,서천군,관외사전투표,,1149,1149,450,299,137,80,158,1124,25,0
4400,충청남도,서천군가선거구,6441201,4412,서천군,장항읍,계,9461,5416,1625,937,1237,234,1198,5231,185,4045
4400,충청남도,서천군가선거구,6441201,4412,서천군,장항읍,관내사전투표,2311,2310,725,393,473,103,530,2224,86,1
4400,충청남도,서천군가선거구,6441201,4412,서천군,장항읍,선거일투표,7150,3106,900,544,764,131,668,3007,99,4044
4400,충청남도,서천군가선거구,6441201,4412,서천군,마서면,계,4084,2420,764,546,468,243,255,2276,144,1664
4400,충청남도,서천군가선거구,6441201,4412,서천군,마서면,관내사전투표,861,861,277,186,160,93,87,803,58,0
4400,충청남도,서천군가선거구,6441201,4412,서천군,마서면,선거일투표,3223,1559,487,360,308,150,168,1473,86,1664
4400,충청남도,서천군가선거구,6441201,4412,서천군,화양면,계,1952,1240,354,360,197,181,87,1179,61,712
4400,충청남도,서천군가선거구,6441201,4412,서천군,화양면,관내사전투표,568,568,167,167,90,77,33,534,34,0
4400,충청남도,서천군가선거구,6441201,4412,서천군,화양면,선거일투표,1384,672,187,193,107,104,54,645,27,712
4400,충청남도,서천군가선거구,6441201,4412,서천군,기산면,계,1407,885,196,217,95,224,109,841,44,522
4400,충청남도,서천군가선거구,6441201,4412,서천군,기산면,관내사전투표,420,420,97,104,46,101,53,401,19,0
4400,충청남도,서천군가선거구,6441201,4412,서천군,기산면,선거일투표,987,465,99,113,49,123,56,440,25,522
4400,충청남도,서천군가선거구,6441201,4412,서천군,한산면,계,2264,1524,466,612,144,182,51,1455,69,740
4400,충청남도,서천군가선거구,6441201,4412,서천군,한산면,관내사전투표,795,791,269,296,69,81,34,749,42,4
4400,충청남도,서천군가선거구,6441201,4412,서천군,한산면,선거일투표,1469,733,197,316,75,101,17,706,27,736
4400,충청남도,서천군가선거구,6441201,4412,서천군,마산면,계,1286,850,157,181,63,384,25,810,40,436
4400,충청남도,서천군가선거구,6441201,4412,서천군,마산면,관내사전투표,386,386,63,75,29,175,14,356,30,0
4400,충청남도,서천군가선거구,6441201,4412,서천군,마산면,선거일투표,900,464,94,106,34,209,11,454,10,436
4400,충청남도,서천군가선거구,6441201,4412,서천군,잘못 투입·구분된 투표지,,0,2,0,2,0,0,0,2,0,-2
4400,충청남도,서천군나선거구,6441202,4412,서천군,합계,,24123,15682,3800,2296,2870,2747,3090,14803,879,8441
4400,충청남도,서천군나선거구,6441202,4412,서천군,거소투표,,55,54,13,8,7,9,11,48,6,1
4400,충청남도,서천군나선거구,6441202,4412,서천군,관외사전투표,,1127,1127,332,191,249,154,156,1082,45,0
4400,충청남도,서천군나선거구,6441202,4412,서천군,서천읍,계,10642,6761,1980,916,1266,753,1540,6455,306,3881
4400,충청남도,서천군나선거구,6441202,4412,서천군,서천읍,관내사전투표,3021,3019,875,455,557,379,635,2901,118,2
4400,충청남도,서천군나선거구,6441202,4412,서천군,서천읍,선거일투표,7621,3742,1105,461,709,374,905,3554,188,3879
4400,충청남도,서천군나선거구,6441202,4412,서천군,시초면,계,1102,678,151,86,150,87,150,624,54,424
4400,충청남도,서천군나선거구,6441202,4412,서천군,시초면,관내사전투표,300,299,61,46,62,40,63,272,27,1
4400,충청남도,서천군나선거구,6441202,4412,서천군,시초면,선거일투표,802,379,90,40,88,47,87,352,27,423
4400,충청남도,서천군나선거구,6441202,4412,서천군,문산면,계,1164,760,167,73,183,109,188,720,40,404
4400,충청남도,서천군나선거구,6441202,4412,서천군,문산면,관내사전투표,370,368,89,46,88,49,81,353,15,2
4400,충청남도,서천군나선거구,6441202,4412,서천군,문산면,선거일투표,794,392,78,27,95,60,107,367,25,402
4400,충청남도,서천군나선거구,6441202,4412,서천군,판교면,계,1862,1271,245,142,316,164,306,1173,98,591
4400,충청남도,서천군나선거구,6441202,4412,서천군,판교면,관내사전투표,674,673,136,82,161,82,153,614,59,1
4400,충청남도,서천군나선거구,6441202,4412,서천군,판교면,선거일투표,1188,598,109,60,155,82,153,559,39,590
4400,충청남도,서천군나선거구,6441202,4412,서천군,종천면,계,1836,1170,301,134,220,219,229,1103,67,666
4400,충청남도,서천군나선거구,6441202,4412,서천군,종천면,관내사전투표,509,509,144,66,86,87,98,481,28,0
4400,충청남도,서천군나선거구,6441202,4412,서천군,종천면,선거일투표,1327,661,157,68,134,132,131,622,39,666
4400,충청남도,서천군나선거구,6441202,4412,서천군,비인면,계,2660,1735,339,200,217,596,248,1600,135,925
4400,충청남도,서천군나선거구,6441202,4412,서천군,비인면,관내사전투표,922,921,163,107,112,335,115,832,89,1
4400,충청남도,서천군나선거구,6441202,4412,서천군,비인면,선거일투표,1738,814,176,93,105,261,133,768,46,924
4400,충청남도,서천군나선거구,6441202,4412,서천군,서면,계,3675,2119,270,544,262,654,262,1992,127,1556
4400,충청남도,서천군나선거구,6441202,4412,서천군,서면,관내사전투표,852,851,110,228,92,268,100,798,53,1
4400,충청남도,서천군나선거구,6441202,4412,서천군,서면,선거일투표,2823,1268,160,316,170,386,162,1194,74,1555
4400,충청남도,서천군나선거구,6441202,4412,서천군,잘못 투입·구분된 투표지,,0,7,2,2,0,2,0,6,1,-7
4400,충청남도,홍성군가선거구,6441301,4413,홍성군,합계,,32167,16570,4291,2813,5048,3524,15676,894,15597
4400,충청남도,홍성군가선거구,6441301,4413,홍성군,거소투표,,99,95,26,20,20,20,86,9,4
4400,충청남도,홍성군가선거구,6441301,4413,홍성군,관외사전투표,,2241,2241,698,456,623,340,2117,124,0
4400,충청남도,홍성군가선거구,6441301,4413,홍성군,홍성읍,계,29827,14223,3564,2333,4404,3162,13463,760,15604
4400,충청남도,홍성군가선거구,6441301,4413,홍성군,홍성읍,관내사전투표,4689,4683,1163,804,1436,1004,4407,276,6
4400,충청남도,홍성군가선거구,6441301,4413,홍성군,홍성읍,선거일투표,25138,9540,2401,1529,2968,2158,9056,484,15598
4400,충청남도,홍성군가선거구,6441301,4413,홍성군,잘못 투입·구분된 투표지,,0,11,3,4,1,2,10,1,-11
4400,충청남도,홍성군나선거구,6441302,4413,홍성군,합계,,21690,11877,3438,3382,3939,870,11629,248,9813
4400,충청남도,홍성군나선거구,6441302,4413,홍성군,거소투표,,21,20,8,6,4,0,18,2,1
4400,충청남도,홍성군나선거구,6441302,4413,홍성군,관외사전투표,,1994,1988,634,532,653,120,1939,49,6
4400,충청남도,홍성군나선거구,6441302,4413,홍성군,홍북읍,계,19675,9857,2794,2841,3276,749,9660,197,9818
4400,충청남도,홍성군나선거구,6441302,4413,홍성군,홍북읍,관내사전투표,3609,3604,1079,1128,1043,284,3534,70,5
4400,충청남도,홍성군나선거구,6441302,4413,홍성군,홍북읍,선거일투표,16066,6253,1715,1713,2233,465,6126,127,9813
4400,충청남도,홍성군나선거구,6441302,4413,홍성군,잘못 투입·구분된 투표지,,0,12,2,3,6,1,12,0,-12
4400,충청남도,홍성군다선거구,6441303,4413,홍성군,검색된 결과가 없습니다.
4400,충청남도,홍성군라선거구,6441304,4413,홍성군,합계,,13750,8159,1640,4092,2031,7763,396,5591
4400,충청남도,홍성군라선거구,6441304,4413,홍성군,거소투표,,35,30,7,19,4,30,0,5
4400,충청남도,홍성군라선거구,6441304,4413,홍성군,관외사전투표,,630,629,204,309,104,617,12,1
4400,충청남도,홍성군라선거구,6441304,4413,홍성군,은하면,계,1996,1092,212,436,386,1034,58,904
4400,충청남도,홍성군라선거구,6441304,4413,홍성군,은하면,관내사전투표,346,344,67,131,134,332,12,2
4400,충청남도,홍성군라선거구,6441304,4413,홍성군,은하면,선거일투표,1650,748,145,305,252,702,46,902
4400,충청남도,홍성군라선거구,6441304,4413,홍성군,결성면,계,1885,1169,197,449,450,1096,73,716
4400,충청남도,홍성군라선거구,6441304,4413,홍성군,결성면,관내사전투표,423,421,76,150,155,381,40,2
4400,충청남도,홍성군라선거구,6441304,4413,홍성군,결성면,선거일투표,1462,748,121,299,295,715,33,714
4400,충청남도,홍성군라선거구,6441304,4413,홍성군,서부면,계,2856,1624,282,474,785,1541,83,1232
4400,충청남도,홍성군라선거구,6441304,4413,홍성군,서부면,관내사전투표,757,757,122,212,372,706,51,0
4400,충청남도,홍성군라선거구,6441304,4413,홍성군,서부면,선거일투표,2099,867,160,262,413,835,32,1232
4400,충청남도,홍성군라선거구,6441304,4413,홍성군,갈산면,계,3208,1916,286,1373,148,1807,109,1292
4400,충청남도,홍성군라선거구,6441304,4413,홍성군,갈산면,관내사전투표,802,801,124,559,69,752,49,1
4400,충청남도,홍성군라선거구,6441304,4413,홍성군,갈산면,선거일투표,2406,1115,162,814,79,1055,60,1291
4400,충청남도,홍성군라선거구,6441304,4413,홍성군,구항면,계,3140,1692,450,1031,151,1632,60,1448
4400,충청남도,홍성군라선거구,6441304,4413,홍성군,구항면,관내사전투표,609,609,178,356,47,581,28,0
4400,충청남도,홍성군라선거구,6441304,4413,홍성군,구항면,선거일투표,2531,1083,272,675,104,1051,32,1448
4400,충청남도,홍성군라선거구,6441304,4413,홍성군,잘못 투입·구분된 투표지,,0,7,2,1,3,6,1,-7
4400,충청남도,청양군가선거구,6441401,4414,청양군,합계,,19457,13821,3151,1687,1805,1968,1609,751,673,1581,13225,596,5636
4400,충청남도,청양군가선거구,6441401,4414,청양군,거소투표,,28,26,7,2,3,6,2,2,0,2,24,2,2
4400,충청남도,청양군가선거구,6441401,4414,청양군,관외사전투표,,994,991,236,115,138,205,85,55,32,85,951,40,3
4400,충청남도,청양군가선거구,6441401,4414,청양군,청양읍,계,8465,5899,1026,455,1042,931,915,378,164,762,5673,226,2566
4400,충청남도,청양군가선거구,6441401,4414,청양군,청양읍,관내사전투표,2959,2958,532,245,526,507,414,172,84,363,2843,115,1
4400,충청남도,청양군가선거구,6441401,4414,청양군,청양읍,선거일투표,5506,2941,494,210,516,424,501,206,80,399,2830,111,2565
4400,충청남도,청양군가선거구,6441401,4414,청양군,운곡면,계,1855,1258,243,88,168,187,164,81,31,240,1202,56,597
4400,충청남도,청양군가선거구,6441401,4414,청양군,운곡면,관내사전투표,553,550,112,31,91,80,68,20,13,107,522,28,3
4400,충청남도,청양군가선거구,6441401,4414,청양군,운곡면,선거일투표,1302,708,131,57,77,107,96,61,18,133,680,28,594
4400,충청남도,청양군가선거구,6441401,4414,청양군,대치면,계,1971,1382,248,126,196,285,180,92,23,176,1326,56,589
4400,충청남도,청양군가선거구,6441401,4414,청양군,대치면,관내사전투표,612,611,106,54,116,110,62,38,13,85,584,27,1
4400,충청남도,청양군가선거구,6441401,4414,청양군,대치면,선거일투표,1359,771,142,72,80,175,118,54,10,91,742,29,588
4400,충청남도,청양군가선거구,6441401,4414,청양군,남양면,계,2416,1689,118,764,54,108,68,44,375,47,1578,111,727
4400,충청남도,청양군가선거구,6441401,4414,청양군,남양면,관내사전투표,820,820,50,394,28,52,31,22,165,26,768,52,0
4400,충청남도,청양군가선거구,6441401,4414,청양군,남양면,선거일투표,1596,869,68,370,26,56,37,22,210,21,810,59,727
4400,충청남도,청양군가선거구,6441401,4414,청양군,화성면,계,1915,1320,808,41,54,118,83,45,24,93,1266,54,595
4400,충청남도,청양군가선거구,6441401,4414,청양군,화성면,관내사전투표,531,531,331,16,23,40,35,11,9,35,500,31,0
4400,충청남도,청양군가선거구,6441401,4414,청양군,화성면,선거일투표,1384,789,477,25,31,78,48,34,15,58,766,23,595
4400,충청남도,청양군가선거구,6441401,4414,청양군,비봉면,계,1813,1250,464,95,149,128,111,54,24,174,1199,51,563
4400,충청남도,청양군가선거구,6441401,4414,청양군,비봉면,관내사전투표,494,494,172,31,75,48,46,22,7,73,474,20,0
4400,충청남도,청양군가선거구,6441401,4414,청양군,비봉면,선거일투표,1319,756,292,64,74,80,65,32,17,101,725,31,563
4400,충청남도,청양군가선거구,6441401,4414,청양군,잘못 투입·구분된 투표지,,0,6,1,1,1,0,1,0,0,2,6,0,-6
4400,충청남도,청양군나선거구,6441402,4414,청양군,합계,,8475,5860,1352,1357,1477,1343,5529,331,2615
4400,충청남도,청양군나선거구,6441402,4414,청양군,거소투표,,16,15,2,2,2,8,14,1,1
4400,충청남도,청양군나선거구,6441402,4414,청양군,관외사전투표,,492,490,130,117,143,81,471,19,2
4400,충청남도,청양군나선거구,6441402,4414,청양군,정산면,계,3062,2029,245,832,559,284,1920,109,1033
4400,충청남도,청양군나선거구,6441402,4414,청양군,정산면,관내사전투표,976,976,126,400,250,150,926,50,0
4400,충청남도,청양군나선거구,6441402,4414,청양군,정산면,선거일투표,2086,1053,119,432,309,134,994,59,1033
4400,충청남도,청양군나선거구,6441402,4414,청양군,목면,계,1282,838,98,183,446,55,782,56,444
4400,충청남도,청양군나선거구,6441402,4414,청양군,목면,관내사전투표,314,314,32,75,161,29,297,17,0
4400,충청남도,청양군나선거구,6441402,4414,청양군,목면,선거일투표,968,524,66,108,285,26,485,39,444
4400,충청남도,청양군나선거구,6441402,4414,청양군,청남면,계,1638,1099,583,67,181,217,1048,51,539
4400,충청남도,청양군나선거구,6441402,4414,청양군,청남면,관내사전투표,523,523,283,32,78,103,496,27,0
4400,충청남도,청양군나선거구,6441402,4414,청양군,청남면,선거일투표,1115,576,300,35,103,114,552,24,539
4400,충청남도,청양군나선거구,6441402,4414,청양군,장평면,계,1985,1387,293,155,146,698,1292,95,598
4400,충청남도,청양군나선거구,6441402,4414,청양군,장평면,관내사전투표,466,466,97,60,63,223,443,23,0
4400,충청남도,청양군나선거구,6441402,4414,청양군,장평면,선거일투표,1519,921,196,95,83,475,849,72,598
4400,충청남도,청양군나선거구,6441402,4414,청양군,잘못 투입·구분된 투표지,,0,2,1,1,0,0,2,0,-2
4400,충청남도,예산군가선거구,6441501,4415,예산군,합계,,27237,14898,3046,1615,3391,2531,2125,1436,14144,754,12339
4400,충청남도,예산군가선거구,6441501,4415,예산군,거소투표,,48,40,7,3,13,7,4,3,37,3,8
4400,충청남도,예산군가선거구,6441501,4415,예산군,관외사전투표,,1897,1894,511,244,378,218,283,166,1800,94,3
4400,충청남도,예산군가선거구,6441501,4415,예산군,예산읍,계,25292,12949,2525,1367,2996,2303,1836,1266,12293,656,12343
4400,충청남도,예산군가선거구,6441501,4415,예산군,예산읍,관내사전투표,3696,3690,776,395,756,692,573,311,3503,187,6
4400,충청남도,예산군가선거구,6441501,4415,예산군,예산읍,선거일투표,21596,9259,1749,972,2240,1611,1263,955,8790,469,12337
4400,충청남도,예산군가선거구,6441501,4415,예산군,잘못 투입·구분된 투표지,,0,15,3,1,4,3,2,1,14,1,-15
4400,충청남도,예산군나선거구,6441502,4415,예산군,합계,,8850,5785,857,2141,1458,1079,5535,250,3065
4400,충청남도,예산군나선거구,6441502,4415,예산군,거소투표,,39,39,15,10,5,5,35,4,0
4400,충청남도,예산군나선거구,6441502,4415,예산군,관외사전투표,,519,519,124,206,95,86,511,8,0
4400,충청남도,예산군나선거구,6441502,4415,예산군,예산읍,계,765,422,69,153,113,66,401,21,343
4400,충청남도,예산군나선거구,6441502,4415,예산군,예산읍,관내사전투표,146,144,26,47,39,26,138,6,2
4400,충청남도,예산군나선거구,6441502,4415,예산군,예산읍,선거일투표,619,278,43,106,74,40,263,15,341
4400,충청남도,예산군나선거구,6441502,4415,예산군,대술면,계,2150,1358,134,274,172,705,1285,73,792
4400,충청남도,예산군나선거구,6441502,4415,예산군,대술면,관내사전투표,587,586,50,120,83,290,543,43,1
4400,충청남도,예산군나선거구,6441502,4415,예산군,대술면,선거일투표,1563,772,84,154,89,415,742,30,791
4400,충청남도,예산군나선거구,6441502,4415,예산군,신양면,계,2640,1711,180,317,945,190,1632,79,929
4400,충청남도,예산군나선거구,6441502,4415,예산군,신양면,관내사전투표,776,773,80,154,425,70,729,44,3
4400,충청남도,예산군나선거구,6441502,4415,예산군,신양면,선거일투표,1864,938,100,163,520,120,903,35,926
4400,충청남도,예산군나선거구,6441502,4415,예산군,광시면,계,2737,1731,334,1180,126,27,1667,64,1006
4400,충청남도,예산군나선거구,6441502,4415,예산군,광시면,관내사전투표,886,886,152,629,58,13,852,34,0
4400,충청남도,예산군나선거구,6441502,4415,예산군,광시면,선거일투표,1851,845,182,551,68,14,815,30,1006
4400,충청남도,예산군나선거구,6441502,4415,예산군,잘못 투입·구분된 투표지,,0,5,1,1,2,0,4,1,-5
4400,충청남도,예산군다선거구,6441503,4415,예산군,합계,,17273,9363,1836,1214,3362,1618,814,8844,519,7910
4400,충청남도,예산군다선거구,6441503,4415,예산군,거소투표,,20,19,5,0,4,3,2,14,5,1
4400,충청남도,예산군다선거구,6441503,4415,예산군,관외사전투표,,1502,1500,418,175,517,201,112,1423,77,2
4400,충청남도,예산군다선거구,6441503,4415,예산군,삽교읍,계,8273,3839,883,446,832,910,561,3632,207,4434
4400,충청남도,예산군다선거구,6441503,4415,예산군,삽교읍,관내사전투표,1381,1379,308,165,272,313,243,1301,78,2
4400,충청남도,예산군다선거구,6441503,4415,예산군,삽교읍,선거일투표,6892,2460,575,281,560,597,318,2331,129,4432
4400,충청남도,예산군다선거구,6441503,4415,예산군,대흥면,계,1466,805,116,111,316,168,50,761,44,661
4400,충청남도,예산군다선거구,6441503,4415,예산군,대흥면,관내사전투표,190,190,30,34,67,32,11,174,16,0
4400,충청남도,예산군다선거구,6441503,4415,예산군,대흥면,선거일투표,1276,615,86,77,249,136,39,587,28,661
4400,충청남도,예산군다선거구,6441503,4415,예산군,응봉면,계,2232,1199,179,299,423,187,39,1127,72,1033
4400,충청남도,예산군다선거구,6441503,4415,예산군,응봉면,관내사전투표,483,483,79,130,152,68,14,443,40,0
4400,충청남도,예산군다선거구,6441503,4415,예산군,응봉면,선거일투표,1749,716,100,169,271,119,25,684,32,1033
4400,충청남도,예산군다선거구,6441503,4415,예산군,오가면,계,3780,1999,235,183,1270,148,50,1886,113,1781
4400,충청남도,예산군다선거구,6441503,4415,예산군,오가면,관내사전투표,910,909,117,90,577,54,18,856,53,1
4400,충청남도,예산군다선거구,6441503,4415,예산군,오가면,선거일투표,2870,1090,118,93,693,94,32,1030,60,1780
4400,충청남도,예산군다선거구,6441503,4415,예산군,잘못 투입·구분된 투표지,,0,2,0,0,0,1,0,1,1,-2
4400,충청남도,예산군라선거구,6441504,4415,예산군,합계,,15709,8712,1803,1654,2153,2444,8054,658,6997
4400,충청남도,예산군라선거구,6441504,4415,예산군,거소투표,,31,27,1,5,7,10,23,4,4
4400,충청남도,예산군라선거구,6441504,4415,예산군,관외사전투표,,693,692,182,94,203,151,630,62,1
4400,충청남도,예산군라선거구,6441504,4415,예산군,덕산면,계,5834,2991,875,279,937,656,2747,244,2843
4400,충청남도,예산군라선거구,6441504,4415,예산군,덕산면,관내사전투표,1155,1155,314,111,408,213,1046,109,0
4400,충청남도,예산군라선거구,6441504,4415,예산군,덕산면,선거일투표,4679,1836,561,168,529,443,1701,135,2843
4400,충청남도,예산군라선거구,6441504,4415,예산군,봉산면,계,2071,1148,231,169,299,365,1064,84,923
4400,충청남도,예산군라선거구,6441504,4415,예산군,봉산면,관내사전투표,463,462,86,64,107,174,431,31,1
4400,충청남도,예산군라선거구,6441504,4415,예산군,봉산면,선거일투표,1608,686,145,105,192,191,633,53,922
4400,충청남도,예산군라선거구,6441504,4415,예산군,고덕면,계,3963,2157,335,475,505,684,1999,158,1806
4400,충청남도,예산군라선거구,6441504,4415,예산군,고덕면,관내사전투표,804,802,128,162,200,254,744,58,2
4400,충청남도,예산군라선거구,6441504,4415,예산군,고덕면,선거일투표,3159,1355,207,313,305,430,1255,100,1804
4400,충청남도,예산군라선거구,6441504,4415,예산군,신암면,계,3117,1691,178,631,202,574,1585,106,1426
4400,충청남도,예산군라선거구,6441504,4415,예산군,신암면,관내사전투표,728,724,78,233,94,260,665,59,4
4400,충청남도,예산군라선거구,6441504,4415,예산군,신암면,선거일투표,2389,967,100,398,108,314,920,47,1422
4400,충청남도,예산군라선거구,6441504,4415,예산군,잘못 투입·구분된 투표지,,0,6,1,1,0,4,6,0,-64500,전라북도,전주시가선거구,6450101,4501,전주시완산구,합계,,47243,18374,6361,3494,5259,2656,17770,604,28869
4500,전라북도,전주시가선거구,6450101,4501,전주시완산구,거소투표,,90,85,36,12,19,9,76,9,5
4500,전라북도,전주시가선거구,6450101,4501,전주시완산구,관외사전투표,,3007,3004,1152,568,696,467,2883,121,3
4500,전라북도,전주시가선거구,6450101,4501,전주시완산구,중앙동,계,6454,2588,975,325,676,498,2474,114,3866
4500,전라북도,전주시가선거구,6450101,4501,전주시완산구,중앙동,관내사전투표,1085,1084,389,135,282,214,1020,64,1
4500,전라북도,전주시가선거구,6450101,4501,전주시완산구,중앙동,선거일투표,5369,1504,586,190,394,284,1454,50,3865
4500,전라북도,전주시가선거구,6450101,4501,전주시완산구,풍남동,계,3654,1450,510,190,514,197,1411,39,2204
4500,전라북도,전주시가선거구,6450101,4501,전주시완산구,풍남동,관내사전투표,535,535,182,86,198,58,524,11,0
4500,전라북도,전주시가선거구,6450101,4501,전주시완산구,풍남동,선거일투표,3119,915,328,104,316,139,887,28,2204
4500,전라북도,전주시가선거구,6450101,4501,전주시완산구,노송동,계,9729,3758,1246,552,1399,449,3646,112,5971
4500,전라북도,전주시가선거구,6450101,4501,전주시완산구,노송동,관내사전투표,1248,1248,382,180,518,126,1206,42,0
4500,전라북도,전주시가선거구,6450101,4501,전주시완산구,노송동,선거일투표,8481,2510,864,372,881,323,2440,70,5971
4500,전라북도,전주시가선거구,6450101,4501,전주시완산구,인후3동,계,24309,7480,2437,1844,1955,1036,7272,208,16829
4500,전라북도,전주시가선거구,6450101,4501,전주시완산구,인후3동,관내사전투표,2219,2214,666,573,633,262,2134,80,5
4500,전라북도,전주시가선거구,6450101,4501,전주시완산구,인후3동,선거일투표,22090,5266,1771,1271,1322,774,5138,128,16824
4500,전라북도,전주시가선거구,6450101,4501,전주시완산구,잘못 투입·구분된 투표지,,0,9,5,3,0,0,8,1,-9
4500,전라북도,전주시나선거구,6450102,4501,전주시완산구,합계,,33597,13223,5041,4569,3068,12678,545,20374
4500,전라북도,전주시나선거구,6450102,4501,전주시완산구,거소투표,,59,55,25,15,14,54,1,4
4500,전라북도,전주시나선거구,6450102,4501,전주시완산구,관외사전투표,,1950,1950,823,648,401,1872,78,0
4500,전라북도,전주시나선거구,6450102,4501,전주시완산구,완산동,계,4712,1864,756,664,374,1794,70,2848
4500,전라북도,전주시나선거구,6450102,4501,전주시완산구,완산동,관내사전투표,684,683,262,243,143,648,35,1
4500,전라북도,전주시나선거구,6450102,4501,전주시완산구,완산동,선거일투표,4028,1181,494,421,231,1146,35,2847
4500,전라북도,전주시나선거구,6450102,4501,전주시완산구,중화산1동,계,11734,4451,1682,1523,1039,4244,207,7283
4500,전라북도,전주시나선거구,6450102,4501,전주시완산구,중화산1동,관내사전투표,1770,1770,696,591,393,1680,90,0
4500,전라북도,전주시나선거구,6450102,4501,전주시완산구,중화산1동,선거일투표,9964,2681,986,932,646,2564,117,7283
4500,전라북도,전주시나선거구,6450102,4501,전주시완산구,중화산2동,계,15142,4899,1754,1716,1240,4710,189,10243
4500,전라북도,전주시나선거구,6450102,4501,전주시완산구,중화산2동,관내사전투표,1556,1553,551,593,351,1495,58,3
4500,전라북도,전주시나선거구,6450102,4501,전주시완산구,중화산2동,선거일투표,13586,3346,1203,1123,889,3215,131,10240
4500,전라북도,전주시나선거구,6450102,4501,전주시완산구,잘못 투입·구분된 투표지,,0,4,1,3,0,4,0,-4
4500,전라북도,전주시다선거구,6450103,4501,전주시완산구,합계,,63026,26714,7607,4558,3881,8866,919,25831,883,36312
4500,전라북도,전주시다선거구,6450103,4501,전주시완산구,거소투표,,294,272,91,38,44,35,12,220,52,22
4500,전라북도,전주시다선거구,6450103,4501,전주시완산구,관외사전투표,,3217,3214,1081,616,468,796,143,3104,110,3
4500,전라북도,전주시다선거구,6450103,4501,전주시완산구,동서학동,계,5245,2170,516,228,374,928,40,2086,84,3075
4500,전라북도,전주시다선거구,6450103,4501,전주시완산구,동서학동,관내사전투표,862,859,187,95,155,379,14,830,29,3
4500,전라북도,전주시다선거구,6450103,4501,전주시완산구,동서학동,선거일투표,4383,1311,329,133,219,549,26,1256,55,3072
4500,전라북도,전주시다선거구,6450103,4501,전주시완산구,서서학동,계,7479,3092,652,354,646,1275,75,3002,90,4387
4500,전라북도,전주시다선거구,6450103,4501,전주시완산구,서서학동,관내사전투표,1413,1412,295,133,330,588,31,1377,35,1
4500,전라북도,전주시다선거구,6450103,4501,전주시완산구,서서학동,선거일투표,6066,1680,357,221,316,687,44,1625,55,4386
4500,전라북도,전주시다선거구,6450103,4501,전주시완산구,평화1동,계,11298,4450,1185,645,567,1754,123,4274,176,6848
4500,전라북도,전주시다선거구,6450103,4501,전주시완산구,평화1동,관내사전투표,2172,2167,563,300,262,897,53,2075,92,5
4500,전라북도,전주시다선거구,6450103,4501,전주시완산구,평화1동,선거일투표,9126,2283,622,345,305,857,70,2199,84,6843
4500,전라북도,전주시다선거구,6450103,4501,전주시완산구,평화2동,계,35493,13508,4078,2676,1781,4076,526,13137,371,21985
4500,전라북도,전주시다선거구,6450103,4501,전주시완산구,평화2동,관내사전투표,4179,4178,1118,893,640,1282,134,4067,111,1
4500,전라북도,전주시다선거구,6450103,4501,전주시완산구,평화2동,선거일투표,31314,9330,2960,1783,1141,2794,392,9070,260,21984
4500,전라북도,전주시다선거구,6450103,4501,전주시완산구,잘못 투입·구분된 투표지,,0,8,4,1,1,2,0,8,0,-8
4500,전라북도,전주시라선거구,6450104,4501,전주시완산구,합계,,33917,14140,6338,4947,2376,13661,479,19777
4500,전라북도,전주시라선거구,6450104,4501,전주시완산구,거소투표,,59,56,24,14,10,48,8,3
4500,전라북도,전주시라선거구,6450104,4501,전주시완산구,관외사전투표,,1880,1880,836,599,368,1803,77,0
4500,전라북도,전주시라선거구,6450104,4501,전주시완산구,서신동,계,31978,12198,5476,4332,1997,11805,393,19780
4500,전라북도,전주시라선거구,6450104,4501,전주시완산구,서신동,관내사전투표,3574,3569,1561,1304,575,3440,129,5
4500,전라북도,전주시라선거구,6450104,4501,전주시완산구,서신동,선거일투표,28404,8629,3915,3028,1422,8365,264,19775
4500,전라북도,전주시라선거구,6450104,4501,전주시완산구,잘못 투입·구분된 투표지,,0,6,2,2,1,5,1,-6
4500,전라북도,전주시마선거구,6450105,4501,전주시완산구,합계,,49836,21128,7983,2240,2096,2495,2635,3029,20478,650,28708
4500,전라북도,전주시마선거구,6450105,4501,전주시완산구,거소투표,,90,79,36,10,5,10,5,7,73,6,11
4500,전라북도,전주시마선거구,6450105,4501,전주시완산구,관외사전투표,,2647,2644,1035,327,250,337,290,304,2543,101,3
4500,전라북도,전주시마선거구,6450105,4501,전주시완산구,삼천1동,계,9212,3437,1257,323,363,406,457,547,3353,84,5775
4500,전라북도,전주시마선거구,6450105,4501,전주시완산구,삼천1동,관내사전투표,1264,1263,456,113,120,145,140,250,1224,39,1
4500,전라북도,전주시마선거구,6450105,4501,전주시완산구,삼천1동,선거일투표,7948,2174,801,210,243,261,317,297,2129,45,5774
4500,전라북도,전주시마선거구,6450105,4501,전주시완산구,삼천2동,계,11335,4268,1544,384,343,494,459,896,4120,148,7067
4500,전라북도,전주시마선거구,6450105,4501,전주시완산구,삼천2동,관내사전투표,1573,1573,579,145,110,146,174,361,1515,58,0
4500,전라북도,전주시마선거구,6450105,4501,전주시완산구,삼천2동,선거일투표,9762,2695,965,239,233,348,285,535,2605,90,7067
4500,전라북도,전주시마선거구,6450105,4501,전주시완산구,삼천3동,계,17454,6983,2606,701,714,705,1126,936,6788,195,10471
4500,전라북도,전주시마선거구,6450105,4501,전주시완산구,삼천3동,관내사전투표,2327,2324,887,262,197,183,409,324,2262,62,3
4500,전라북도,전주시마선거구,6450105,4501,전주시완산구,삼천3동,선거일투표,15127,4659,1719,439,517,522,717,612,4526,133,10468
4500,전라북도,전주시마선거구,6450105,4501,전주시완산구,효자1동,계,9098,3708,1502,494,421,542,297,338,3594,114,5390
4500,전라북도,전주시마선거구,6450105,4501,전주시완산구,효자1동,관내사전투표,1601,1600,637,236,186,226,125,149,1559,41,1
4500,전라북도,전주시마선거구,6450105,4501,전주시완산구,효자1동,선거일투표,7497,2108,865,258,235,316,172,189,2035,73,5389
4500,전라북도,전주시마선거구,6450105,4501,전주시완산구,잘못 투입·구분된 투표지,,0,9,3,1,0,1,1,1,7,2,-9
4500,전라북도,전주시바선거구,6450106,4501,전주시완산구,합계,,52730,21706,7130,4095,2703,3004,4180,21112,594,31024
4500,전라북도,전주시바선거구,6450106,4501,전주시완산구,거소투표,,94,86,36,12,5,16,10,79,7,8
4500,전라북도,전주시바선거구,6450106,4501,전주시완산구,관외사전투표,,3437,3435,1218,653,423,490,511,3295,140,2
4500,전라북도,전주시바선거구,6450106,4501,전주시완산구,효자2동,계,8382,2989,1203,534,339,443,386,2905,84,5393
4500,전라북도,전주시바선거구,6450106,4501,전주시완산구,효자2동,관내사전투표,981,981,413,181,130,118,115,957,24,0
4500,전라북도,전주시바선거구,6450106,4501,전주시완산구,효자2동,선거일투표,7401,2008,790,353,209,325,271,1948,60,5393
4500,전라북도,전주시바선거구,6450106,4501,전주시완산구,효자3동,계,12221,5131,1827,936,600,684,972,5019,112,7090
4500,전라북도,전주시바선거구,6450106,4501,전주시완산구,효자3동,관내사전투표,1985,1982,713,364,211,243,403,1934,48,3
4500,전라북도,전주시바선거구,6450106,4501,전주시완산구,효자3동,선거일투표,10236,3149,1114,572,389,441,569,3085,64,7087
4500,전라북도,전주시바선거구,6450106,4501,전주시완산구,효자4동,계,28596,10059,2843,1960,1335,1369,2301,9808,251,18537
4500,전라북도,전주시바선거구,6450106,4501,전주시완산구,효자4동,관내사전투표,2183,2182,636,428,329,248,488,2129,53,1
4500,전라북도,전주시바선거구,6450106,4501,전주시완산구,효자4동,선거일투표,26413,7877,2207,1532,1006,1121,1813,7679,198,18536
4500,전라북도,전주시바선거구,6450106,4501,전주시완산구,잘못 투입·구분된 투표지,,0,6,3,0,1,2,0,6,0,-6
4500,전라북도,전주시사선거구,6450107,4501,전주시완산구,검색된 결과가 없습니다.
4500,전라북도,전주시아선거구,6450201,4502,전주시덕진구,합계,,54140,22259,8197,3840,6382,3137,21556,703,31881
4500,전라북도,전주시아선거구,6450201,4502,전주시덕진구,거소투표,,88,84,44,13,11,11,79,5,4
4500,전라북도,전주시아선거구,6450201,4502,전주시덕진구,관외사전투표,,2716,2716,1108,449,588,457,2602,114,0
4500,전라북도,전주시아선거구,6450201,4502,전주시덕진구,진북동,계,12012,4974,1339,397,2451,643,4830,144,7038
4500,전라북도,전주시아선거구,6450201,4502,전주시덕진구,진북동,관내사전투표,1802,1802,472,147,921,193,1733,69,0
4500,전라북도,전주시아선거구,6450201,4502,전주시덕진구,진북동,선거일투표,10210,3172,867,250,1530,450,3097,75,7038
4500,전라북도,전주시아선거구,6450201,4502,전주시덕진구,인후1동,계,14158,5533,1999,1752,909,715,5375,158,8625
4500,전라북도,전주시아선거구,6450201,4502,전주시덕진구,인후1동,관내사전투표,2374,2372,841,772,418,274,2305,67,2
4500,전라북도,전주시아선거구,6450201,4502,전주시덕진구,인후1동,선거일투표,11784,3161,1158,980,491,441,3070,91,8623
4500,전라북도,전주시아선거구,6450201,4502,전주시덕진구,인후2동,계,9623,3353,1382,573,828,477,3260,93,6270
4500,전라북도,전주시아선거구,6450201,4502,전주시덕진구,인후2동,관내사전투표,1136,1136,423,210,290,169,1092,44,0
4500,전라북도,전주시아선거구,6450201,4502,전주시덕진구,인후2동,선거일투표,8487,2217,959,363,538,308,2168,49,6270
4500,전라북도,전주시아선거구,6450201,4502,전주시덕진구,금암1동,계,7022,2196,1021,240,491,367,2119,77,4826
4500,전라북도,전주시아선거구,6450201,4502,전주시덕진구,금암1동,관내사전투표,803,801,383,84,186,117,770,31,2
4500,전라북도,전주시아선거구,6450201,4502,전주시덕진구,금암1동,선거일투표,6219,1395,638,156,305,250,1349,46,4824
4500,전라북도,전주시아선거구,6450201,4502,전주시덕진구,금암2동,계,8521,3396,1301,415,1102,466,3284,112,5125
4500,전라북도,전주시아선거구,6450201,4502,전주시덕진구,금암2동,관내사전투표,1523,1522,555,195,530,183,1463,59,1
4500,전라북도,전주시아선거구,6450201,4502,전주시덕진구,금암2동,선거일투표,6998,1874,746,220,572,283,1821,53,5124
4500,전라북도,전주시아선거구,6450201,4502,전주시덕진구,잘못 투입·구분된 투표지,,0,7,3,1,2,1,7,0,-7
4500,전라북도,전주시자선거구,6450202,4502,전주시덕진구,검색된 결과가 없습니다.
4500,전라북도,전주시차선거구,6450203,4502,전주시덕진구,합계,,40276,16108,7283,5429,2933,15645,463,24168
4500,전라북도,전주시차선거구,6450203,4502,전주시덕진구,거소투표,,99,86,41,21,13,75,11,13
4500,전라북도,전주시차선거구,6450203,4502,전주시덕진구,관외사전투표,,2064,2064,976,620,390,1986,78,0
4500,전라북도,전주시차선거구,6450203,4502,전주시덕진구,우아1동,계,10145,3557,1680,1050,727,3457,100,6588
4500,전라북도,전주시차선거구,6450203,4502,전주시덕진구,우아1동,관내사전투표,1443,1442,676,445,260,1381,61,1
4500,전라북도,전주시차선거구,6450203,4502,전주시덕진구,우아1동,선거일투표,8702,2115,1004,605,467,2076,39,6587
4500,전라북도,전주시차선거구,6450203,4502,전주시덕진구,우아2동,계,12293,3827,1820,1103,787,3710,117,8466
4500,전라북도,전주시차선거구,6450203,4502,전주시덕진구,우아2동,관내사전투표,1450,1449,663,471,273,1407,42,1
4500,전라북도,전주시차선거구,6450203,4502,전주시덕진구,우아2동,선거일투표,10843,2378,1157,632,514,2303,75,8465
4500,전라북도,전주시차선거구,6450203,4502,전주시덕진구,호성동,계,15675,6570,2765,2634,1014,6413,157,9105
4500,전라북도,전주시차선거구,6450203,4502,전주시덕진구,호성동,관내사전투표,2063,2061,856,866,290,2012,49,2
4500,전라북도,전주시차선거구,6450203,4502,전주시덕진구,호성동,선거일투표,13612,4509,1909,1768,724,4401,108,9103
4500,전라북도,전주시차선거구,6450203,4502,전주시덕진구,잘못 투입·구분된 투표지,,0,4,1,1,2,4,0,-4
4500,전라북도,전주시카선거구,6450204,4502,전주시덕진구,합계,,48647,20772,6855,5146,2785,5410,20196,576,27875
4500,전라북도,전주시카선거구,6450204,4502,전주시덕진구,거소투표,,76,67,29,20,4,9,62,5,9
4500,전라북도,전주시카선거구,6450204,4502,전주시덕진구,관외사전투표,,3856,3856,1411,1010,474,825,3720,136,0
4500,전라북도,전주시카선거구,6450204,4502,전주시덕진구,송천1동,계,44715,16843,5413,4113,2307,4575,16408,435,27872
4500,전라북도,전주시카선거구,6450204,4502,전주시덕진구,송천1동,관내사전투표,3642,3641,1128,973,542,913,3556,85,1
4500,전라북도,전주시카선거구,6450204,4502,전주시덕진구,송천1동,선거일투표,41073,13202,4285,3140,1765,3662,12852,350,27871
4500,전라북도,전주시카선거구,6450204,4502,전주시덕진구,잘못 투입·구분된 투표지,,0,6,2,3,0,1,6,0,-6
4500,전라북도,전주시타선거구,6450205,4502,전주시덕진구,합계,,49551,20507,5445,3656,5146,2793,2940,19980,527,29044
4500,전라북도,전주시타선거구,6450205,4502,전주시덕진구,거소투표,,90,81,34,13,12,13,7,79,2,9
4500,전라북도,전주시타선거구,6450205,4502,전주시덕진구,관외사전투표,,2524,2524,790,320,679,422,230,2441,83,0
4500,전라북도,전주시타선거구,6450205,4502,전주시덕진구,조촌동,계,10503,3864,904,1093,498,403,856,3754,110,6639
4500,전라북도,전주시타선거구,6450205,4502,전주시덕진구,조촌동,관내사전투표,1655,1655,396,467,224,135,389,1611,44,0
4500,전라북도,전주시타선거구,6450205,4502,전주시덕진구,조촌동,선거일투표,8848,2209,508,626,274,268,467,2143,66,6639
4500,전라북도,전주시타선거구,6450205,4502,전주시덕진구,여의동,계,22805,8242,2147,1725,1649,1034,1485,8040,202,14563
4500,전라북도,전주시타선거구,6450205,4502,전주시덕진구,여의동,관내사전투표,1986,1984,467,518,255,186,507,1933,51,2
4500,전라북도,전주시타선거구,6450205,4502,전주시덕진구,여의동,선거일투표,20819,6258,1680,1207,1394,848,978,6107,151,14561
4500,전라북도,전주시타선거구,6450205,4502,전주시덕진구,혁신동,계,13629,5791,1570,504,2306,920,361,5661,130,7838
4500,전라북도,전주시타선거구,6450205,4502,전주시덕진구,혁신동,관내사전투표,2151,2148,590,181,871,319,135,2096,52,3
4500,전라북도,전주시타선거구,6450205,4502,전주시덕진구,혁신동,선거일투표,11478,3643,980,323,1435,601,226,3565,78,7835
4500,전라북도,전주시타선거구,6450205,4502,전주시덕진구,잘못 투입·구분된 투표지,,0,5,0,1,2,1,1,5,0,-5
4500,전라북도,군산시가선거구,6450301,4503,군산시,검색된 결과가 없습니다.
4500,전라북도,군산시나선거구,6450302,4503,군산시,검색된 결과가 없습니다.
4500,전라북도,군산시다선거구,6450303,4503,군산시,합계,,16784,8661,5501,2013,729,8243,418,8123
4500,전라북도,군산시다선거구,6450303,4503,군산시,거소투표,,65,59,36,15,2,53,6,6
4500,전라북도,군산시다선거구,6450303,4503,군산시,관외사전투표,,923,923,537,227,121,885,38,0
4500,전라북도,군산시다선거구,6450303,4503,군산시,임피면,계,2288,1090,755,173,118,1046,44,1198
4500,전라북도,군산시다선거구,6450303,4503,군산시,임피면,관내사전투표,549,549,396,77,56,529,20,0
4500,전라북도,군산시다선거구,6450303,4503,군산시,임피면,선거일투표,1739,541,359,96,62,517,24,1198
4500,전라북도,군산시다선거구,6450303,4503,군산시,서수면,계,2215,1033,672,142,160,974,59,1182
4500,전라북도,군산시다선거구,6450303,4503,군산시,서수면,관내사전투표,428,425,284,54,57,395,30,3
4500,전라북도,군산시다선거구,6450303,4503,군산시,서수면,선거일투표,1787,608,388,88,103,579,29,1179
4500,전라북도,군산시다선거구,6450303,4503,군산시,대야면,계,4351,2059,1279,527,128,1934,125,2292
4500,전라북도,군산시다선거구,6450303,4503,군산시,대야면,관내사전투표,1277,1273,823,309,68,1200,73,4
4500,전라북도,군산시다선거구,6450303,4503,군산시,대야면,선거일투표,3074,786,456,218,60,734,52,2288
4500,전라북도,군산시다선거구,6450303,4503,군산시,개정면,계,2496,1218,549,556,65,1170,48,1278
4500,전라북도,군산시다선거구,6450303,4503,군산시,개정면,관내사전투표,556,555,256,244,25,525,30,1
4500,전라북도,군산시다선거구,6450303,4503,군산시,개정면,선거일투표,1940,663,293,312,40,645,18,1277
4500,전라북도,군산시다선거구,6450303,4503,군산시,성산면,계,2525,1333,1022,200,73,1295,38,1192
4500,전라북도,군산시다선거구,6450303,4503,군산시,성산면,관내사전투표,744,744,594,92,33,719,25,0
4500,전라북도,군산시다선거구,6450303,4503,군산시,성산면,선거일투표,1781,589,428,108,40,576,13,1192
4500,전라북도,군산시다선거구,6450303,4503,군산시,나포면,계,1921,936,646,171,62,879,57,985
4500,전라북도,군산시다선거구,6450303,4503,군산시,나포면,관내사전투표,525,523,358,89,31,478,45,2
4500,전라북도,군산시다선거구,6450303,4503,군산시,나포면,선거일투표,1396,413,288,82,31,401,12,983
4500,전라북도,군산시다선거구,6450303,4503,군산시,잘못 투입·구분된 투표지,,0,10,5,2,0,7,3,-10
4500,전라북도,군산시라선거구,6450304,4503,군산시,합계,,39990,16521,4528,2563,3699,1569,1599,1840,15798,723,23469
4500,전라북도,군산시라선거구,6450304,4503,군산시,거소투표,,80,74,25,14,12,7,2,6,66,8,6
4500,전라북도,군산시라선거구,6450304,4503,군산시,관외사전투표,,2006,2006,686,232,477,188,145,180,1908,98,0
4500,전라북도,군산시라선거구,6450304,4503,군산시,중앙동,계,3824,1385,448,214,315,94,79,154,1304,81,2439
4500,전라북도,군산시라선거구,6450304,4503,군산시,중앙동,관내사전투표,678,678,216,115,177,39,30,69,646,32,0
4500,전라북도,군산시라선거구,6450304,4503,군산시,중앙동,선거일투표,3146,707,232,99,138,55,49,85,658,49,2439
4500,전라북도,군산시라선거구,6450304,4503,군산시,조촌동,계,18582,6618,1507,944,1529,656,789,914,6339,279,11964
4500,전라북도,군산시라선거구,6450304,4503,군산시,조촌동,관내사전투표,2413,2413,539,383,572,206,310,327,2337,76,0
4500,전라북도,군산시라선거구,6450304,4503,군산시,조촌동,선거일투표,16169,4205,968,561,957,450,479,587,4002,203,11964
4500,전라북도,군산시라선거구,6450304,4503,군산시,경암동,계,6417,2676,949,503,417,274,199,218,2560,116,3741
4500,전라북도,군산시라선거구,6450304,4503,군산시,경암동,관내사전투표,1042,1042,375,211,184,106,54,73,1003,39,0
4500,전라북도,군산시라선거구,6450304,4503,군산시,경암동,선거일투표,5375,1634,574,292,233,168,145,145,1557,77,3741
4500,전라북도,군산시라선거구,6450304,4503,군산시,구암동,계,6703,2611,616,494,656,243,265,254,2528,83,4092
4500,전라북도,군산시라선거구,6450304,4503,군산시,구암동,관내사전투표,1011,1008,238,193,247,98,117,89,982,26,3
4500,전라북도,군산시라선거구,6450304,4503,군산시,구암동,선거일투표,5692,1603,378,301,409,145,148,165,1546,57,4089
4500,전라북도,군산시라선거구,6450304,4503,군산시,개정동,계,2378,1148,297,162,292,107,119,113,1090,58,1230
4500,전라북도,군산시라선거구,6450304,4503,군산시,개정동,관내사전투표,659,659,169,109,156,61,68,69,632,27,0
4500,전라북도,군산시라선거구,6450304,4503,군산시,개정동,선거일투표,1719,489,128,53,136,46,51,44,458,31,1230
4500,전라북도,군산시라선거구,6450304,4503,군산시,잘못 투입·구분된 투표지,,0,3,0,0,1,0,1,1,3,0,-3
4500,전라북도,군산시마선거구,6450305,4503,군산시,검색된 결과가 없습니다.
4500,전라북도,군산시바선거구,6450306,4503,군산시,합계,,42293,15766,4573,4629,2988,1630,1433,15253,513,26527
4500,전라북도,군산시바선거구,6450306,4503,군산시,거소투표,,73,60,16,16,12,7,3,54,6,13
4500,전라북도,군산시바선거구,6450306,4503,군산시,관외사전투표,,3125,3125,814,941,642,323,284,3004,121,0
4500,전라북도,군산시바선거구,6450306,4503,군산시,수송동,계,39095,12580,3743,3672,2334,1300,1146,12195,385,26515
4500,전라북도,군산시바선거구,6450306,4503,군산시,수송동,관내사전투표,3143,3141,917,953,665,297,246,3078,63,2
4500,전라북도,군산시바선거구,6450306,4503,군산시,수송동,선거일투표,35952,9439,2826,2719,1669,1003,900,9117,322,26513
4500,전라북도,군산시바선거구,6450306,4503,군산시,잘못 투입·구분된 투표지,,0,1,0,0,0,0,0,0,1,-1
4500,전라북도,군산시사선거구,6450307,4503,군산시,검색된 결과가 없습니다.
4500,전라북도,군산시아선거구,6450308,4503,군산시,검색된 결과가 없습니다.
4500,전라북도,익산시가선거구,6450501,4505,익산시,합계,,38750,17777,5167,3987,2920,2315,2852,17241,536,20973
4500,전라북도,익산시가선거구,6450501,4505,익산시,거소투표,,49,43,16,10,7,8,0,41,2,6
4500,전라북도,익산시가선거구,6450501,4505,익산시,관외사전투표,,2370,2370,716,519,363,298,406,2302,68,0
4500,전라북도,익산시가선거구,6450501,4505,익산시,모현동,계,29465,12265,3557,2684,2027,1586,2036,11890,375,17200
4500,전라북도,익산시가선거구,6450501,4505,익산시,모현동,관내사전투표,4101,4099,1237,873,758,478,654,4000,99,2
4500,전라북도,익산시가선거구,6450501,4505,익산시,모현동,선거일투표,25364,8166,2320,1811,1269,1108,1382,7890,276,17198
4500,전라북도,익산시가선거구,6450501,4505,익산시,송학동,계,6866,3093,877,772,521,422,410,3002,91,3773
4500,전라북도,익산시가선거구,6450501,4505,익산시,송학동,관내사전투표,1398,1398,402,400,229,153,181,1365,33,0
4500,전라북도,익산시가선거구,6450501,4505,익산시,송학동,선거일투표,5468,1695,475,372,292,269,229,1637,58,3773
4500,전라북도,익산시가선거구,6450501,4505,익산시,잘못 투입·구분된 투표지,,0,6,1,2,2,1,0,6,0,-6
4500,전라북도,익산시나선거구,6450502,4505,익산시,합계,,22212,9841,2268,2266,2553,688,859,791,9425,416,12371
4500,전라북도,익산시나선거구,6450502,4505,익산시,거소투표,,44,41,11,9,5,3,3,2,33,8,3
4500,전라북도,익산시나선거구,6450502,4505,익산시,관외사전투표,,1177,1176,361,253,243,98,101,78,1134,42,1
4500,전라북도,익산시나선거구,6450502,4505,익산시,중앙동,계,3110,1432,260,391,359,122,165,79,1376,56,1678
4500,전라북도,익산시나선거구,6450502,4505,익산시,중앙동,관내사전투표,716,714,123,195,188,55,89,35,685,29,2
4500,전라북도,익산시나선거구,6450502,4505,익산시,중앙동,선거일투표,2394,718,137,196,171,67,76,44,691,27,1676
4500,전라북도,익산시나선거구,6450502,4505,익산시,평화동,계,3918,1761,422,406,463,123,183,94,1691,70,2157
4500,전라북도,익산시나선거구,6450502,4505,익산시,평화동,관내사전투표,794,794,176,213,219,54,80,35,777,17,0
4500,전라북도,익산시나선거구,6450502,4505,익산시,평화동,선거일투표,3124,967,246,193,244,69,103,59,914,53,2157
4500,전라북도,익산시나선거구,6450502,4505,익산시,인화동,계,5580,2104,437,452,550,96,160,313,2008,96,3476
4500,전라북도,익산시나선거구,6450502,4505,익산시,인화동,관내사전투표,828,828,173,186,214,39,62,109,783,45,0
4500,전라북도,익산시나선거구,6450502,4505,익산시,인화동,선거일투표,4752,1276,264,266,336,57,98,204,1225,51,3476
4500,전라북도,익산시나선거구,6450502,4505,익산시,마동,계,8383,3321,777,753,932,245,247,223,3177,144,5062
4500,전라북도,익산시나선거구,6450502,4505,익산시,마동,관내사전투표,1397,1395,278,359,373,104,97,132,1343,52,2
4500,전라북도,익산시나선거구,6450502,4505,익산시,마동,선거일투표,6986,1926,499,394,559,141,150,91,1834,92,5060
4500,전라북도,익산시나선거구,6450502,4505,익산시,잘못 투입·구분된 투표지,,0,6,0,2,1,1,0,2,6,0,-6
4500,전라북도,익산시다선거구,6450503,4505,익산시,합계,,31008,12990,6346,2734,1427,733,326,850,12416,574,18018
4500,전라북도,익산시다선거구,6450503,4505,익산시,거소투표,,82,76,33,18,12,4,1,5,73,3,6
4500,전라북도,익산시다선거구,6450503,4505,익산시,관외사전투표,,2014,2013,977,430,251,122,39,100,1919,94,1
4500,전라북도,익산시다선거구,6450503,4505,익산시,오산면,계,6154,2287,1248,456,209,101,45,122,2181,106,3867
4500,전라북도,익산시다선거구,6450503,4505,익산시,오산면,관내사전투표,679,679,358,154,62,20,8,46,648,31,0
4500,전라북도,익산시다선거구,6450503,4505,익산시,오산면,선거일투표,5475,1608,890,302,147,81,37,76,1533,75,3867
4500,전라북도,익산시다선거구,6450503,4505,익산시,남중동,계,9696,4107,1842,928,448,250,156,321,3945,162,5589
4500,전라북도,익산시다선거구,6450503,4505,익산시,남중동,관내사전투표,1801,1801,819,419,160,98,79,161,1736,65,0
4500,전라북도,익산시다선거구,6450503,4505,익산시,남중동,선거일투표,7895,2306,1023,509,288,152,77,160,2209,97,5589
4500,전라북도,익산시다선거구,6450503,4505,익산시,신동,계,13062,4503,2244,900,507,256,85,302,4294,209,8559
4500,전라북도,익산시다선거구,6450503,4505,익산시,신동,관내사전투표,1807,1806,957,361,183,76,30,117,1724,82,1
4500,전라북도,익산시다선거구,6450503,4505,익산시,신동,선거일투표,11255,2697,1287,539,324,180,55,185,2570,127,8558
4500,전라북도,익산시다선거구,6450503,4505,익산시,잘못 투입·구분된 투표지,,0,4,2,2,0,0,0,0,4,0,-4
4500,전라북도,익산시라선거구,6450504,4505,익산시,합계,,24275,13491,3775,1387,1072,757,2061,1938,627,1150,144,12911,580,10784
4500,전라북도,익산시라선거구,6450504,4505,익산시,거소투표,,63,61,11,4,5,8,3,8,2,11,2,54,7,2
4500,전라북도,익산시라선거구,6450504,4505,익산시,관외사전투표,,1135,1135,401,128,136,111,121,102,22,70,14,1105,30,0
4500,전라북도,익산시라선거구,6450504,4505,익산시,함열읍,계,5793,3247,1279,116,157,117,542,154,29,730,12,3136,111,2546
4500,전라북도,익산시라선거구,6450504,4505,익산시,함열읍,관내사전투표,1789,1789,719,60,90,49,293,89,13,403,7,1723,66,0
4500,전라북도,익산시라선거구,6450504,4505,익산시,함열읍,선거일투표,4004,1458,560,56,67,68,249,65,16,327,5,1413,45,2546
4500,전라북도,익산시라선거구,6450504,4505,익산시,황등면,계,6076,3080,432,669,425,189,268,845,4,28,92,2952,128,2996
4500,전라북도,익산시라선거구,6450504,4505,익산시,황등면,관내사전투표,1578,1578,260,369,221,64,149,401,2,10,37,1513,65,0
4500,전라북도,익산시라선거구,6450504,4505,익산시,황등면,선거일투표,4498,1502,172,300,204,125,119,444,2,18,55,1439,63,2996
4500,전라북도,익산시라선거구,6450504,4505,익산시,함라면,계,1948,1030,241,182,64,47,164,220,0,40,5,963,67,918
4500,전라북도,익산시라선거구,6450504,4505,익산시,함라면,관내사전투표,543,543,126,86,33,18,105,114,0,26,1,509,34,0
4500,전라북도,익산시라선거구,6450504,4505,익산시,함라면,선거일투표,1405,487,115,96,31,29,59,106,0,14,4,454,33,918
4500,전라북도,익산시라선거구,6450504,4505,익산시,웅포면,계,1334,737,214,73,49,41,142,102,1,77,4,703,34,597
4500,전라북도,익산시라선거구,6450504,4505,익산시,웅포면,관내사전투표,377,377,130,34,28,20,69,43,0,33,2,359,18,0
4500,전라북도,익산시라선거구,6450504,4505,익산시,웅포면,선거일투표,957,360,84,39,21,21,73,59,1,44,2,344,16,597
4500,전라북도,익산시라선거구,6450504,4505,익산시,성당면,계,1663,845,359,43,73,44,128,62,4,96,2,811,34,818
4500,전라북도,익산시라선거구,6450504,4505,익산시,성당면,관내사전투표,425,425,190,20,45,22,49,29,3,48,1,407,18,0
4500,전라북도,익산시라선거구,6450504,4505,익산시,성당면,선거일투표,1238,420,169,23,28,22,79,33,1,48,1,404,16,818
4500,전라북도,익산시라선거구,6450504,4505,익산시,용안면,계,2266,1221,350,39,72,51,430,129,25,50,9,1155,66,1045
4500,전라북도,익산시라선거구,6450504,4505,익산시,용안면,관내사전투표,651,651,185,23,43,19,214,78,10,24,8,604,47,0
4500,전라북도,익산시라선거구,6450504,4505,익산시,용안면,선거일투표,1615,570,165,16,29,32,216,51,15,26,1,551,19,1045
4500,전라북도,익산시라선거구,6450504,4505,익산시,망성면,계,2637,1403,269,89,53,104,132,238,428,13,1,1327,76,1234
4500,전라북도,익산시라선거구,6450504,4505,익산시,망성면,관내사전투표,639,639,115,46,27,43,62,107,197,6,1,604,35,0
4500,전라북도,익산시라선거구,6450504,4505,익산시,망성면,선거일투표,1998,764,154,43,26,61,70,131,231,7,0,723,41,1234
4500,전라북도,익산시라선거구,6450504,4505,익산시,용동면,계,1360,732,219,44,38,45,131,78,112,35,3,705,27,628
4500,전라북도,익산시라선거구,6450504,4505,익산시,용동면,관내사전투표,369,369,133,20,20,17,67,39,41,17,3,357,12,0
4500,전라북도,익산시라선거구,6450504,4505,익산시,용동면,선거일투표,991,363,86,24,18,28,64,39,71,18,0,348,15,628
4500,전라북도,익산시라선거구,6450504,4505,익산시,잘못 투입·구분된 투표지,,0,0,0,0,0,0,0,0,0,0,0,0,0,0
4500,전라북도,익산시마선거구,6450505,4505,익산시,합계,,20127,8099,3021,2641,2086,7748,351,12028
4500,전라북도,익산시마선거구,6450505,4505,익산시,거소투표,,18,17,8,3,2,13,4,1
4500,전라북도,익산시마선거구,6450505,4505,익산시,관외사전투표,,1440,1440,520,516,349,1385,55,0
4500,전라북도,익산시마선거구,6450505,4505,익산시,어양동,계,18669,6641,2493,2121,1735,6349,292,12028
4500,전라북도,익산시마선거구,6450505,4505,익산시,어양동,관내사전투표,2576,2576,929,890,675,2494,82,0
4500,전라북도,익산시마선거구,6450505,4505,익산시,어양동,선거일투표,16093,4065,1564,1231,1060,3855,210,12028
4500,전라북도,익산시마선거구,6450505,4505,익산시,잘못 투입·구분된 투표지,,0,1,0,1,0,1,0,-1
4500,전라북도,익산시바선거구,6450506,4505,익산시,합계,,40737,16912,6901,3251,2328,1425,2175,16080,832,23825
4500,전라북도,익산시바선거구,6450506,4505,익산시,거소투표,,69,67,31,13,14,4,2,64,3,2
4500,전라북도,익산시바선거구,6450506,4505,익산시,관외사전투표,,2576,2575,1149,497,314,204,264,2428,147,1
4500,전라북도,익산시바선거구,6450506,4505,익산시,삼기면,계,2291,978,394,278,70,79,79,900,78,1313
4500,전라북도,익산시바선거구,6450506,4505,익산시,삼기면,관내사전투표,523,519,212,144,35,47,45,483,36,4
4500,전라북도,익산시바선거구,6450506,4505,익산시,삼기면,선거일투표,1768,459,182,134,35,32,34,417,42,1309
4500,전라북도,익산시바선거구,6450506,4505,익산시,영등2동,계,10826,4404,1747,759,490,257,986,4239,165,6422
4500,전라북도,익산시바선거구,6450506,4505,익산시,영등2동,관내사전투표,1983,1980,801,337,226,109,440,1913,67,3
4500,전라북도,익산시바선거구,6450506,4505,익산시,영등2동,선거일투표,8843,2424,946,422,264,148,546,2326,98,6419
4500,전라북도,익산시바선거구,6450506,4505,익산시,삼성동,계,24975,8878,3575,1700,1440,880,844,8439,439,16097
4500,전라북도,익산시바선거구,6450506,4505,익산시,삼성동,관내사전투표,2905,2904,1140,590,538,293,239,2800,104,1
4500,전라북도,익산시바선거구,6450506,4505,익산시,삼성동,선거일투표,22070,5974,2435,1110,902,587,605,5639,335,16096
4500,전라북도,익산시바선거구,6450506,4505,익산시,잘못 투입·구분된 투표지,,0,10,5,4,0,1,0,10,0,-10
4500,전라북도,익산시사선거구,6450507,4505,익산시,합계,,38102,15768,6258,2063,4339,2406,15066,702,22334
4500,전라북도,익산시사선거구,6450507,4505,익산시,거소투표,,71,68,31,10,13,5,59,9,3
4500,전라북도,익산시사선거구,6450507,4505,익산시,관외사전투표,,2417,2417,1100,314,548,324,2286,131,0
4500,전라북도,익산시사선거구,6450507,4505,익산시,동산동,계,17725,6420,2150,550,2577,897,6174,246,11305
4500,전라북도,익산시사선거구,6450507,4505,익산시,동산동,관내사전투표,2690,2690,804,206,1240,334,2584,106,0
4500,전라북도,익산시사선거구,6450507,4505,익산시,동산동,선거일투표,15035,3730,1346,344,1337,563,3590,140,11305
4500,전라북도,익산시사선거구,6450507,4505,익산시,영등1동,계,17889,6863,2977,1189,1201,1180,6547,316,11026
4500,전라북도,익산시사선거구,6450507,4505,익산시,영등1동,관내사전투표,2615,2614,1088,453,528,419,2488,126,1
4500,전라북도,익산시사선거구,6450507,4505,익산시,영등1동,선거일투표,15274,4249,1889,736,673,761,4059,190,11025
4500,전라북도,익산시사선거구,6450507,4505,익산시,잘못 투입·구분된 투표지,,0,0,0,0,0,0,0,0,0
4500,전라북도,익산시아선거구,6450508,4505,익산시,합계,,23866,12367,3458,2937,920,1572,2350,121,443,11801,566,11499
4500,전라북도,익산시아선거구,6450508,4505,익산시,거소투표,,196,183,12,107,7,41,13,1,0,181,2,13
4500,전라북도,익산시아선거구,6450508,4505,익산시,관외사전투표,,1351,1351,473,327,171,112,198,6,29,1316,35,0
4500,전라북도,익산시아선거구,6450508,4505,익산시,낭산면,계,2578,1317,323,173,91,84,554,20,19,1264,53,1261
4500,전라북도,익산시아선거구,6450508,4505,익산시,낭산면,관내사전투표,646,646,156,86,46,26,284,10,7,615,31,0
4500,전라북도,익산시아선거구,6450508,4505,익산시,낭산면,선거일투표,1932,671,167,87,45,58,270,10,12,649,22,1261
4500,전라북도,익산시아선거구,6450508,4505,익산시,여산면,계,2849,1531,308,287,116,232,419,45,36,1443,88,1318
4500,전라북도,익산시아선거구,6450508,4505,익산시,여산면,관내사전투표,816,815,162,149,55,127,226,19,24,762,53,1
4500,전라북도,익산시아선거구,6450508,4505,익산시,여산면,선거일투표,2033,716,146,138,61,105,193,26,12,681,35,1317
4500,전라북도,익산시아선거구,6450508,4505,익산시,금마면,계,4548,2302,410,534,161,569,481,18,30,2203,99,2246
4500,전라북도,익산시아선거구,6450508,4505,익산시,금마면,관내사전투표,1091,1091,190,256,71,287,215,9,17,1045,46,0
4500,전라북도,익산시아선거구,6450508,4505,익산시,금마면,선거일투표,3457,1211,220,278,90,282,266,9,13,1158,53,2246
4500,전라북도,익산시아선거구,6450508,4505,익산시,왕궁면,계,3488,1898,251,970,79,319,175,5,24,1823,75,1590
4500,전라북도,익산시아선거구,6450508,4505,익산시,왕궁면,관내사전투표,758,758,95,424,31,90,83,3,12,738,20,0
4500,전라북도,익산시아선거구,6450508,4505,익산시,왕궁면,선거일투표,2730,1140,156,546,48,229,92,2,12,1085,55,1590
4500,전라북도,익산시아선거구,6450508,4505,익산시,춘포면,계,3618,1579,613,269,100,128,150,7,240,1507,72,2039
4500,전라북도,익산시아선거구,6450508,4505,익산시,춘포면,관내사전투표,395,395,148,72,22,26,28,2,73,371,24,0
4500,전라북도,익산시아선거구,6450508,4505,익산시,춘포면,선거일투표,3223,1184,465,197,78,102,122,5,167,1136,48,2039
4500,전라북도,익산시아선거구,6450508,4505,익산시,팔봉동,계,5238,2205,1067,270,195,87,360,19,65,2063,142,3033
4500,전라북도,익산시아선거구,6450508,4505,익산시,팔봉동,관내사전투표,1114,1113,500,135,80,43,193,7,46,1004,109,1
4500,전라북도,익산시아선거구,6450508,4505,익산시,팔봉동,선거일투표,4124,1092,567,135,115,44,167,12,19,1059,33,3032
4500,전라북도,익산시아선거구,6450508,4505,익산시,잘못 투입·구분된 투표지,,0,1,1,0,0,0,0,0,0,1,0,-1
4500,전라북도,정읍시가선거구,6450701,4507,정읍시,합계,,13735,8469,1302,1040,705,152,229,145,1462,708,725,639,325,624,8056,413,5266
4500,전라북도,정읍시가선거구,6450701,4507,정읍시,거소투표,,72,64,15,5,7,2,0,1,19,1,2,4,0,3,59,5,8
4500,전라북도,정읍시가선거구,6450701,4507,정읍시,관외사전투표,,913,912,256,122,60,33,32,11,121,55,51,55,23,58,877,35,1
4500,전라북도,정읍시가선거구,6450701,4507,정읍시,신태인읍,계,4759,2806,258,340,411,55,144,100,434,23,51,456,243,179,2694,112,1953
4500,전라북도,정읍시가선거구,6450701,4507,정읍시,신태인읍,관내사전투표,1481,1481,135,183,198,33,68,35,257,10,18,246,153,99,1435,46,0
4500,전라북도,정읍시가선거구,6450701,4507,정읍시,신태인읍,선거일투표,3278,1325,123,157,213,22,76,65,177,13,33,210,90,80,1259,66,1953
4500,전라북도,정읍시가선거구,6450701,4507,정읍시,북면,계,3581,2109,393,78,59,31,28,12,149,571,586,47,20,32,2006,103,1472
4500,전라북도,정읍시가선거구,6450701,4507,정읍시,북면,관내사전투표,1181,1181,207,48,38,16,8,7,87,349,317,26,11,18,1132,49,0
4500,전라북도,정읍시가선거구,6450701,4507,정읍시,북면,선거일투표,2400,928,186,30,21,15,20,5,62,222,269,21,9,14,874,54,1472
4500,전라북도,정읍시가선거구,6450701,4507,정읍시,정우면,계,2030,1224,293,39,33,15,12,7,678,27,18,22,8,11,1163,61,806
4500,전라북도,정읍시가선거구,6450701,4507,정읍시,정우면,관내사전투표,727,727,157,24,16,9,10,4,420,16,11,10,3,4,684,43,0
4500,전라북도,정읍시가선거구,6450701,4507,정읍시,정우면,선거일투표,1303,497,136,15,17,6,2,3,258,11,7,12,5,7,479,18,806
4500,전라북도,정읍시가선거구,6450701,4507,정읍시,감곡면,계,2380,1353,87,455,135,16,13,14,61,31,17,55,31,341,1256,97,1027
4500,전라북도,정읍시가선거구,6450701,4507,정읍시,감곡면,관내사전투표,723,722,33,261,67,8,4,6,32,17,4,30,15,195,672,50,1
4500,전라북도,정읍시가선거구,6450701,4507,정읍시,감곡면,선거일투표,1657,631,54,194,68,8,9,8,29,14,13,25,16,146,584,47,1026
4500,전라북도,정읍시가선거구,6450701,4507,정읍시,잘못 투입·구분된 투표지,,0,1,0,1,0,0,0,0,0,0,0,0,0,0,1,0,-1
4500,전라북도,정읍시나선거구,6450702,4507,정읍시,합계,,7852,4928,1902,1516,1247,4665,263,2924
4500,전라북도,정읍시나선거구,6450702,4507,정읍시,거소투표,,179,162,77,30,34,141,21,17
4500,전라북도,정읍시나선거구,6450702,4507,정읍시,관외사전투표,,669,668,281,195,154,630,38,1
4500,전라북도,정읍시나선거구,6450702,4507,정읍시,고부면,계,2305,1265,314,716,148,1178,87,1040
4500,전라북도,정읍시나선거구,6450702,4507,정읍시,고부면,관내사전투표,658,657,160,385,53,598,59,1
4500,전라북도,정읍시나선거구,6450702,4507,정읍시,고부면,선거일투표,1647,608,154,331,95,580,28,1039
4500,전라북도,정읍시나선거구,6450702,4507,정읍시,영원면,계,1474,955,642,127,158,927,28,519
4500,전라북도,정읍시나선거구,6450702,4507,정읍시,영원면,관내사전투표,486,486,341,57,74,472,14,0
4500,전라북도,정읍시나선거구,6450702,4507,정읍시,영원면,선거일투표,988,469,301,70,84,455,14,519
4500,전라북도,정읍시나선거구,6450702,4507,정읍시,덕천면,계,1462,839,343,222,228,793,46,623
4500,전라북도,정읍시나선거구,6450702,4507,정읍시,덕천면,관내사전투표,334,334,144,96,73,313,21,0
4500,전라북도,정읍시나선거구,6450702,4507,정읍시,덕천면,선거일투표,1128,505,199,126,155,480,25,623
4500,전라북도,정읍시나선거구,6450702,4507,정읍시,이평면,계,1763,1037,245,224,525,994,43,726
4500,전라북도,정읍시나선거구,6450702,4507,정읍시,이평면,관내사전투표,490,490,123,97,241,461,29,0
4500,전라북도,정읍시나선거구,6450702,4507,정읍시,이평면,선거일투표,1273,547,122,127,284,533,14,726
4500,전라북도,정읍시나선거구,6450702,4507,정읍시,잘못 투입·구분된 투표지,,0,2,0,2,0,2,0,-2
4500,전라북도,정읍시다선거구,6450703,4507,정읍시,검색된 결과가 없습니다.
4500,전라북도,정읍시라선거구,6450704,4507,정읍시,합계,,9860,6373,1958,1620,2048,323,5949,424,3487
4500,전라북도,정읍시라선거구,6450704,4507,정읍시,거소투표,,17,15,6,3,2,0,11,4,2
4500,전라북도,정읍시라선거구,6450704,4507,정읍시,관외사전투표,,726,726,264,161,233,37,695,31,0
4500,전라북도,정읍시라선거구,6450704,4507,정읍시,태인면,계,2908,1692,940,357,257,55,1609,83,1216
4500,전라북도,정읍시라선거구,6450704,4507,정읍시,태인면,관내사전투표,899,899,523,166,134,27,850,49,0
4500,전라북도,정읍시라선거구,6450704,4507,정읍시,태인면,선거일투표,2009,793,417,191,123,28,759,34,1216
4500,전라북도,정읍시라선거구,6450704,4507,정읍시,옹동면,계,1369,851,214,355,179,27,775,76,518
4500,전라북도,정읍시라선거구,6450704,4507,정읍시,옹동면,관내사전투표,366,366,98,144,81,14,337,29,0
4500,전라북도,정읍시라선거구,6450704,4507,정읍시,옹동면,선거일투표,1003,485,116,211,98,13,438,47,518
4500,전라북도,정읍시라선거구,6450704,4507,정읍시,칠보면,계,1958,1294,204,312,605,76,1197,97,664
4500,전라북도,정읍시라선거구,6450704,4507,정읍시,칠보면,관내사전투표,603,603,105,149,280,37,571,32,0
4500,전라북도,정읍시라선거구,6450704,4507,정읍시,칠보면,선거일투표,1355,691,99,163,325,39,626,65,664
4500,전라북도,정읍시라선거구,6450704,4507,정읍시,산내면,계,1036,726,106,202,316,42,666,60,310
4500,전라북도,정읍시라선거구,6450704,4507,정읍시,산내면,관내사전투표,444,443,68,118,202,24,412,31,1
4500,전라북도,정읍시라선거구,6450704,4507,정읍시,산내면,선거일투표,592,283,38,84,114,18,254,29,309
4500,전라북도,정읍시라선거구,6450704,4507,정읍시,산외면,계,1846,1066,223,230,454,86,993,73,780
4500,전라북도,정읍시라선거구,6450704,4507,정읍시,산외면,관내사전투표,627,626,129,129,273,48,579,47,1
4500,전라북도,정읍시라선거구,6450704,4507,정읍시,산외면,선거일투표,1219,440,94,101,181,38,414,26,779
4500,전라북도,정읍시라선거구,6450704,4507,정읍시,잘못 투입·구분된 투표지,,0,3,1,0,2,0,3,0,-3
4500,전라북도,정읍시마선거구,6450705,4507,정읍시,합계,,16744,9650,3345,2753,3104,9202,448,7094
4500,전라북도,정읍시마선거구,6450705,4507,정읍시,거소투표,,35,31,15,4,8,27,4,4
4500,전라북도,정읍시마선거구,6450705,4507,정읍시,관외사전투표,,1738,1738,607,480,589,1676,62,0
4500,전라북도,정읍시마선거구,6450705,4507,정읍시,내장상동,계,14971,7879,2723,2268,2506,7497,382,7092
4500,전라북도,정읍시마선거구,6450705,4507,정읍시,내장상동,관내사전투표,3324,3322,1100,1058,1040,3198,124,2
4500,전라북도,정읍시마선거구,6450705,4507,정읍시,내장상동,선거일투표,11647,4557,1623,1210,1466,4299,258,7090
4500,전라북도,정읍시마선거구,6450705,4507,정읍시,잘못 투입·구분된 투표지,,0,2,0,1,1,2,0,-2
4500,전라북도,정읍시바선거구,6450706,4507,정읍시,합계,,16869,8622,2256,1536,900,2245,1374,8311,311,8247
4500,전라북도,정읍시바선거구,6450706,4507,정읍시,거소투표,,68,66,28,10,8,9,8,63,3,2
4500,전라북도,정읍시바선거구,6450706,4507,정읍시,관외사전투표,,1273,1266,363,270,127,284,167,1211,55,7
4500,전라북도,정읍시바선거구,6450706,4507,정읍시,수성동,계,13192,6128,1605,1061,680,1534,1044,5924,204,7064
4500,전라북도,정읍시바선거구,6450706,4507,정읍시,수성동,관내사전투표,2513,2510,608,477,257,661,444,2447,63,3
4500,전라북도,정읍시바선거구,6450706,4507,정읍시,수성동,선거일투표,10679,3618,997,584,423,873,600,3477,141,7061
4500,전라북도,정읍시바선거구,6450706,4507,정읍시,장명동,계,2336,1154,257,194,85,415,154,1105,49,1182
4500,전라북도,정읍시바선거구,6450706,4507,정읍시,장명동,관내사전투표,497,497,103,100,42,170,62,477,20,0
4500,전라북도,정읍시바선거구,6450706,4507,정읍시,장명동,선거일투표,1839,657,154,94,43,245,92,628,29,1182
4500,전라북도,정읍시바선거구,6450706,4507,정읍시,잘못 투입·구분된 투표지,,0,8,3,1,0,3,1,8,0,-8
4500,전라북도,정읍시사선거구,6450707,4507,정읍시,합계,,14958,8942,3399,1420,2758,889,8466,476,6016
4500,전라북도,정읍시사선거구,6450707,4507,정읍시,거소투표,,43,42,15,9,8,7,39,3,1
4500,전라북도,정읍시사선거구,6450707,4507,정읍시,관외사전투표,,1818,1817,742,350,428,210,1730,87,1
4500,전라북도,정읍시사선거구,6450707,4507,정읍시,시기동,계,2770,1664,684,229,514,149,1576,88,1106
4500,전라북도,정읍시사선거구,6450707,4507,정읍시,시기동,관내사전투표,779,777,316,102,252,70,740,37,2
4500,전라북도,정읍시사선거구,6450707,4507,정읍시,시기동,선거일투표,1991,887,368,127,262,79,836,51,1104
4500,전라북도,정읍시사선거구,6450707,4507,정읍시,초산동,계,7068,3826,1343,519,1390,393,3645,181,3242
4500,전라북도,정읍시사선거구,6450707,4507,정읍시,초산동,관내사전투표,1742,1742,578,229,715,167,1689,53,0
4500,전라북도,정읍시사선거구,6450707,4507,정읍시,초산동,선거일투표,5326,2084,765,290,675,226,1956,128,3242
4500,전라북도,정읍시사선거구,6450707,4507,정읍시,상교동,계,3259,1589,613,313,418,129,1473,116,1670
4500,전라북도,정읍시사선거구,6450707,4507,정읍시,상교동,관내사전투표,830,829,337,147,237,54,775,54,1
4500,전라북도,정읍시사선거구,6450707,4507,정읍시,상교동,선거일투표,2429,760,276,166,181,75,698,62,1669
4500,전라북도,정읍시사선거구,6450707,4507,정읍시,잘못 투입·구분된 투표지,,0,4,2,0,0,1,3,1,-4
4500,전라북도,남원시가선거구,6450801,4508,남원시,합계,,9547,6324,2010,2268,1779,6057,267,3223
4500,전라북도,남원시가선거구,6450801,4508,남원시,거소투표,,34,29,3,10,5,18,11,5
4500,전라북도,남원시가선거구,6450801,4508,남원시,관외사전투표,,486,486,188,176,107,471,15,0
4500,전라북도,남원시가선거구,6450801,4508,남원시,운봉읍,계,3277,2118,843,1036,160,2039,79,1159
4500,전라북도,남원시가선거구,6450801,4508,남원시,운봉읍,관내사전투표,1219,1216,505,580,83,1168,48,3
4500,전라북도,남원시가선거구,6450801,4508,남원시,운봉읍,선거일투표,2058,902,338,456,77,871,31,1156
4500,전라북도,남원시가선거구,6450801,4508,남원시,인월면,계,2409,1560,355,249,901,1505,55,849
4500,전라북도,남원시가선거구,6450801,4508,남원시,인월면,관내사전투표,843,841,210,139,463,812,29,2
4500,전라북도,남원시가선거구,6450801,4508,남원시,인월면,선거일투표,1566,719,145,110,438,693,26,847
4500,전라북도,남원시가선거구,6450801,4508,남원시,아영면,계,1626,1024,343,321,305,969,55,602
4500,전라북도,남원시가선거구,6450801,4508,남원시,아영면,관내사전투표,540,540,160,188,164,512,28,0
4500,전라북도,남원시가선거구,6450801,4508,남원시,아영면,선거일투표,1086,484,183,133,141,457,27,602
4500,전라북도,남원시가선거구,6450801,4508,남원시,산내면,계,1715,1101,276,474,299,1049,52,614
4500,전라북도,남원시가선거구,6450801,4508,남원시,산내면,관내사전투표,513,513,131,219,137,487,26,0
4500,전라북도,남원시가선거구,6450801,4508,남원시,산내면,선거일투표,1202,588,145,255,162,562,26,614
4500,전라북도,남원시가선거구,6450801,4508,남원시,잘못 투입·구분된 투표지,,0,6,2,2,2,6,0,-6
4500,전라북도,남원시나선거구,6450802,4508,남원시,합계,,6128,4619,1549,1377,461,937,116,4440,179,1509
4500,전라북도,남원시나선거구,6450802,4508,남원시,거소투표,,75,70,24,15,12,11,4,66,4,5
4500,전라북도,남원시나선거구,6450802,4508,남원시,관외사전투표,,810,809,281,260,77,147,21,786,23,1
4500,전라북도,남원시나선거구,6450802,4508,남원시,주천면,계,2028,1479,177,687,32,507,27,1430,49,549
4500,전라북도,남원시나선거구,6450802,4508,남원시,주천면,관내사전투표,807,807,90,374,18,279,17,778,29,0
4500,전라북도,남원시나선거구,6450802,4508,남원시,주천면,선거일투표,1221,672,87,313,14,228,10,652,20,549
4500,전라북도,남원시나선거구,6450802,4508,남원시,산동면,계,1437,1034,739,117,33,65,29,983,51,403
4500,전라북도,남원시나선거구,6450802,4508,남원시,산동면,관내사전투표,650,648,474,60,19,37,18,608,40,2
4500,전라북도,남원시나선거구,6450802,4508,남원시,산동면,선거일투표,787,386,265,57,14,28,11,375,11,401
4500,전라북도,남원시나선거구,6450802,4508,남원시,이백면,계,1778,1222,324,298,307,206,35,1170,52,556
4500,전라북도,남원시나선거구,6450802,4508,남원시,이백면,관내사전투표,709,708,183,164,192,115,16,670,38,1
4500,전라북도,남원시나선거구,6450802,4508,남원시,이백면,선거일투표,1069,514,141,134,115,91,19,500,14,555
4500,전라북도,남원시나선거구,6450802,4508,남원시,잘못 투입·구분된 투표지,,0,5,4,0,0,1,0,5,0,-5
4500,전라북도,남원시다선거구,6450803,4508,남원시,합계,,19978,12272,5593,2023,3118,1199,11933,339,7706
4500,전라북도,남원시다선거구,6450803,4508,남원시,거소투표,,42,36,14,7,7,4,32,4,6
4500,전라북도,남원시다선거구,6450803,4508,남원시,관외사전투표,,2091,2091,943,356,516,218,2033,58,0
4500,전라북도,남원시다선거구,6450803,4508,남원시,향교동,계,5843,3364,1704,436,778,336,3254,110,2479
4500,전라북도,남원시다선거구,6450803,4508,남원시,향교동,관내사전투표,1966,1963,995,264,455,178,1892,71,3
4500,전라북도,남원시다선거구,6450803,4508,남원시,향교동,선거일투표,3877,1401,709,172,323,158,1362,39,2476
4500,전라북도,남원시다선거구,6450803,4508,남원시,도통동,계,12002,6772,2928,1223,1814,640,6605,167,5230
4500,전라북도,남원시다선거구,6450803,4508,남원시,도통동,관내사전투표,3499,3494,1591,615,948,268,3422,72,5
4500,전라북도,남원시다선거구,6450803,4508,남원시,도통동,선거일투표,8503,3278,1337,608,866,372,3183,95,5225
4500,전라북도,남원시다선거구,6450803,4508,남원시,잘못 투입·구분된 투표지,,0,9,4,1,3,1,9,0,-9
4500,전라북도,남원시라선거구,6450804,4508,남원시,검색된 결과가 없습니다.
4500,전라북도,남원시마선거구,6450805,4508,남원시,합계,,6789,4879,1730,1433,1363,4526,353,1910
4500,전라북도,남원시마선거구,6450805,4508,남원시,거소투표,,154,138,64,55,13,132,6,16
4500,전라북도,남원시마선거구,6450805,4508,남원시,관외사전투표,,597,592,250,151,176,577,15,5
4500,전라북도,남원시마선거구,6450805,4508,남원시,주생면,계,1504,996,412,264,252,928,68,508
4500,전라북도,남원시마선거구,6450805,4508,남원시,주생면,관내사전투표,557,556,238,142,149,529,27,1
4500,전라북도,남원시마선거구,6450805,4508,남원시,주생면,선거일투표,947,440,174,122,103,399,41,507
4500,전라북도,남원시마선거구,6450805,4508,남원시,대산면,계,1319,956,635,148,71,854,102,363
4500,전라북도,남원시마선거구,6450805,4508,남원시,대산면,관내사전투표,598,598,382,96,43,521,77,0
4500,전라북도,남원시마선거구,6450805,4508,남원시,대산면,선거일투표,721,358,253,52,28,333,25,363
4500,전라북도,남원시마선거구,6450805,4508,남원시,사매면,계,1251,868,98,332,370,800,68,383
4500,전라북도,남원시마선거구,6450805,4508,남원시,사매면,관내사전투표,500,498,52,164,240,456,42,2
4500,전라북도,남원시마선거구,6450805,4508,남원시,사매면,선거일투표,751,370,46,168,130,344,26,381
4500,전라북도,남원시마선거구,6450805,4508,남원시,덕과면,계,756,516,87,200,204,491,25,240
4500,전라북도,남원시마선거구,6450805,4508,남원시,덕과면,관내사전투표,268,268,48,101,105,254,14,0
4500,전라북도,남원시마선거구,6450805,4508,남원시,덕과면,선거일투표,488,248,39,99,99,237,11,240
4500,전라북도,남원시마선거구,6450805,4508,남원시,보절면,계,1208,805,184,278,274,736,69,403
4500,전라북도,남원시마선거구,6450805,4508,남원시,보절면,관내사전투표,449,449,111,150,146,407,42,0
4500,전라북도,남원시마선거구,6450805,4508,남원시,보절면,선거일투표,759,356,73,128,128,329,27,403
4500,전라북도,남원시마선거구,6450805,4508,남원시,잘못 투입·구분된 투표지,,0,8,0,5,3,8,0,-8
4500,전라북도,남원시바선거구,6450806,4508,남원시,합계,,20065,12268,4998,2568,2173,576,1551,11866,402,7797
4500,전라북도,남원시바선거구,6450806,4508,남원시,거소투표,,52,50,23,8,13,2,1,47,3,2
4500,전라북도,남원시바선거구,6450806,4508,남원시,관외사전투표,,1330,1327,565,248,251,84,130,1278,49,3
4500,전라북도,남원시바선거구,6450806,4508,남원시,동충동,계,2757,1605,600,333,280,66,267,1546,59,1152
4500,전라북도,남원시바선거구,6450806,4508,남원시,동충동,관내사전투표,927,926,329,198,164,37,162,890,36,1
4500,전라북도,남원시바선거구,6450806,4508,남원시,동충동,선거일투표,1830,679,271,135,116,29,105,656,23,1151
4500,전라북도,남원시바선거구,6450806,4508,남원시,죽항동,계,2742,1547,598,324,272,77,221,1492,55,1195
4500,전라북도,남원시바선거구,6450806,4508,남원시,죽항동,관내사전투표,940,939,332,214,188,42,135,911,28,1
4500,전라북도,남원시바선거구,6450806,4508,남원시,죽항동,선거일투표,1802,608,266,110,84,35,86,581,27,1194
4500,전라북도,남원시바선거구,6450806,4508,남원시,노암동,계,4577,2664,1098,446,649,126,257,2576,88,1913
4500,전라북도,남원시바선거구,6450806,4508,남원시,노암동,관내사전투표,1226,1225,465,219,319,64,119,1186,39,1
4500,전라북도,남원시바선거구,6450806,4508,남원시,노암동,선거일투표,3351,1439,633,227,330,62,138,1390,49,1912
4500,전라북도,남원시바선거구,6450806,4508,남원시,금동,계,5169,3061,1247,698,464,146,429,2984,77,2108
4500,전라북도,남원시바선거구,6450806,4508,남원시,금동,관내사전투표,1628,1625,626,375,280,77,229,1587,38,3
4500,전라북도,남원시바선거구,6450806,4508,남원시,금동,선거일투표,3541,1436,621,323,184,69,200,1397,39,2105
4500,전라북도,남원시바선거구,6450806,4508,남원시,왕정동,계,3438,2003,862,510,241,73,246,1932,71,1435
4500,전라북도,남원시바선거구,6450806,4508,남원시,왕정동,관내사전투표,1005,1005,428,261,141,32,109,971,34,0
4500,전라북도,남원시바선거구,6450806,4508,남원시,왕정동,선거일투표,2433,998,434,249,100,41,137,961,37,1435
4500,전라북도,남원시바선거구,6450806,4508,남원시,잘못 투입·구분된 투표지,,0,11,5,1,3,2,0,11,0,-11
4500,전라북도,김제시가선거구,6450901,4509,김제시,합계,,8689,5328,1620,1612,1816,5048,280,3361
4500,전라북도,김제시가선거구,6450901,4509,김제시,거소투표,,35,31,14,7,5,26,5,4
4500,전라북도,김제시가선거구,6450901,4509,김제시,관외사전투표,,613,613,259,195,128,582,31,0
4500,전라북도,김제시가선거구,6450901,4509,김제시,만경읍,계,2308,1467,307,187,897,1391,76,841
4500,전라북도,김제시가선거구,6450901,4509,김제시,만경읍,관내사전투표,760,759,174,93,448,715,44,1
4500,전라북도,김제시가선거구,6450901,4509,김제시,만경읍,선거일투표,1548,708,133,94,449,676,32,840
4500,전라북도,김제시가선거구,6450901,4509,김제시,백산면,계,2066,1171,465,559,86,1110,61,895
4500,전라북도,김제시가선거구,6450901,4509,김제시,백산면,관내사전투표,538,538,209,261,31,501,37,0
4500,전라북도,김제시가선거구,6450901,4509,김제시,백산면,선거일투표,1528,633,256,298,55,609,24,895
4500,전라북도,김제시가선거구,6450901,4509,김제시,공덕면,계,2175,1136,342,377,352,1071,65,1039
4500,전라북도,김제시가선거구,6450901,4509,김제시,공덕면,관내사전투표,503,503,163,161,146,470,33,0
4500,전라북도,김제시가선거구,6450901,4509,김제시,공덕면,선거일투표,1672,633,179,216,206,601,32,1039
4500,전라북도,김제시가선거구,6450901,4509,김제시,청하면,계,1492,908,233,287,346,866,42,584
4500,전라북도,김제시가선거구,6450901,4509,김제시,청하면,관내사전투표,438,438,105,149,164,418,20,0
4500,전라북도,김제시가선거구,6450901,4509,김제시,청하면,선거일투표,1054,470,128,138,182,448,22,584
4500,전라북도,김제시가선거구,6450901,4509,김제시,잘못 투입·구분된 투표지,,0,2,0,0,2,2,0,-2
4500,전라북도,김제시나선거구,6450902,4509,김제시,합계,,8798,5740,2033,1702,1476,262,5473,267,3058
4500,전라북도,김제시나선거구,6450902,4509,김제시,거소투표,,49,46,23,15,6,1,45,1,3
4500,전라북도,김제시나선거구,6450902,4509,김제시,관외사전투표,,799,799,319,232,159,48,758,41,0
4500,전라북도,김제시나선거구,6450902,4509,김제시,죽산면,계,2094,1294,309,835,61,24,1229,65,800
4500,전라북도,김제시나선거구,6450902,4509,김제시,죽산면,관내사전투표,779,779,185,501,28,16,730,49,0
4500,전라북도,김제시나선거구,6450902,4509,김제시,죽산면,선거일투표,1315,515,124,334,33,8,499,16,800
4500,전라북도,김제시나선거구,6450902,4509,김제시,부량면,계,1096,663,246,279,55,42,622,41,433
4500,전라북도,김제시나선거구,6450902,4509,김제시,부량면,관내사전투표,332,332,124,128,25,18,295,37,0
4500,전라북도,김제시나선거구,6450902,4509,김제시,부량면,선거일투표,764,331,122,151,30,24,327,4,433
4500,전라북도,김제시나선거구,6450902,4509,김제시,성덕면,계,1471,926,624,126,116,19,885,41,545
4500,전라북도,김제시나선거구,6450902,4509,김제시,성덕면,관내사전투표,473,473,336,52,45,10,443,30,0
4500,전라북도,김제시나선거구,6450902,4509,김제시,성덕면,선거일투표,998,453,288,74,71,9,442,11,545
4500,전라북도,김제시나선거구,6450902,4509,김제시,진봉면,계,2153,1264,198,87,819,113,1217,47,889
4500,전라북도,김제시나선거구,6450902,4509,김제시,진봉면,관내사전투표,506,506,73,33,329,51,486,20,0
4500,전라북도,김제시나선거구,6450902,4509,김제시,진봉면,선거일투표,1647,758,125,54,490,62,731,27,889
4500,전라북도,김제시나선거구,6450902,4509,김제시,광활면,계,1136,747,314,128,259,15,716,31,389
4500,전라북도,김제시나선거구,6450902,4509,김제시,광활면,관내사전투표,323,323,133,63,100,8,304,19,0
4500,전라북도,김제시나선거구,6450902,4509,김제시,광활면,선거일투표,813,424,181,65,159,7,412,12,389
4500,전라북도,김제시나선거구,6450902,4509,김제시,잘못 투입·구분된 투표지,,0,1,0,0,1,0,1,0,-1
4500,전라북도,김제시다선거구,6450903,4509,김제시,합계,,14919,9031,2950,2115,3676,8741,290,5888
4500,전라북도,김제시다선거구,6450903,4509,김제시,거소투표,,44,40,19,8,9,36,4,4
4500,전라북도,김제시다선거구,6450903,4509,김제시,관외사전투표,,1166,1166,413,280,429,1122,44,0
4500,전라북도,김제시다선거구,6450903,4509,김제시,요촌동,계,8474,4601,1642,1152,1681,4475,126,3873
4500,전라북도,김제시다선거구,6450903,4509,김제시,요촌동,관내사전투표,2054,2054,718,524,751,1993,61,0
4500,전라북도,김제시다선거구,6450903,4509,김제시,요촌동,선거일투표,6420,2547,924,628,930,2482,65,3873
4500,전라북도,김제시다선거구,6450903,4509,김제시,교월동,계,5235,3219,873,674,1556,3103,116,2016
4500,전라북도,김제시다선거구,6450903,4509,김제시,교월동,관내사전투표,1537,1534,414,294,748,1456,78,3
4500,전라북도,김제시다선거구,6450903,4509,김제시,교월동,선거일투표,3698,1685,459,380,808,1647,38,2013
4500,전라북도,김제시다선거구,6450903,4509,김제시,잘못 투입·구분된 투표지,,0,5,3,1,1,5,0,-5
4500,전라북도,김제시라선거구,6450904,4509,김제시,합계,,18985,10901,4326,2477,2670,944,10417,484,8084
4500,전라북도,김제시라선거구,6450904,4509,김제시,거소투표,,51,49,20,10,7,1,38,11,2
4500,전라북도,김제시라선거구,6450904,4509,김제시,관외사전투표,,1512,1511,526,356,404,157,1443,68,1
4500,전라북도,김제시라선거구,6450904,4509,김제시,봉남면,계,1925,1036,455,211,231,90,987,49,889
4500,전라북도,김제시라선거구,6450904,4509,김제시,봉남면,관내사전투표,517,517,234,96,116,40,486,31,0
4500,전라북도,김제시라선거구,6450904,4509,김제시,봉남면,선거일투표,1408,519,221,115,115,50,501,18,889
4500,전라북도,김제시라선거구,6450904,4509,김제시,황산면,계,1710,971,382,224,246,78,930,41,739
4500,전라북도,김제시라선거구,6450904,4509,김제시,황산면,관내사전투표,473,473,191,119,109,25,444,29,0
4500,전라북도,김제시라선거구,6450904,4509,김제시,황산면,선거일투표,1237,498,191,105,137,53,486,12,739
4500,전라북도,김제시라선거구,6450904,4509,김제시,금산면,계,4057,2167,1051,324,400,259,2034,133,1890
4500,전라북도,김제시라선거구,6450904,4509,김제시,금산면,관내사전투표,1217,1214,603,171,222,135,1131,83,3
4500,전라북도,김제시라선거구,6450904,4509,김제시,금산면,선거일투표,2840,953,448,153,178,124,903,50,1887
4500,전라북도,김제시라선거구,6450904,4509,김제시,신풍동,계,9730,5163,1891,1352,1382,359,4984,179,4567
4500,전라북도,김제시라선거구,6450904,4509,김제시,신풍동,관내사전투표,2297,2297,889,575,585,155,2204,93,0
4500,전라북도,김제시라선거구,6450904,4509,김제시,신풍동,선거일투표,7433,2866,1002,777,797,204,2780,86,4567
4500,전라북도,김제시라선거구,6450904,4509,김제시,잘못 투입·구분된 투표지,,0,4,1,0,0,0,1,3,-4
4500,전라북도,김제시마선거구,6450905,4509,김제시,합계,,20967,11668,3470,2892,2057,1878,846,11143,525,9299
4500,전라북도,김제시마선거구,6450905,4509,김제시,거소투표,,162,153,52,42,20,12,8,134,19,9
4500,전라북도,김제시마선거구,6450905,4509,김제시,관외사전투표,,1660,1657,559,391,294,191,121,1556,101,3
4500,전라북도,김제시마선거구,6450905,4509,김제시,용지면,계,2963,1619,314,179,323,650,73,1539,80,1344
4500,전라북도,김제시마선거구,6450905,4509,김제시,용지면,관내사전투표,810,810,162,96,173,286,41,758,52,0
4500,전라북도,김제시마선거구,6450905,4509,김제시,용지면,선거일투표,2153,809,152,83,150,364,32,781,28,1344
4500,전라북도,김제시마선거구,6450905,4509,김제시,백구면,계,3237,1570,535,198,186,522,62,1503,67,1667
4500,전라북도,김제시마선거구,6450905,4509,김제시,백구면,관내사전투표,772,770,280,106,96,224,32,738,32,2
4500,전라북도,김제시마선거구,6450905,4509,김제시,백구면,선거일투표,2465,800,255,92,90,298,30,765,35,1665
4500,전라북도,김제시마선거구,6450905,4509,김제시,금구면,계,4166,2047,556,1098,101,140,81,1976,71,2119
4500,전라북도,김제시마선거구,6450905,4509,김제시,금구면,관내사전투표,894,894,209,515,52,46,41,863,31,0
4500,전라북도,김제시마선거구,6450905,4509,김제시,금구면,선거일투표,3272,1153,347,583,49,94,40,1113,40,2119
4500,전라북도,김제시마선거구,6450905,4509,김제시,검산동,계,8779,4614,1452,982,1133,362,500,4429,185,4165
4500,전라북도,김제시마선거구,6450905,4509,김제시,검산동,관내사전투표,2054,2053,601,501,507,151,219,1979,74,1
4500,전라북도,김제시마선거구,6450905,4509,김제시,검산동,선거일투표,6725,2561,851,481,626,211,281,2450,111,4164
4500,전라북도,김제시마선거구,6450905,4509,김제시,잘못 투입·구분된 투표지,,0,8,2,2,0,1,1,6,2,-8
4500,전라북도,완주군가선거구,6451001,4510,완주군,합계,,24728,12061,3507,4707,3429,11643,418,12667
4500,전라북도,완주군가선거구,6451001,4510,완주군,거소투표,,52,51,15,13,14,42,9,1
4500,전라북도,완주군가선거구,6451001,4510,완주군,관외사전투표,,1789,1786,591,630,506,1727,59,3
4500,전라북도,완주군가선거구,6451001,4510,완주군,삼례읍,계,12237,5788,1864,3049,657,5570,218,6449
4500,전라북도,완주군가선거구,6451001,4510,완주군,삼례읍,관내사전투표,2753,2751,859,1495,285,2639,112,2
4500,전라북도,완주군가선거구,6451001,4510,완주군,삼례읍,선거일투표,9484,3037,1005,1554,372,2931,106,6447
4500,전라북도,완주군가선거구,6451001,4510,완주군,이서면,계,10650,4425,1035,1013,2247,4295,130,6225
4500,전라북도,완주군가선거구,6451001,4510,완주군,이서면,관내사전투표,1591,1588,364,343,829,1536,52,3
4500,전라북도,완주군가선거구,6451001,4510,완주군,이서면,선거일투표,9059,2837,671,670,1418,2759,78,6222
4500,전라북도,완주군가선거구,6451001,4510,완주군,잘못 투입·구분된 투표지,,0,11,2,2,5,9,2,-11
4500,전라북도,완주군나선거구,6451002,4510,완주군,검색된 결과가 없습니다.
4500,전라북도,완주군다선거구,6451003,4510,완주군,합계,,27098,13466,2610,3840,2484,303,2194,1539,12970,496,13632
4500,전라북도,완주군다선거구,6451003,4510,완주군,거소투표,,40,36,7,6,9,4,2,4,32,4,4
4500,전라북도,완주군다선거구,6451003,4510,완주군,관외사전투표,,1786,1782,430,517,312,42,214,183,1698,84,4
4500,전라북도,완주군다선거구,6451003,4510,완주군,봉동읍,계,19417,8664,1729,2907,1284,195,1581,670,8366,298,10753
4500,전라북도,완주군다선거구,6451003,4510,완주군,봉동읍,관내사전투표,3589,3580,628,1248,562,64,656,302,3460,120,9
4500,전라북도,완주군다선거구,6451003,4510,완주군,봉동읍,선거일투표,15828,5084,1101,1659,722,131,925,368,4906,178,10744
4500,전라북도,완주군다선거구,6451003,4510,완주군,용진읍,계,5855,2968,444,404,877,62,394,681,2862,106,2887
4500,전라북도,완주군다선거구,6451003,4510,완주군,용진읍,관내사전투표,1027,1024,131,157,335,10,141,221,995,29,3
4500,전라북도,완주군다선거구,6451003,4510,완주군,용진읍,선거일투표,4828,1944,313,247,542,52,253,460,1867,77,2884
4500,전라북도,완주군다선거구,6451003,4510,완주군,잘못 투입·구분된 투표지,,0,16,0,6,2,0,3,1,12,4,-16
4500,전라북도,완주군라선거구,6451004,4510,완주군,합계,,12033,8323,2466,2966,2460,7892,431,3710
4500,전라북도,완주군라선거구,6451004,4510,완주군,거소투표,,47,41,20,10,9,39,2,6
4500,전라북도,완주군라선거구,6451004,4510,완주군,관외사전투표,,1050,1047,359,332,321,1012,35,3
4500,전라북도,완주군라선거구,6451004,4510,완주군,고산면,계,4041,2755,542,1360,698,2600,155,1286
4500,전라북도,완주군라선거구,6451004,4510,완주군,고산면,관내사전투표,1773,1762,363,851,437,1651,111,11
4500,전라북도,완주군라선거구,6451004,4510,완주군,고산면,선거일투표,2268,993,179,509,261,949,44,1275
4500,전라북도,완주군라선거구,6451004,4510,완주군,비봉면,계,1432,919,200,195,469,864,55,513
4500,전라북도,완주군라선거구,6451004,4510,완주군,비봉면,관내사전투표,471,468,86,107,236,429,39,3
4500,전라북도,완주군라선거구,6451004,4510,완주군,비봉면,선거일투표,961,451,114,88,233,435,16,510
4500,전라북도,완주군라선거구,6451004,4510,완주군,운주면,계,1653,1078,220,417,395,1032,46,575
4500,전라북도,완주군라선거구,6451004,4510,완주군,운주면,관내사전투표,587,586,115,228,212,555,31,1
4500,전라북도,완주군라선거구,6451004,4510,완주군,운주면,선거일투표,1066,492,105,189,183,477,15,574
4500,전라북도,완주군라선거구,6451004,4510,완주군,화산면,계,2101,1293,815,203,209,1227,66,808
4500,전라북도,완주군라선거구,6451004,4510,완주군,화산면,관내사전투표,755,748,457,116,128,701,47,7
4500,전라북도,완주군라선거구,6451004,4510,완주군,화산면,선거일투표,1346,545,358,87,81,526,19,801
4500,전라북도,완주군라선거구,6451004,4510,완주군,동상면,계,776,484,123,206,126,455,29,292
4500,전라북도,완주군라선거구,6451004,4510,완주군,동상면,관내사전투표,319,318,75,143,75,293,25,1
4500,전라북도,완주군라선거구,6451004,4510,완주군,동상면,선거일투표,457,166,48,63,51,162,4,291
4500,전라북도,완주군라선거구,6451004,4510,완주군,경천면,계,933,681,182,236,225,643,38,252
4500,전라북도,완주군라선거구,6451004,4510,완주군,경천면,관내사전투표,466,465,113,164,161,438,27,1
4500,전라북도,완주군라선거구,6451004,4510,완주군,경천면,선거일투표,467,216,69,72,64,205,11,251
4500,전라북도,완주군라선거구,6451004,4510,완주군,잘못 투입·구분된 투표지,,0,25,5,7,8,20,5,-25
4500,전라북도,진안군가선거구,6451101,4511,진안군,합계,,13894,10053,2603,1319,1753,156,1779,2130,9740,313,3841
4500,전라북도,진안군가선거구,6451101,4511,진안군,거소투표,,53,47,19,2,12,1,4,4,42,5,6
4500,전라북도,진안군가선거구,6451101,4511,진안군,관외사전투표,,1327,1326,422,212,221,23,191,224,1293,33,1
4500,전라북도,진안군가선거구,6451101,4511,진안군,진안읍,계,7921,5523,1416,693,593,79,1283,1314,5378,145,2398
4500,전라북도,진안군가선거구,6451101,4511,진안군,진안읍,관내사전투표,3027,3027,794,407,368,41,677,657,2944,83,0
4500,전라북도,진안군가선거구,6451101,4511,진안군,진안읍,선거일투표,4894,2496,622,286,225,38,606,657,2434,62,2398
4500,전라북도,진안군가선거구,6451101,4511,진안군,백운면,계,1628,1123,227,151,371,11,87,217,1064,59,505
4500,전라북도,진안군가선거구,6451101,4511,진안군,백운면,관내사전투표,714,714,141,99,250,6,57,118,671,43,0
4500,전라북도,진안군가선거구,6451101,4511,진안군,백운면,선거일투표,914,409,86,52,121,5,30,99,393,16,505
4500,전라북도,진안군가선거구,6451101,4511,진안군,성수면,계,1434,987,224,152,351,18,67,134,946,41,447
4500,전라북도,진안군가선거구,6451101,4511,진안군,성수면,관내사전투표,545,545,131,58,212,11,37,73,522,23,0
4500,전라북도,진안군가선거구,6451101,4511,진안군,성수면,선거일투표,889,442,93,94,139,7,30,61,424,18,447
4500,전라북도,진안군가선거구,6451101,4511,진안군,마령면,계,1531,1043,293,109,204,24,147,236,1013,30,488
4500,전라북도,진안군가선거구,6451101,4511,진안군,마령면,관내사전투표,542,542,156,57,125,7,69,107,521,21,0
4500,전라북도,진안군가선거구,6451101,4511,진안군,마령면,선거일투표,989,501,137,52,79,17,78,129,492,9,488
4500,전라북도,진안군가선거구,6451101,4511,진안군,잘못 투입·구분된 투표지,,0,4,2,0,1,0,0,1,4,0,-4
4500,전라북도,진안군나선거구,6451102,4511,진안군,합계,,8740,6562,1327,1134,497,644,857,1316,541,6316,246,2178
4500,전라북도,진안군나선거구,6451102,4511,진안군,거소투표,,26,24,5,1,3,0,2,10,1,22,2,2
4500,전라북도,진안군나선거구,6451102,4511,진안군,관외사전투표,,893,889,221,125,94,106,87,181,47,861,28,4
4500,전라북도,진안군나선거구,6451102,4511,진안군,용담면,계,748,523,145,122,14,35,55,86,44,501,22,225
4500,전라북도,진안군나선거구,6451102,4511,진안군,용담면,관내사전투표,254,254,84,58,8,14,26,36,20,246,8,0
4500,전라북도,진안군나선거구,6451102,4511,진안군,용담면,선거일투표,494,269,61,64,6,21,29,50,24,255,14,225
4500,전라북도,진안군나선거구,6451102,4511,진안군,안천면,계,896,654,203,115,36,59,133,45,30,621,33,242
4500,전라북도,진안군나선거구,6451102,4511,진안군,안천면,관내사전투표,342,342,101,59,22,34,71,20,18,325,17,0
4500,전라북도,진안군나선거구,6451102,4511,진안군,안천면,선거일투표,554,312,102,56,14,25,62,25,12,296,16,242
4500,전라북도,진안군나선거구,6451102,4511,진안군,동향면,계,1139,852,175,94,24,35,444,28,17,817,35,287
4500,전라북도,진안군나선거구,6451102,4511,진안군,동향면,관내사전투표,456,455,96,52,13,18,240,10,9,438,17,1
4500,전라북도,진안군나선거구,6451102,4511,진안군,동향면,선거일투표,683,397,79,42,11,17,204,18,8,379,18,286
4500,전라북도,진안군나선거구,6451102,4511,진안군,상전면,계,659,450,103,151,34,43,36,48,18,433,17,209
4500,전라북도,진안군나선거구,6451102,4511,진안군,상전면,관내사전투표,240,240,57,74,18,22,19,30,10,230,10,0
4500,전라북도,진안군나선거구,6451102,4511,진안군,상전면,선거일투표,419,210,46,77,16,21,17,18,8,203,7,209
4500,전라북도,진안군나선거구,6451102,4511,진안군,부귀면,계,2219,1548,290,51,219,342,46,539,8,1495,53,671
4500,전라북도,진안군나선거구,6451102,4511,진안군,부귀면,관내사전투표,751,750,142,17,88,160,25,286,6,724,26,1
4500,전라북도,진안군나선거구,6451102,4511,진안군,부귀면,선거일투표,1468,798,148,34,131,182,21,253,2,771,27,670
4500,전라북도,진안군나선거구,6451102,4511,진안군,정천면,계,836,619,128,78,52,11,29,287,16,601,18,217
4500,전라북도,진안군나선거구,6451102,4511,진안군,정천면,관내사전투표,321,320,57,42,23,8,19,150,11,310,10,1
4500,전라북도,진안군나선거구,6451102,4511,진안군,정천면,선거일투표,515,299,71,36,29,3,10,137,5,291,8,216
4500,전라북도,진안군나선거구,6451102,4511,진안군,주천면,계,1324,989,55,394,20,13,24,89,358,953,36,335
4500,전라북도,진안군나선거구,6451102,4511,진안군,주천면,관내사전투표,606,598,28,240,12,7,14,54,224,579,19,8
4500,전라북도,진안군나선거구,6451102,4511,진안군,주천면,선거일투표,718,391,27,154,8,6,10,35,134,374,17,327
4500,전라북도,진안군나선거구,6451102,4511,진안군,잘못 투입·구분된 투표지,,0,14,2,3,1,0,1,3,2,12,2,-14
4500,전라북도,무주군가선거구,6451201,4512,무주군,합계,,11738,8930,1953,1565,1727,2078,1281,8604,326,2808
4500,전라북도,무주군가선거구,6451201,4512,무주군,거소투표,,136,124,18,25,24,37,10,114,10,12
4500,전라북도,무주군가선거구,6451201,4512,무주군,관외사전투표,,776,776,214,127,169,177,68,755,21,0
4500,전라북도,무주군가선거구,6451201,4512,무주군,무주읍,계,7367,5452,1393,525,1144,1360,891,5313,139,1915
4500,전라북도,무주군가선거구,6451201,4512,무주군,무주읍,관내사전투표,3376,3375,909,337,702,827,517,3292,83,1
4500,전라북도,무주군가선거구,6451201,4512,무주군,무주읍,선거일투표,3991,2077,484,188,442,533,374,2021,56,1914
4500,전라북도,무주군가선거구,6451201,4512,무주군,적상면,계,2253,1667,187,770,229,251,122,1559,108,586
4500,전라북도,무주군가선거구,6451201,4512,무주군,적상면,관내사전투표,844,844,90,413,98,130,57,788,56,0
4500,전라북도,무주군가선거구,6451201,4512,무주군,적상면,선거일투표,1409,823,97,357,131,121,65,771,52,586
4500,전라북도,무주군가선거구,6451201,4512,무주군,부남면,계,1206,910,141,118,161,253,190,863,47,296
4500,전라북도,무주군가선거구,6451201,4512,무주군,부남면,관내사전투표,632,632,91,82,116,175,138,602,30,0
4500,전라북도,무주군가선거구,6451201,4512,무주군,부남면,선거일투표,574,278,50,36,45,78,52,261,17,296
4500,전라북도,무주군가선거구,6451201,4512,무주군,잘못 투입·구분된 투표지,,0,1,0,0,0,0,0,0,1,-1
4500,전라북도,무주군나선거구,6451202,4512,무주군,합계,,9541,7336,1500,972,1154,1843,585,1010,7064,272,2205
4500,전라북도,무주군나선거구,6451202,4512,무주군,거소투표,,126,114,25,18,23,22,14,11,113,1,12
4500,전라북도,무주군나선거구,6451202,4512,무주군,관외사전투표,,764,764,184,67,172,188,39,95,745,19,0
4500,전라북도,무주군나선거구,6451202,4512,무주군,무풍면,계,1856,1431,359,39,248,181,277,270,1374,57,425
4500,전라북도,무주군나선거구,6451202,4512,무주군,무풍면,관내사전투표,817,816,181,23,144,100,162,169,779,37,1
4500,전라북도,무주군나선거구,6451202,4512,무주군,무풍면,선거일투표,1039,615,178,16,104,81,115,101,595,20,424
4500,전라북도,무주군나선거구,6451202,4512,무주군,설천면,계,3211,2359,690,56,572,147,220,582,2267,92,852
4500,전라북도,무주군나선거구,6451202,4512,무주군,설천면,관내사전투표,1254,1253,346,32,303,79,145,301,1206,47,1
4500,전라북도,무주군나선거구,6451202,4512,무주군,설천면,선거일투표,1957,1106,344,24,269,68,75,281,1061,45,851
4500,전라북도,무주군나선거구,6451202,4512,무주군,안성면,계,3584,2668,242,792,139,1305,35,52,2565,103,916
4500,전라북도,무주군나선거구,6451202,4512,무주군,안성면,관내사전투표,1643,1643,158,490,77,803,20,36,1584,59,0
4500,전라북도,무주군나선거구,6451202,4512,무주군,안성면,선거일투표,1941,1025,84,302,62,502,15,16,981,44,916
4500,전라북도,무주군나선거구,6451202,4512,무주군,잘못 투입·구분된 투표지,,0,0,0,0,0,0,0,0,0,0,0
4500,전라북도,장수군가선거구,6451301,4513,장수군,합계,,10190,7651,2577,1786,1956,1008,7327,324,2539
4500,전라북도,장수군가선거구,6451301,4513,장수군,거소투표,,68,61,21,17,10,7,55,6,7
4500,전라북도,장수군가선거구,6451301,4513,장수군,관외사전투표,,785,783,311,179,140,130,760,23,2
4500,전라북도,장수군가선거구,6451301,4513,장수군,장수읍,계,5626,4151,1892,594,766,711,3963,188,1475
4500,전라북도,장수군가선거구,6451301,4513,장수군,장수읍,관내사전투표,2087,2087,932,304,381,373,1990,97,0
4500,전라북도,장수군가선거구,6451301,4513,장수군,장수읍,선거일투표,3539,2064,960,290,385,338,1973,91,1475
4500,전라북도,장수군가선거구,6451301,4513,장수군,산서면,계,1725,1260,141,914,77,75,1207,53,465
4500,전라북도,장수군가선거구,6451301,4513,장수군,산서면,관내사전투표,759,758,95,546,43,49,733,25,1
4500,전라북도,장수군가선거구,6451301,4513,장수군,산서면,선거일투표,966,502,46,368,34,26,474,28,464
4500,전라북도,장수군가선거구,6451301,4513,장수군,번암면,계,1986,1394,212,81,962,85,1340,54,592
4500,전라북도,장수군가선거구,6451301,4513,장수군,번암면,관내사전투표,825,825,118,47,574,48,787,38,0
4500,전라북도,장수군가선거구,6451301,4513,장수군,번암면,선거일투표,1161,569,94,34,388,37,553,16,592
4500,전라북도,장수군가선거구,6451301,4513,장수군,잘못 투입·구분된 투표지,,0,2,0,1,1,0,2,0,-2
4500,전라북도,장수군나선거구,6451302,4513,장수군,합계,,9190,6939,2088,1656,845,876,1218,6683,256,2251
4500,전라북도,장수군나선거구,6451302,4513,장수군,거소투표,,30,30,9,10,5,4,2,30,0,0
4500,전라북도,장수군나선거구,6451302,4513,장수군,관외사전투표,,736,734,268,156,88,75,125,712,22,2
4500,전라북도,장수군나선거구,6451302,4513,장수군,장계면,계,3621,2694,817,628,321,626,223,2615,79,927
4500,전라북도,장수군나선거구,6451302,4513,장수군,장계면,관내사전투표,1464,1461,460,371,178,314,96,1419,42,3
4500,전라북도,장수군나선거구,6451302,4513,장수군,장계면,선거일투표,2157,1233,357,257,143,312,127,1196,37,924
4500,전라북도,장수군나선거구,6451302,4513,장수군,천천면,계,1756,1229,185,118,94,57,703,1157,72,527
4500,전라북도,장수군나선거구,6451302,4513,장수군,천천면,관내사전투표,584,584,88,53,46,17,348,552,32,0
4500,전라북도,장수군나선거구,6451302,4513,장수군,천천면,선거일투표,1172,645,97,65,48,40,355,605,40,527
4500,전라북도,장수군나선거구,6451302,4513,장수군,계남면,계,1723,1267,236,670,133,59,117,1215,52,456
4500,전라북도,장수군나선거구,6451302,4513,장수군,계남면,관내사전투표,715,714,134,385,72,30,68,689,25,1
4500,전라북도,장수군나선거구,6451302,4513,장수군,계남면,선거일투표,1008,553,102,285,61,29,49,526,27,455
4500,전라북도,장수군나선거구,6451302,4513,장수군,계북면,계,1324,979,571,73,203,54,48,949,30,345
4500,전라북도,장수군나선거구,6451302,4513,장수군,계북면,관내사전투표,514,514,305,37,106,26,27,501,13,0
4500,전라북도,장수군나선거구,6451302,4513,장수군,계북면,선거일투표,810,465,266,36,97,28,21,448,17,345
4500,전라북도,장수군나선거구,6451302,4513,장수군,잘못 투입·구분된 투표지,,0,6,2,1,1,1,0,5,1,-6
4500,전라북도,임실군가선거구,6451401,4514,임실군,합계,,7621,5508,1535,865,1167,551,1193,5311,197,2113
4500,전라북도,임실군가선거구,6451401,4514,임실군,거소투표,,35,34,11,3,5,4,11,34,0,1
4500,전라북도,임실군가선거구,6451401,4514,임실군,관외사전투표,,747,747,263,131,135,82,112,723,24,0
4500,전라북도,임실군가선거구,6451401,4514,임실군,임실읍,계,5538,3803,966,430,871,419,979,3665,138,1735
4500,전라북도,임실군가선거구,6451401,4514,임실군,임실읍,관내사전투표,2154,2152,593,245,492,224,528,2082,70,2
4500,전라북도,임실군가선거구,6451401,4514,임실군,임실읍,선거일투표,3384,1651,373,185,379,195,451,1583,68,1733
4500,전라북도,임실군가선거구,6451401,4514,임실군,성수면,계,1301,921,295,301,154,46,90,886,35,380
4500,전라북도,임실군가선거구,6451401,4514,임실군,성수면,관내사전투표,510,510,174,159,83,24,53,493,17,0
4500,전라북도,임실군가선거구,6451401,4514,임실군,성수면,선거일투표,791,411,121,142,71,22,37,393,18,380
4500,전라북도,임실군가선거구,6451401,4514,임실군,잘못 투입·구분된 투표지,,0,3,0,0,2,0,1,3,0,-3
4500,전라북도,임실군나선거구,6451402,4514,임실군,합계,,7051,5131,1115,1764,2014,4893,238,1920
4500,전라북도,임실군나선거구,6451402,4514,임실군,거소투표,,34,33,10,17,4,31,2,1
4500,전라북도,임실군나선거구,6451402,4514,임실군,관외사전투표,,801,801,213,322,248,783,18,0
4500,전라북도,임실군나선거구,6451402,4514,임실군,운암면,계,1232,800,209,332,210,751,49,432
4500,전라북도,임실군나선거구,6451402,4514,임실군,운암면,관내사전투표,249,249,71,93,69,233,16,0
4500,전라북도,임실군나선거구,6451402,4514,임실군,운암면,선거일투표,983,551,138,239,141,518,33,432
4500,전라북도,임실군나선거구,6451402,4514,임실군,신평면,계,1088,732,155,194,337,686,46,356
4500,전라북도,임실군나선거구,6451402,4514,임실군,신평면,관내사전투표,406,406,82,110,184,376,30,0
4500,전라북도,임실군나선거구,6451402,4514,임실군,신평면,선거일투표,682,326,73,84,153,310,16,356
4500,전라북도,임실군나선거구,6451402,4514,임실군,신덕면,계,1021,667,159,208,269,636,31,354
4500,전라북도,임실군나선거구,6451402,4514,임실군,신덕면,관내사전투표,336,336,79,104,135,318,18,0
4500,전라북도,임실군나선거구,6451402,4514,임실군,신덕면,선거일투표,685,331,80,104,134,318,13,354
4500,전라북도,임실군나선거구,6451402,4514,임실군,관촌면,계,2875,2096,369,691,944,2004,92,779
4500,전라북도,임실군나선거구,6451402,4514,임실군,관촌면,관내사전투표,1269,1268,206,442,572,1220,48,1
4500,전라북도,임실군나선거구,6451402,4514,임실군,관촌면,선거일투표,1606,828,163,249,372,784,44,778
4500,전라북도,임실군나선거구,6451402,4514,임실군,잘못 투입·구분된 투표지,,0,2,0,0,2,2,0,-2
4500,전라북도,임실군다선거구,6451403,4514,임실군,합계,,9674,6999,1683,1587,1101,910,1252,185,6718,281,2675
4500,전라북도,임실군다선거구,6451403,4514,임실군,거소투표,,51,49,16,13,6,4,6,2,47,2,2
4500,전라북도,임실군다선거구,6451403,4514,임실군,관외사전투표,,925,925,295,192,151,66,172,22,898,27,0
4500,전라북도,임실군다선거구,6451403,4514,임실군,청웅면,계,1093,777,450,37,25,29,182,16,739,38,316
4500,전라북도,임실군다선거구,6451403,4514,임실군,청웅면,관내사전투표,408,408,247,19,11,18,82,6,383,25,0
4500,전라북도,임실군다선거구,6451403,4514,임실군,청웅면,선거일투표,685,369,203,18,14,11,100,10,356,13,316
4500,전라북도,임실군다선거구,6451403,4514,임실군,오수면,계,3106,2179,213,767,444,497,90,72,2083,96,927
4500,전라북도,임실군다선거구,6451403,4514,임실군,오수면,관내사전투표,1266,1266,124,439,270,279,49,42,1203,63,0
4500,전라북도,임실군다선거구,6451403,4514,임실군,오수면,선거일투표,1840,913,89,328,174,218,41,30,880,33,927
4500,전라북도,임실군다선거구,6451403,4514,임실군,삼계면,계,1200,793,105,181,315,88,62,14,765,28,407
4500,전라북도,임실군다선거구,6451403,4514,임실군,삼계면,관내사전투표,391,390,50,85,164,42,27,5,373,17,1
4500,전라북도,임실군다선거구,6451403,4514,임실군,삼계면,선거일투표,809,403,55,96,151,46,35,9,392,11,406
4500,전라북도,임실군다선거구,6451403,4514,임실군,강진면,계,1330,923,270,58,26,46,460,22,882,41,407
4500,전라북도,임실군다선거구,6451403,4514,임실군,강진면,관내사전투표,560,560,156,41,19,32,270,17,535,25,0
4500,전라북도,임실군다선거구,6451403,4514,임실군,강진면,선거일투표,770,363,114,17,7,14,190,5,347,16,407
4500,전라북도,임실군다선거구,6451403,4514,임실군,덕치면,계,967,655,227,66,20,39,250,19,621,34,312
4500,전라북도,임실군다선거구,6451403,4514,임실군,덕치면,관내사전투표,315,315,95,29,9,21,137,8,299,16,0
4500,전라북도,임실군다선거구,6451403,4514,임실군,덕치면,선거일투표,652,340,132,37,11,18,113,11,322,18,312
4500,전라북도,임실군다선거구,6451403,4514,임실군,지사면,계,1002,694,107,272,113,139,30,18,679,15,308
4500,전라북도,임실군다선거구,6451403,4514,임실군,지사면,관내사전투표,383,380,52,170,67,57,16,9,371,9,3
4500,전라북도,임실군다선거구,6451403,4514,임실군,지사면,선거일투표,619,314,55,102,46,82,14,9,308,6,305
4500,전라북도,임실군다선거구,6451403,4514,임실군,잘못 투입·구분된 투표지,,0,4,0,1,1,2,0,0,4,0,-4
4500,전라북도,순창군가선거구,6451501,4515,순창군,검색된 결과가 없습니다.
4500,전라북도,순창군나선거구,6451502,4515,순창군,검색된 결과가 없습니다.
4500,전라북도,순창군다선거구,6451503,4515,순창군,합계,,10309,7988,2554,1497,1350,1122,1066,7589,399,2321
4500,전라북도,순창군다선거구,6451503,4515,순창군,거소투표,,132,127,48,17,32,10,10,117,10,5
4500,전라북도,순창군다선거구,6451503,4515,순창군,관외사전투표,,1079,1079,456,134,186,137,121,1034,45,0
4500,전라북도,순창군다선거구,6451503,4515,순창군,풍산면,계,1289,904,394,144,202,61,70,871,33,385
4500,전라북도,순창군다선거구,6451503,4515,순창군,풍산면,관내사전투표,517,511,246,81,120,26,22,495,16,6
4500,전라북도,순창군다선거구,6451503,4515,순창군,풍산면,선거일투표,772,393,148,63,82,35,48,376,17,379
4500,전라북도,순창군다선거구,6451503,4515,순창군,금과면,계,1463,1060,379,216,176,118,114,1003,57,403
4500,전라북도,순창군다선거구,6451503,4515,순창군,금과면,관내사전투표,714,710,251,141,121,89,72,674,36,4
4500,전라북도,순창군다선거구,6451503,4515,순창군,금과면,선거일투표,749,350,128,75,55,29,42,329,21,399
4500,전라북도,순창군다선거구,6451503,4515,순창군,팔덕면,계,1124,815,309,78,167,101,106,761,54,309
4500,전라북도,순창군다선거구,6451503,4515,순창군,팔덕면,관내사전투표,529,524,190,47,120,67,61,485,39,5
4500,전라북도,순창군다선거구,6451503,4515,순창군,팔덕면,선거일투표,595,291,119,31,47,34,45,276,15,304
4500,전라북도,순창군다선거구,6451503,4515,순창군,복흥면,계,1772,1350,113,783,306,43,52,1297,53,422
4500,전라북도,순창군다선거구,6451503,4515,순창군,복흥면,관내사전투표,720,720,60,421,153,26,29,689,31,0
4500,전라북도,순창군다선거구,6451503,4515,순창군,복흥면,선거일투표,1052,630,53,362,153,17,23,608,22,422
4500,전라북도,순창군다선거구,6451503,4515,순창군,쌍치면,계,1595,1220,521,29,91,36,487,1164,56,375
4500,전라북도,순창군다선거구,6451503,4515,순창군,쌍치면,관내사전투표,785,781,341,21,55,18,311,746,35,4
4500,전라북도,순창군다선거구,6451503,4515,순창군,쌍치면,선거일투표,810,439,180,8,36,18,176,418,21,371
4500,전라북도,순창군다선거구,6451503,4515,순창군,구림면,계,1855,1412,322,95,187,615,102,1321,91,443
4500,전라북도,순창군다선거구,6451503,4515,순창군,구림면,관내사전투표,785,785,200,59,91,318,53,721,64,0
4500,전라북도,순창군다선거구,6451503,4515,순창군,구림면,선거일투표,1070,627,122,36,96,297,49,600,27,443
4500,전라북도,순창군다선거구,6451503,4515,순창군,잘못 투입·구분된 투표지,,0,21,12,1,3,1,4,21,0,-21
4500,전라북도,고창군가선거구,6451601,4516,고창군,합계,,21458,15863,3910,3360,3166,3120,1757,15313,550,5595
4500,전라북도,고창군가선거구,6451601,4516,고창군,거소투표,,112,104,26,32,11,23,9,101,3,8
4500,전라북도,고창군가선거구,6451601,4516,고창군,관외사전투표,,2142,2142,621,448,444,389,167,2069,73,0
4500,전라북도,고창군가선거구,6451601,4516,고창군,고창읍,계,14945,10468,2656,2061,2275,2278,869,10139,329,4477
4500,전라북도,고창군가선거구,6451601,4516,고창군,고창읍,관내사전투표,5087,5087,1344,987,1131,1081,388,4931,156,0
4500,전라북도,고창군가선거구,6451601,4516,고창군,고창읍,선거일투표,9858,5381,1312,1074,1144,1197,481,5208,173,4477
4500,전라북도,고창군가선거구,6451601,4516,고창군,고수면,계,2286,1693,376,158,211,233,644,1622,71,593
4500,전라북도,고창군가선거구,6451601,4516,고창군,고수면,관내사전투표,1121,1119,262,116,152,170,371,1071,48,2
4500,전라북도,고창군가선거구,6451601,4516,고창군,고수면,선거일투표,1165,574,114,42,59,63,273,551,23,591
4500,전라북도,고창군가선거구,6451601,4516,고창군,신림면,계,1973,1451,229,660,225,197,68,1379,72,522
4500,전라북도,고창군가선거구,6451601,4516,고창군,신림면,관내사전투표,1026,1026,162,450,169,140,46,967,59,0
4500,전라북도,고창군가선거구,6451601,4516,고창군,신림면,선거일투표,947,425,67,210,56,57,22,412,13,522
4500,전라북도,고창군가선거구,6451601,4516,고창군,잘못 투입·구분된 투표지,,0,5,2,1,0,0,0,3,2,-5
4500,전라북도,고창군나선거구,6451602,4516,고창군,합계,,9481,6991,1998,1156,1306,738,1470,6668,323,2490
4500,전라북도,고창군나선거구,6451602,4516,고창군,거소투표,,85,77,16,12,7,6,32,73,4,8
4500,전라북도,고창군나선거구,6451602,4516,고창군,관외사전투표,,706,706,263,127,86,75,134,685,21,0
4500,전라북도,고창군나선거구,6451602,4516,고창군,심원면,계,2118,1587,985,148,124,50,205,1512,75,531
4500,전라북도,고창군나선거구,6451602,4516,고창군,심원면,관내사전투표,911,911,568,87,63,27,117,862,49,0
4500,전라북도,고창군나선거구,6451602,4516,고창군,심원면,선거일투표,1207,676,417,61,61,23,88,650,26,531
4500,전라북도,고창군나선거구,6451602,4516,고창군,흥덕면,계,2710,1880,304,150,199,450,685,1788,92,830
4500,전라북도,고창군나선거구,6451602,4516,고창군,흥덕면,관내사전투표,986,985,142,79,95,245,371,932,53,1
4500,전라북도,고창군나선거구,6451602,4516,고창군,흥덕면,선거일투표,1724,895,162,71,104,205,314,856,39,829
4500,전라북도,고창군나선거구,6451602,4516,고창군,성내면,계,1644,1147,145,507,209,78,161,1100,47,497
4500,전라북도,고창군나선거구,6451602,4516,고창군,성내면,관내사전투표,734,734,87,317,150,44,100,698,36,0
4500,전라북도,고창군나선거구,6451602,4516,고창군,성내면,선거일투표,910,413,58,190,59,34,61,402,11,497
4500,전라북도,고창군나선거구,6451602,4516,고창군,부안면,계,2218,1592,285,212,681,79,251,1508,84,626
4500,전라북도,고창군나선거구,6451602,4516,고창군,부안면,관내사전투표,852,852,153,114,349,38,139,793,59,0
4500,전라북도,고창군나선거구,6451602,4516,고창군,부안면,선거일투표,1366,740,132,98,332,41,112,715,25,626
4500,전라북도,고창군나선거구,6451602,4516,고창군,잘못 투입·구분된 투표지,,0,2,0,0,0,0,2,2,0,-2
4500,전라북도,고창군다선거구,6451603,4516,고창군,검색된 결과가 없습니다.
4500,전라북도,고창군라선거구,6451604,4516,고창군,검색된 결과가 없습니다.
4500,전라북도,부안군가선거구,6451701,4517,부안군,합계,,19508,11965,3652,3094,2433,629,1140,606,11554,411,7543
4500,전라북도,부안군가선거구,6451701,4517,부안군,거소투표,,58,53,17,10,16,3,2,2,50,3,5
4500,전라북도,부안군가선거구,6451701,4517,부안군,관외사전투표,,1683,1681,570,466,302,98,116,72,1624,57,2
4500,전라북도,부안군가선거구,6451701,4517,부안군,부안읍,계,15163,8430,2384,2235,1772,468,840,457,8156,274,6733
4500,전라북도,부안군가선거구,6451701,4517,부안군,부안읍,관내사전투표,4310,4308,1216,1173,932,208,407,216,4152,156,2
4500,전라북도,부안군가선거구,6451701,4517,부안군,부안읍,선거일투표,10853,4122,1168,1062,840,260,433,241,4004,118,6731
4500,전라북도,부안군가선거구,6451701,4517,부안군,행안면,계,2604,1796,679,380,343,60,182,75,1719,77,808
4500,전라북도,부안군가선거구,6451701,4517,부안군,행안면,관내사전투표,1267,1267,477,289,250,32,122,52,1222,45,0
4500,전라북도,부안군가선거구,6451701,4517,부안군,행안면,선거일투표,1337,529,202,91,93,28,60,23,497,32,808
4500,전라북도,부안군가선거구,6451701,4517,부안군,잘못 투입·구분된 투표지,,0,5,2,3,0,0,0,0,5,0,-5
4500,전라북도,부안군나선거구,6451702,4517,부안군,검색된 결과가 없습니다.
4500,전라북도,부안군다선거구,6451703,4517,부안군,검색된 결과가 없습니다.
4500,전라북도,부안군라선거구,6451704,4517,부안군,합계,,8777,5340,2375,1855,807,5037,303,3437
4500,전라북도,부안군라선거구,6451704,4517,부안군,거소투표,,29,26,12,6,5,23,3,3
4500,전라북도,부안군라선거구,6451704,4517,부안군,관외사전투표,,643,642,266,226,113,605,37,1
4500,전라북도,부안군라선거구,6451704,4517,부안군,보안면,계,2051,1235,219,784,162,1165,70,816
4500,전라북도,부안군라선거구,6451704,4517,부안군,보안면,관내사전투표,670,670,116,422,81,619,51,0
4500,전라북도,부안군라선거구,6451704,4517,부안군,보안면,선거일투표,1381,565,103,362,81,546,19,816
4500,전라북도,부안군라선거구,6451704,4517,부안군,진서면,계,1994,1126,566,311,186,1063,63,868
4500,전라북도,부안군라선거구,6451704,4517,부안군,진서면,관내사전투표,550,550,265,165,86,516,34,0
4500,전라북도,부안군라선거구,6451704,4517,부안군,진서면,선거일투표,1444,576,301,146,100,547,29,868
4500,전라북도,부안군라선거구,6451704,4517,부안군,상서면,계,1797,938,388,324,172,884,54,859
4500,전라북도,부안군라선거구,6451704,4517,부안군,상서면,관내사전투표,496,495,188,171,96,455,40,1
4500,전라북도,부안군라선거구,6451704,4517,부안군,상서면,선거일투표,1301,443,200,153,76,429,14,858
4500,전라북도,부안군라선거구,6451704,4517,부안군,줄포면,계,2263,1372,924,203,169,1296,76,891
4500,전라북도,부안군라선거구,6451704,4517,부안군,줄포면,관내사전투표,700,700,458,114,79,651,49,0
4500,전라북도,부안군라선거구,6451704,4517,부안군,줄포면,선거일투표,1563,672,466,89,90,645,27,891
4500,전라북도,부안군라선거구,6451704,4517,부안군,잘못 투입·구분된 투표지,,0,1,0,1,0,1,0,-14600,전라남도,목포시가선거구,6460101,4601,목포시,합계,,23025,12309,3212,2805,2616,810,1193,1081,11717,592,10716
4600,전라남도,목포시가선거구,6460101,4601,목포시,거소투표,,85,77,24,27,4,2,9,5,71,6,8
4600,전라남도,목포시가선거구,6460101,4601,목포시,관외사전투표,,1462,1462,424,333,267,107,129,133,1393,69,0
4600,전라남도,목포시가선거구,6460101,4601,목포시,용당1동,계,8546,4168,1278,965,800,199,384,354,3980,188,4378
4600,전라남도,목포시가선거구,6460101,4601,목포시,용당1동,관내사전투표,2114,2113,641,518,392,101,212,160,2024,89,1
4600,전라남도,목포시가선거구,6460101,4601,목포시,용당1동,선거일투표,6432,2055,637,447,408,98,172,194,1956,99,4377
4600,전라남도,목포시가선거구,6460101,4601,목포시,용당2동,계,4354,2271,510,696,417,113,241,183,2160,111,2083
4600,전라남도,목포시가선거구,6460101,4601,목포시,용당2동,관내사전투표,1289,1287,254,416,242,52,146,109,1219,68,2
4600,전라남도,목포시가선거구,6460101,4601,목포시,용당2동,선거일투표,3065,984,256,280,175,61,95,74,941,43,2081
4600,전라남도,목포시가선거구,6460101,4601,목포시,연동,계,3809,1825,393,329,604,120,153,122,1721,104,1984
4600,전라남도,목포시가선거구,6460101,4601,목포시,연동,관내사전투표,953,953,174,166,337,60,85,64,886,67,0
4600,전라남도,목포시가선거구,6460101,4601,목포시,연동,선거일투표,2856,872,219,163,267,60,68,58,835,37,1984
4600,전라남도,목포시가선거구,6460101,4601,목포시,삼학동,계,4769,2504,583,454,524,269,277,284,2391,113,2265
4600,전라남도,목포시가선거구,6460101,4601,목포시,삼학동,관내사전투표,1354,1354,301,237,301,143,161,151,1294,60,0
4600,전라남도,목포시가선거구,6460101,4601,목포시,삼학동,선거일투표,3415,1150,282,217,223,126,116,133,1097,53,2265
4600,전라남도,목포시가선거구,6460101,4601,목포시,잘못 투입·구분된 투표지,,0,2,0,1,0,0,0,0,1,1,-2
4600,전라남도,목포시나선거구,6460102,4601,목포시,합계,,18852,9505,2469,2427,1861,2394,9151,354,9347
4600,전라남도,목포시나선거구,6460102,4601,목포시,거소투표,,89,82,27,22,16,11,76,6,7
4600,전라남도,목포시나선거구,6460102,4601,목포시,관외사전투표,,1702,1698,478,441,298,417,1634,64,4
4600,전라남도,목포시나선거구,6460102,4601,목포시,이로동,계,7771,4094,920,864,1031,1148,3963,131,3677
4600,전라남도,목포시나선거구,6460102,4601,목포시,이로동,관내사전투표,1806,1801,380,387,408,560,1735,66,5
4600,전라남도,목포시나선거구,6460102,4601,목포시,이로동,선거일투표,5965,2293,540,477,623,588,2228,65,3672
4600,전라남도,목포시나선거구,6460102,4601,목포시,하당동,계,9290,3611,1042,1096,513,809,3460,151,5679
4600,전라남도,목포시나선거구,6460102,4601,목포시,하당동,관내사전투표,1614,1608,437,500,201,395,1533,75,6
4600,전라남도,목포시나선거구,6460102,4601,목포시,하당동,선거일투표,7676,2003,605,596,312,414,1927,76,5673
4600,전라남도,목포시나선거구,6460102,4601,목포시,잘못 투입·구분된 투표지,,0,20,2,4,3,9,18,2,-20
4600,전라남도,목포시다선거구,6460103,4601,목포시,합계,,22375,12080,4497,2479,3723,644,11343,737,10295
4600,전라남도,목포시다선거구,6460103,4601,목포시,거소투표,,64,57,27,14,10,2,53,4,7
4600,전라남도,목포시다선거구,6460103,4601,목포시,관외사전투표,,1679,1673,664,373,421,110,1568,105,6
4600,전라남도,목포시다선거구,6460103,4601,목포시,산정동,계,6981,3493,1347,672,1025,226,3270,223,3488
4600,전라남도,목포시다선거구,6460103,4601,목포시,산정동,관내사전투표,1630,1626,629,301,489,111,1530,96,4
4600,전라남도,목포시다선거구,6460103,4601,목포시,산정동,선거일투표,5351,1867,718,371,536,115,1740,127,3484
4600,전라남도,목포시다선거구,6460103,4601,목포시,대성동,계,3842,1941,915,359,474,78,1826,115,1901
4600,전라남도,목포시다선거구,6460103,4601,목포시,대성동,관내사전투표,1058,1053,503,185,271,42,1001,52,5
4600,전라남도,목포시다선거구,6460103,4601,목포시,대성동,선거일투표,2784,888,412,174,203,36,825,63,1896
4600,전라남도,목포시다선거구,6460103,4601,목포시,죽교동,계,2611,1322,475,276,378,87,1216,106,1289
4600,전라남도,목포시다선거구,6460103,4601,목포시,죽교동,관내사전투표,788,788,289,150,223,52,714,74,0
4600,전라남도,목포시다선거구,6460103,4601,목포시,죽교동,선거일투표,1823,534,186,126,155,35,502,32,1289
4600,전라남도,목포시다선거구,6460103,4601,목포시,북항동,계,7198,3565,1060,779,1405,140,3384,181,3633
4600,전라남도,목포시다선거구,6460103,4601,목포시,북항동,관내사전투표,1992,1984,549,432,822,71,1874,110,8
4600,전라남도,목포시다선거구,6460103,4601,목포시,북항동,선거일투표,5206,1581,511,347,583,69,1510,71,3625
4600,전라남도,목포시다선거구,6460103,4601,목포시,잘못 투입·구분된 투표지,,0,29,9,6,10,1,26,3,-29
4600,전라남도,목포시라선거구,6460104,4601,목포시,합계,,17698,9819,2223,1877,1656,1463,612,1443,9274,545,7879
4600,전라남도,목포시라선거구,6460104,4601,목포시,거소투표,,77,73,49,5,3,4,1,9,71,2,4
4600,전라남도,목포시라선거구,6460104,4601,목포시,관외사전투표,,1397,1397,385,252,238,193,56,185,1309,88,0
4600,전라남도,목포시라선거구,6460104,4601,목포시,목원동,계,6168,3157,631,478,580,557,119,628,2993,164,3011
4600,전라남도,목포시라선거구,6460104,4601,목포시,목원동,관내사전투표,1697,1696,314,277,318,297,63,337,1606,90,1
4600,전라남도,목포시라선거구,6460104,4601,목포시,목원동,선거일투표,4471,1461,317,201,262,260,56,291,1387,74,3010
4600,전라남도,목포시라선거구,6460104,4601,목포시,동명동,계,4309,2115,517,436,432,287,70,259,2001,114,2194
4600,전라남도,목포시라선거구,6460104,4601,목포시,동명동,관내사전투표,1300,1300,316,280,261,186,36,153,1232,68,0
4600,전라남도,목포시라선거구,6460104,4601,목포시,동명동,선거일투표,3009,815,201,156,171,101,34,106,769,46,2194
4600,전라남도,목포시라선거구,6460104,4601,목포시,만호동,계,2174,1053,265,278,133,161,70,108,1015,38,1121
4600,전라남도,목포시라선거구,6460104,4601,목포시,만호동,관내사전투표,626,625,148,173,80,106,40,59,606,19,1
4600,전라남도,목포시라선거구,6460104,4601,목포시,만호동,선거일투표,1548,428,117,105,53,55,30,49,409,19,1120
4600,전라남도,목포시라선거구,6460104,4601,목포시,유달동,계,3573,2023,376,428,270,260,296,254,1884,139,1550
4600,전라남도,목포시라선거구,6460104,4601,목포시,유달동,관내사전투표,1185,1186,195,238,149,156,216,146,1100,86,-1
4600,전라남도,목포시라선거구,6460104,4601,목포시,유달동,선거일투표,2388,837,181,190,121,104,80,108,784,53,1551
4600,전라남도,목포시라선거구,6460104,4601,목포시,잘못 투입·구분된 투표지,,0,1,0,0,0,1,0,0,1,0,-1
4600,전라남도,목포시마선거구,6460105,4601,목포시,합계,,32075,16524,3335,3819,2966,3268,2571,15959,565,15551
4600,전라남도,목포시마선거구,6460105,4601,목포시,거소투표,,104,99,28,22,20,13,12,95,4,5
4600,전라남도,목포시마선거구,6460105,4601,목포시,관외사전투표,,2994,2991,704,774,486,509,425,2898,93,3
4600,전라남도,목포시마선거구,6460105,4601,목포시,연산동,계,6774,3007,496,849,524,600,443,2912,95,3767
4600,전라남도,목포시마선거구,6460105,4601,목포시,연산동,관내사전투표,1258,1252,205,423,206,217,146,1197,55,6
4600,전라남도,목포시마선거구,6460105,4601,목포시,연산동,선거일투표,5516,1755,291,426,318,383,297,1715,40,3761
4600,전라남도,목포시마선거구,6460105,4601,목포시,원산동,계,9724,4419,831,1313,832,780,489,4245,174,5305
4600,전라남도,목포시마선거구,6460105,4601,목포시,원산동,관내사전투표,2145,2131,382,664,425,362,224,2057,74,14
4600,전라남도,목포시마선거구,6460105,4601,목포시,원산동,선거일투표,7579,2288,449,649,407,418,265,2188,100,5291
4600,전라남도,목포시마선거구,6460105,4601,목포시,용해동,계,12479,5972,1272,853,1095,1363,1195,5778,194,6507
4600,전라남도,목포시마선거구,6460105,4601,목포시,용해동,관내사전투표,2886,2878,611,439,556,601,581,2788,90,8
4600,전라남도,목포시마선거구,6460105,4601,목포시,용해동,선거일투표,9593,3094,661,414,539,762,614,2990,104,6499
4600,전라남도,목포시마선거구,6460105,4601,목포시,잘못 투입·구분된 투표지,,0,36,4,8,9,3,7,31,5,-36
4600,전라남도,목포시바선거구,6460106,4601,목포시,합계,,31055,17228,3889,1532,3807,1543,1567,2035,2219,16592,636,13827
4600,전라남도,목포시바선거구,6460106,4601,목포시,거소투표,,139,135,33,17,29,9,5,30,2,125,10,4
4600,전라남도,목포시바선거구,6460106,4601,목포시,관외사전투표,,2767,2760,831,288,569,280,233,193,242,2636,124,7
4600,전라남도,목포시바선거구,6460106,4601,목포시,상동,계,15480,7646,1459,669,1783,550,845,1312,744,7362,284,7834
4600,전라남도,목포시바선거구,6460106,4601,목포시,상동,관내사전투표,3373,3372,528,211,891,220,452,655,272,3229,143,1
4600,전라남도,목포시바선거구,6460106,4601,목포시,상동,선거일투표,12107,4274,931,458,892,330,393,657,472,4133,141,7833
4600,전라남도,목포시바선거구,6460106,4601,목포시,삼향동,계,4169,2282,357,140,419,159,134,196,807,2212,70,1887
4600,전라남도,목포시바선거구,6460106,4601,목포시,삼향동,관내사전투표,1486,1486,216,83,336,97,86,139,482,1439,47,0
4600,전라남도,목포시바선거구,6460106,4601,목포시,삼향동,선거일투표,2683,796,141,57,83,62,48,57,325,773,23,1887
4600,전라남도,목포시바선거구,6460106,4601,목포시,옥암동,계,8500,4403,1209,418,1007,545,349,303,424,4255,148,4097
4600,전라남도,목포시바선거구,6460106,4601,목포시,옥암동,관내사전투표,2480,2480,656,192,651,289,208,171,235,2402,78,0
4600,전라남도,목포시바선거구,6460106,4601,목포시,옥암동,선거일투표,6020,1923,553,226,356,256,141,132,189,1853,70,4097
4600,전라남도,목포시바선거구,6460106,4601,목포시,잘못 투입·구분된 투표지,,0,2,0,0,0,0,1,1,0,2,0,-2
4600,전라남도,목포시사선거구,6460107,4601,목포시,합계,,38332,19506,3878,3674,1420,4016,3107,2766,18861,645,18826
4600,전라남도,목포시사선거구,6460107,4601,목포시,거소투표,,124,111,24,27,13,7,13,21,105,6,13
4600,전라남도,목포시사선거구,6460107,4601,목포시,관외사전투표,,2896,2893,684,559,238,569,406,317,2773,120,3
4600,전라남도,목포시사선거구,6460107,4601,목포시,신흥동,계,12498,5864,1118,1294,364,1205,829,861,5671,193,6634
4600,전라남도,목포시사선거구,6460107,4601,목포시,신흥동,관내사전투표,2227,2227,380,476,130,430,327,415,2158,69,0
4600,전라남도,목포시사선거구,6460107,4601,목포시,신흥동,선거일투표,10271,3637,738,818,234,775,502,446,3513,124,6634
4600,전라남도,목포시사선거구,6460107,4601,목포시,부흥동,계,7018,3517,671,620,238,923,397,550,3399,118,3501
4600,전라남도,목포시사선거구,6460107,4601,목포시,부흥동,관내사전투표,2053,2053,377,383,133,503,258,349,2003,50,0
4600,전라남도,목포시사선거구,6460107,4601,목포시,부흥동,선거일투표,4965,1464,294,237,105,420,139,201,1396,68,3501
4600,전라남도,목포시사선거구,6460107,4601,목포시,부주동,계,15796,7120,1381,1173,567,1312,1462,1017,6912,208,8676
4600,전라남도,목포시사선거구,6460107,4601,목포시,부주동,관내사전투표,3192,3192,606,515,239,615,663,471,3109,83,0
4600,전라남도,목포시사선거구,6460107,4601,목포시,부주동,선거일투표,12604,3928,775,658,328,697,799,546,3803,125,8676
4600,전라남도,목포시사선거구,6460107,4601,목포시,잘못 투입·구분된 투표지,,0,1,0,1,0,0,0,0,1,0,-1
4600,전라남도,여수시가선거구,6460201,4602,여수시,합계,,16278,8790,2803,2302,2042,1216,8363,427,7488
4600,전라남도,여수시가선거구,6460201,4602,여수시,거소투표,,42,39,17,8,9,2,36,3,3
4600,전라남도,여수시가선거구,6460201,4602,여수시,관외사전투표,,1588,1587,541,514,288,175,1518,69,1
4600,전라남도,여수시가선거구,6460201,4602,여수시,돌산읍,계,10680,4765,1106,1269,1324,855,4554,211,5915
4600,전라남도,여수시가선거구,6460201,4602,여수시,돌산읍,관내사전투표,1121,1121,229,270,380,155,1034,87,0
4600,전라남도,여수시가선거구,6460201,4602,여수시,돌산읍,선거일투표,9559,3644,877,999,944,700,3520,124,5915
4600,전라남도,여수시가선거구,6460201,4602,여수시,남면,계,2273,1435,754,191,253,132,1330,105,838
4600,전라남도,여수시가선거구,6460201,4602,여수시,남면,관내사전투표,562,562,323,66,81,40,510,52,0
4600,전라남도,여수시가선거구,6460201,4602,여수시,남면,선거일투표,1711,873,431,125,172,92,820,53,838
4600,전라남도,여수시가선거구,6460201,4602,여수시,삼산면,계,1695,963,385,320,167,52,924,39,732
4600,전라남도,여수시가선거구,6460201,4602,여수시,삼산면,관내사전투표,280,280,115,94,43,12,264,16,0
4600,전라남도,여수시가선거구,6460201,4602,여수시,삼산면,선거일투표,1415,683,270,226,124,40,660,23,732
4600,전라남도,여수시가선거구,6460201,4602,여수시,잘못 투입·구분된 투표지,,0,1,0,0,1,0,1,0,-1
4600,전라남도,여수시나선거구,6460202,4602,여수시,합계,,20338,9641,4082,1775,1634,670,1134,9295,346,10697
4600,전라남도,여수시나선거구,6460202,4602,여수시,거소투표,,53,48,23,6,9,4,4,46,2,5
4600,전라남도,여수시나선거구,6460202,4602,여수시,관외사전투표,,808,807,386,139,158,39,55,777,30,1
4600,전라남도,여수시나선거구,6460202,4602,여수시,대교동,계,4702,2135,1145,335,218,150,211,2059,76,2567
4600,전라남도,여수시나선거구,6460202,4602,여수시,대교동,관내사전투표,873,873,444,152,107,61,81,845,28,0
4600,전라남도,여수시나선거구,6460202,4602,여수시,대교동,선거일투표,3829,1262,701,183,111,89,130,1214,48,2567
4600,전라남도,여수시나선거구,6460202,4602,여수시,국동,계,9271,3958,1538,808,815,334,327,3822,136,5313
4600,전라남도,여수시나선거구,6460202,4602,여수시,국동,관내사전투표,1647,1647,606,316,407,140,120,1589,58,0
4600,전라남도,여수시나선거구,6460202,4602,여수시,국동,선거일투표,7624,2311,932,492,408,194,207,2233,78,5313
4600,전라남도,여수시나선거구,6460202,4602,여수시,월호동,계,5504,2693,990,487,434,143,537,2591,102,2811
4600,전라남도,여수시나선거구,6460202,4602,여수시,월호동,관내사전투표,1016,1016,342,205,171,57,205,980,36,0
4600,전라남도,여수시나선거구,6460202,4602,여수시,월호동,선거일투표,4488,1677,648,282,263,86,332,1611,66,2811
4600,전라남도,여수시나선거구,6460202,4602,여수시,잘못 투입·구분된 투표지,,0,0,0,0,0,0,0,0,0,0
4600,전라남도,여수시다선거구,6460203,4602,여수시,합계,,17540,8518,4060,2348,1596,8004,514,9022
4600,전라남도,여수시다선거구,6460203,4602,여수시,거소투표,,42,41,20,12,5,37,4,1
4600,전라남도,여수시다선거구,6460203,4602,여수시,관외사전투표,,1016,1016,496,274,208,978,38,0
4600,전라남도,여수시다선거구,6460203,4602,여수시,동문동,계,3912,1847,832,530,368,1730,117,2065
4600,전라남도,여수시다선거구,6460203,4602,여수시,동문동,관내사전투표,884,881,402,259,188,849,32,3
4600,전라남도,여수시다선거구,6460203,4602,여수시,동문동,선거일투표,3028,966,430,271,180,881,85,2062
4600,전라남도,여수시다선거구,6460203,4602,여수시,한려동,계,2669,1301,591,346,260,1197,104,1368
4600,전라남도,여수시다선거구,6460203,4602,여수시,한려동,관내사전투표,645,641,311,175,119,605,36,4
4600,전라남도,여수시다선거구,6460203,4602,여수시,한려동,선거일투표,2024,660,280,171,141,592,68,1364
4600,전라남도,여수시다선거구,6460203,4602,여수시,중앙동,계,3522,1565,761,447,280,1488,77,1957
4600,전라남도,여수시다선거구,6460203,4602,여수시,중앙동,관내사전투표,717,717,366,187,121,674,43,0
4600,전라남도,여수시다선거구,6460203,4602,여수시,중앙동,선거일투표,2805,848,395,260,159,814,34,1957
4600,전라남도,여수시다선거구,6460203,4602,여수시,충무동,계,3290,1349,690,361,220,1271,78,1941
4600,전라남도,여수시다선거구,6460203,4602,여수시,충무동,관내사전투표,606,605,305,172,95,572,33,1
4600,전라남도,여수시다선거구,6460203,4602,여수시,충무동,선거일투표,2684,744,385,189,125,699,45,1940
4600,전라남도,여수시다선거구,6460203,4602,여수시,서강동,계,3089,1390,666,376,253,1295,95,1699
4600,전라남도,여수시다선거구,6460203,4602,여수시,서강동,관내사전투표,563,563,280,160,102,542,21,0
4600,전라남도,여수시다선거구,6460203,4602,여수시,서강동,선거일투표,2526,827,386,216,151,753,74,1699
4600,전라남도,여수시다선거구,6460203,4602,여수시,잘못 투입·구분된 투표지,,0,9,4,2,2,8,1,-9
4600,전라남도,여수시라선거구,6460204,4602,여수시,합계,,21786,10640,3330,2772,4047,10149,491,11146
4600,전라남도,여수시라선거구,6460204,4602,여수시,거소투표,,42,39,15,10,13,38,1,3
4600,전라남도,여수시라선거구,6460204,4602,여수시,관외사전투표,,1320,1318,484,356,434,1274,44,2
4600,전라남도,여수시라선거구,6460204,4602,여수시,미평동,계,9588,4264,1231,643,2263,4137,127,5324
4600,전라남도,여수시라선거구,6460204,4602,여수시,미평동,관내사전투표,1709,1705,507,243,925,1675,30,4
4600,전라남도,여수시라선거구,6460204,4602,여수시,미평동,선거일투표,7879,2559,724,400,1338,2462,97,5320
4600,전라남도,여수시라선거구,6460204,4602,여수시,만덕동,계,7927,3616,936,1479,1014,3429,187,4311
4600,전라남도,여수시라선거구,6460204,4602,여수시,만덕동,관내사전투표,1183,1182,283,520,349,1152,30,1
4600,전라남도,여수시라선거구,6460204,4602,여수시,만덕동,선거일투표,6744,2434,653,959,665,2277,157,4310
4600,전라남도,여수시라선거구,6460204,4602,여수시,삼일동,계,1924,852,386,183,221,790,62,1072
4600,전라남도,여수시라선거구,6460204,4602,여수시,삼일동,관내사전투표,390,390,168,87,106,361,29,0
4600,전라남도,여수시라선거구,6460204,4602,여수시,삼일동,선거일투표,1534,462,218,96,115,429,33,1072
4600,전라남도,여수시라선거구,6460204,4602,여수시,묘도동,계,985,544,276,99,101,476,68,441
4600,전라남도,여수시라선거구,6460204,4602,여수시,묘도동,관내사전투표,302,302,165,56,60,281,21,0
4600,전라남도,여수시라선거구,6460204,4602,여수시,묘도동,선거일투표,683,242,111,43,41,195,47,441
4600,전라남도,여수시라선거구,6460204,4602,여수시,잘못 투입·구분된 투표지,,0,7,2,2,1,5,2,-7
4600,전라남도,여수시마선거구,6460205,4602,여수시,합계,,38289,17517,4509,3217,3828,2339,820,2336,17049,468,20772
4600,전라남도,여수시마선거구,6460205,4602,여수시,거소투표,,88,80,19,14,17,8,12,4,74,6,8
4600,전라남도,여수시마선거구,6460205,4602,여수시,관외사전투표,,1899,1897,579,305,404,191,113,256,1848,49,2
4600,전라남도,여수시마선거구,6460205,4602,여수시,광림동,계,5228,2256,680,498,263,274,106,344,2165,91,2972
4600,전라남도,여수시마선거구,6460205,4602,여수시,광림동,관내사전투표,808,808,236,200,102,98,32,115,783,25,0
4600,전라남도,여수시마선거구,6460205,4602,여수시,광림동,선거일투표,4420,1448,444,298,161,176,74,229,1382,66,2972
4600,전라남도,여수시마선거구,6460205,4602,여수시,여서동,계,14734,6494,1553,1114,1443,1077,301,879,6367,127,8240
4600,전라남도,여수시마선거구,6460205,4602,여수시,여서동,관내사전투표,1997,1997,463,360,440,359,78,261,1961,36,0
4600,전라남도,여수시마선거구,6460205,4602,여수시,여서동,선거일투표,12737,4497,1090,754,1003,718,223,618,4406,91,8240
4600,전라남도,여수시마선거구,6460205,4602,여수시,문수동,계,16340,6790,1678,1286,1701,789,288,853,6595,195,9550
4600,전라남도,여수시마선거구,6460205,4602,여수시,문수동,관내사전투표,1977,1977,458,376,499,210,76,309,1928,49,0
4600,전라남도,여수시마선거구,6460205,4602,여수시,문수동,선거일투표,14363,4813,1220,910,1202,579,212,544,4667,146,9550
4600,전라남도,여수시마선거구,6460205,4602,여수시,잘못 투입·구분된 투표지,,0,0,0,0,0,0,0,0,0,0,0
4600,전라남도,여수시바선거구,6460206,4602,여수시,합계,,18202,7320,3380,1634,1880,6894,426,10882
4600,전라남도,여수시바선거구,6460206,4602,여수시,거소투표,,41,41,21,14,4,39,2,0
4600,전라남도,여수시바선거구,6460206,4602,여수시,관외사전투표,,1179,1178,617,237,277,1131,47,1
4600,전라남도,여수시바선거구,6460206,4602,여수시,여천동,계,16982,6095,2741,1381,1598,5720,375,10887
4600,전라남도,여수시바선거구,6460206,4602,여수시,여천동,관내사전투표,1701,1700,765,386,477,1628,72,1
4600,전라남도,여수시바선거구,6460206,4602,여수시,여천동,선거일투표,15281,4395,1976,995,1121,4092,303,10886
4600,전라남도,여수시바선거구,6460206,4602,여수시,잘못 투입·구분된 투표지,,0,6,1,2,1,4,2,-6
4600,전라남도,여수시사선거구,6460207,4602,여수시,합계,,23780,10762,3187,2393,993,3548,10121,641,13018
4600,전라남도,여수시사선거구,6460207,4602,여수시,거소투표,,82,74,28,9,4,15,56,18,8
4600,전라남도,여수시사선거구,6460207,4602,여수시,관외사전투표,,1721,1721,620,421,139,473,1653,68,0
4600,전라남도,여수시사선거구,6460207,4602,여수시,소라면,계,16685,6444,1789,1736,673,1887,6085,359,10241
4600,전라남도,여수시사선거구,6460207,4602,여수시,소라면,관내사전투표,1733,1733,470,487,203,486,1646,87,0
4600,전라남도,여수시사선거구,6460207,4602,여수시,소라면,선거일투표,14952,4711,1319,1249,470,1401,4439,272,10241
4600,전라남도,여수시사선거구,6460207,4602,여수시,율촌면,계,5292,2520,750,227,177,1171,2325,195,2772
4600,전라남도,여수시사선거구,6460207,4602,여수시,율촌면,관내사전투표,1148,1148,317,101,68,557,1043,105,0
4600,전라남도,여수시사선거구,6460207,4602,여수시,율촌면,선거일투표,4144,1372,433,126,109,614,1282,90,2772
4600,전라남도,여수시사선거구,6460207,4602,여수시,잘못 투입·구분된 투표지,,0,3,0,0,0,2,2,1,-3
4600,전라남도,여수시아선거구,6460208,4602,여수시,합계,,39273,17313,4756,3846,2330,2003,3906,16841,472,21960
4600,전라남도,여수시아선거구,6460208,4602,여수시,거소투표,,64,59,22,16,7,2,7,54,5,5
4600,전라남도,여수시아선거구,6460208,4602,여수시,관외사전투표,,2483,2482,696,619,284,245,544,2388,94,1
4600,전라남도,여수시아선거구,6460208,4602,여수시,화양면,계,5618,2723,1092,214,768,224,309,2607,116,2895
4600,전라남도,여수시아선거구,6460208,4602,여수시,화양면,관내사전투표,1142,1142,467,81,315,97,131,1091,51,0
4600,전라남도,여수시아선거구,6460208,4602,여수시,화양면,선거일투표,4476,1581,625,133,453,127,178,1516,65,2895
4600,전라남도,여수시아선거구,6460208,4602,여수시,쌍봉동,계,25309,9973,2388,2473,1039,1174,2684,9758,215,15336
4600,전라남도,여수시아선거구,6460208,4602,여수시,쌍봉동,관내사전투표,2718,2718,705,706,300,224,715,2650,68,0
4600,전라남도,여수시아선거구,6460208,4602,여수시,쌍봉동,선거일투표,22591,7255,1683,1767,739,950,1969,7108,147,15336
4600,전라남도,여수시아선거구,6460208,4602,여수시,주삼동,계,5799,2074,557,523,232,358,362,2032,42,3725
4600,전라남도,여수시아선거구,6460208,4602,여수시,주삼동,관내사전투표,642,642,197,155,92,66,114,624,18,0
4600,전라남도,여수시아선거구,6460208,4602,여수시,주삼동,선거일투표,5157,1432,360,368,140,292,248,1408,24,3725
4600,전라남도,여수시아선거구,6460208,4602,여수시,잘못 투입·구분된 투표지,,0,2,1,1,0,0,0,2,0,-2
4600,전라남도,여수시자선거구,6460209,4602,여수시,합계,,41395,18631,4339,4825,2781,2103,1021,1715,1389,18173,458,22764
4600,전라남도,여수시자선거구,6460209,4602,여수시,거소투표,,65,62,24,10,10,7,3,3,4,61,1,3
4600,전라남도,여수시자선거구,6460209,4602,여수시,관외사전투표,,3193,3190,846,799,451,332,201,279,186,3094,96,3
4600,전라남도,여수시자선거구,6460209,4602,여수시,화정면,계,1816,1140,433,168,228,77,54,91,35,1086,54,676
4600,전라남도,여수시자선거구,6460209,4602,여수시,화정면,관내사전투표,145,145,41,19,26,16,14,14,4,134,11,0
4600,전라남도,여수시자선거구,6460209,4602,여수시,화정면,선거일투표,1671,995,392,149,202,61,40,77,31,952,43,676
4600,전라남도,여수시자선거구,6460209,4602,여수시,둔덕동,계,7949,3264,773,619,831,372,190,203,191,3179,85,4685
4600,전라남도,여수시자선거구,6460209,4602,여수시,둔덕동,관내사전투표,1256,1256,308,254,344,139,60,56,67,1228,28,0
4600,전라남도,여수시자선거구,6460209,4602,여수시,둔덕동,선거일투표,6693,2008,465,365,487,233,130,147,124,1951,57,4685
4600,전라남도,여수시자선거구,6460209,4602,여수시,시전동,계,28372,10974,2263,3229,1261,1314,573,1139,973,10752,222,17398
4600,전라남도,여수시자선거구,6460209,4602,여수시,시전동,관내사전투표,2777,2777,577,843,371,275,107,261,281,2715,62,0
4600,전라남도,여수시자선거구,6460209,4602,여수시,시전동,선거일투표,25595,8197,1686,2386,890,1039,466,878,692,8037,160,17398
4600,전라남도,여수시자선거구,6460209,4602,여수시,잘못 투입·구분된 투표지,,0,1,0,0,0,1,0,0,0,1,0,-1
4600,전라남도,순천시가선거구,6460401,4604,순천시,합계,,23124,13979,4275,2812,3859,2256,13202,777,9145
4600,전라남도,순천시가선거구,6460401,4604,순천시,거소투표,,46,44,20,10,8,4,42,2,2
4600,전라남도,순천시가선거구,6460401,4604,순천시,관외사전투표,,1921,1915,654,459,407,326,1846,69,6
4600,전라남도,순천시가선거구,6460401,4604,순천시,승주읍,계,2344,1383,479,130,556,108,1273,110,961
4600,전라남도,순천시가선거구,6460401,4604,순천시,승주읍,관내사전투표,678,678,250,58,257,59,624,54,0
4600,전라남도,순천시가선거구,6460401,4604,순천시,승주읍,선거일투표,1666,705,229,72,299,49,649,56,961
4600,전라남도,순천시가선거구,6460401,4604,순천시,주암면,계,2744,1611,879,126,416,77,1498,113,1133
4600,전라남도,순천시가선거구,6460401,4604,순천시,주암면,관내사전투표,713,711,425,48,156,35,664,47,2
4600,전라남도,순천시가선거구,6460401,4604,순천시,주암면,선거일투표,2031,900,454,78,260,42,834,66,1131
4600,전라남도,순천시가선거구,6460401,4604,순천시,송광면,계,1300,706,375,104,97,58,634,72,594
4600,전라남도,순천시가선거구,6460401,4604,순천시,송광면,관내사전투표,353,353,199,54,53,28,334,19,0
4600,전라남도,순천시가선거구,6460401,4604,순천시,송광면,선거일투표,947,353,176,50,44,30,300,53,594
4600,전라남도,순천시가선거구,6460401,4604,순천시,서면,계,10668,5633,1290,1822,782,1506,5400,233,5035
4600,전라남도,순천시가선거구,6460401,4604,순천시,서면,관내사전투표,1558,1554,330,488,240,447,1505,49,4
4600,전라남도,순천시가선거구,6460401,4604,순천시,서면,선거일투표,9110,4079,960,1334,542,1059,3895,184,5031
4600,전라남도,순천시가선거구,6460401,4604,순천시,황전면,계,2682,1804,343,113,1124,100,1680,124,878
4600,전라남도,순천시가선거구,6460401,4604,순천시,황전면,관내사전투표,1084,1084,197,71,663,65,996,88,0
4600,전라남도,순천시가선거구,6460401,4604,순천시,황전면,선거일투표,1598,720,146,42,461,35,684,36,878
4600,전라남도,순천시가선거구,6460401,4604,순천시,월등면,계,1419,869,231,45,466,74,816,53,550
4600,전라남도,순천시가선거구,6460401,4604,순천시,월등면,관내사전투표,489,489,125,27,264,42,458,31,0
4600,전라남도,순천시가선거구,6460401,4604,순천시,월등면,선거일투표,930,380,106,18,202,32,358,22,550
4600,전라남도,순천시가선거구,6460401,4604,순천시,잘못 투입·구분된 투표지,,0,14,4,3,3,3,13,1,-14
4600,전라남도,순천시나선거구,6460402,4604,순천시,합계,,26357,15174,3542,1823,2660,722,1753,633,1530,1897,14560,614,11183
4600,전라남도,순천시나선거구,6460402,4604,순천시,거소투표,,53,51,14,6,7,4,2,4,5,3,45,6,2
4600,전라남도,순천시나선거구,6460402,4604,순천시,관외사전투표,,2275,2273,637,297,425,148,236,54,229,173,2199,74,2
4600,전라남도,순천시나선거구,6460402,4604,순천시,외서면,계,749,464,123,21,159,21,27,13,17,56,437,27,285
4600,전라남도,순천시나선거구,6460402,4604,순천시,외서면,관내사전투표,301,301,77,12,106,13,17,11,13,33,282,19,0
4600,전라남도,순천시나선거구,6460402,4604,순천시,외서면,선거일투표,448,163,46,9,53,8,10,2,4,23,155,8,285
4600,전라남도,순천시나선거구,6460402,4604,순천시,낙안면,계,2770,1647,321,142,807,61,75,28,46,80,1560,87,1123
4600,전라남도,순천시나선거구,6460402,4604,순천시,낙안면,관내사전투표,888,888,171,69,454,27,34,14,26,37,832,56,0
4600,전라남도,순천시나선거구,6460402,4604,순천시,낙안면,선거일투표,1882,759,150,73,353,34,41,14,20,43,728,31,1123
4600,전라남도,순천시나선거구,6460402,4604,순천시,별량면,계,4752,2580,387,155,254,92,194,385,73,919,2459,121,2172
4600,전라남도,순천시나선거구,6460402,4604,순천시,별량면,관내사전투표,1236,1236,159,69,132,49,87,180,38,455,1169,67,0
4600,전라남도,순천시나선거구,6460402,4604,순천시,별량면,선거일투표,3516,1344,228,86,122,43,107,205,35,464,1290,54,2172
4600,전라남도,순천시나선거구,6460402,4604,순천시,상사면,계,2449,1372,348,287,182,63,142,21,136,117,1296,76,1077
4600,전라남도,순천시나선거구,6460402,4604,순천시,상사면,관내사전투표,537,536,110,117,67,23,61,7,59,52,496,40,1
4600,전라남도,순천시나선거구,6460402,4604,순천시,상사면,선거일투표,1912,836,238,170,115,40,81,14,77,65,800,36,1076
4600,전라남도,순천시나선거구,6460402,4604,순천시,도사동,계,13309,6787,1712,915,826,333,1077,128,1024,549,6564,223,6522
4600,전라남도,순천시나선거구,6460402,4604,순천시,도사동,관내사전투표,2263,2263,500,283,306,111,322,37,419,208,2186,77,0
4600,전라남도,순천시나선거구,6460402,4604,순천시,도사동,선거일투표,11046,4524,1212,632,520,222,755,91,605,341,4378,146,6522
4600,전라남도,순천시나선거구,6460402,4604,순천시,잘못 투입·구분된 투표지,,0,0,0,0,0,0,0,0,0,0,0,0,0
4600,전라남도,순천시다선거구,6460403,4604,순천시,합계,,16526,8807,5139,2256,1070,8465,342,7719
4600,전라남도,순천시다선거구,6460403,4604,순천시,거소투표,,31,29,12,7,6,25,4,2
4600,전라남도,순천시다선거구,6460403,4604,순천시,관외사전투표,,1047,1044,539,289,162,990,54,3
4600,전라남도,순천시다선거구,6460403,4604,순천시,풍덕동,계,6601,3538,2406,649,366,3421,117,3063
4600,전라남도,순천시다선거구,6460403,4604,순천시,풍덕동,관내사전투표,1395,1394,939,286,112,1337,57,1
4600,전라남도,순천시다선거구,6460403,4604,순천시,풍덕동,선거일투표,5206,2144,1467,363,254,2084,60,3062
4600,전라남도,순천시다선거구,6460403,4604,순천시,남제동,계,6939,3260,1684,1030,420,3134,126,3679
4600,전라남도,순천시다선거구,6460403,4604,순천시,남제동,관내사전투표,1340,1338,680,410,175,1265,73,2
4600,전라남도,순천시다선거구,6460403,4604,순천시,남제동,선거일투표,5599,1922,1004,620,245,1869,53,3677
4600,전라남도,순천시다선거구,6460403,4604,순천시,장천동,계,1908,930,494,279,116,889,41,978
4600,전라남도,순천시다선거구,6460403,4604,순천시,장천동,관내사전투표,430,430,212,145,53,410,20,0
4600,전라남도,순천시다선거구,6460403,4604,순천시,장천동,선거일투표,1478,500,282,134,63,479,21,978
4600,전라남도,순천시다선거구,6460403,4604,순천시,잘못 투입·구분된 투표지,,0,6,4,2,0,6,0,-6
4600,전라남도,순천시라선거구,6460404,4604,순천시,합계,,35665,20650,5287,3029,2921,8468,19705,945,15015
4600,전라남도,순천시라선거구,6460404,4604,순천시,거소투표,,99,93,32,16,14,17,79,14,6
4600,전라남도,순천시라선거구,6460404,4604,순천시,관외사전투표,,2251,2250,731,331,301,794,2157,93,1
4600,전라남도,순천시라선거구,6460404,4604,순천시,향동,계,3065,1815,381,124,222,1008,1735,80,1250
4600,전라남도,순천시라선거구,6460404,4604,순천시,향동,관내사전투표,1054,1052,199,77,121,607,1004,48,2
4600,전라남도,순천시라선거구,6460404,4604,순천시,향동,선거일투표,2011,763,182,47,101,401,731,32,1248
4600,전라남도,순천시라선거구,6460404,4604,순천시,매곡동,계,5478,2996,686,407,439,1343,2875,121,2482
4600,전라남도,순천시라선거구,6460404,4604,순천시,매곡동,관내사전투표,1596,1591,326,193,241,767,1527,64,5
4600,전라남도,순천시라선거구,6460404,4604,순천시,매곡동,선거일투표,3882,1405,360,214,198,576,1348,57,2477
4600,전라남도,순천시라선거구,6460404,4604,순천시,삼산동,계,19735,10599,2669,1883,1227,4326,10105,494,9136
4600,전라남도,순천시라선거구,6460404,4604,순천시,삼산동,관내사전투표,3864,3858,882,655,475,1706,3718,140,6
4600,전라남도,순천시라선거구,6460404,4604,순천시,삼산동,선거일투표,15871,6741,1787,1228,752,2620,6387,354,9130
4600,전라남도,순천시라선거구,6460404,4604,순천시,저전동,계,2335,1382,447,147,211,492,1297,85,953
4600,전라남도,순천시라선거구,6460404,4604,순천시,저전동,관내사전투표,819,815,239,76,136,319,770,45,4
4600,전라남도,순천시라선거구,6460404,4604,순천시,저전동,선거일투표,1516,567,208,71,75,173,527,40,949
4600,전라남도,순천시라선거구,6460404,4604,순천시,중앙동,계,2702,1490,336,120,502,474,1432,58,1212
4600,전라남도,순천시라선거구,6460404,4604,순천시,중앙동,관내사전투표,868,866,174,61,320,280,835,31,2
4600,전라남도,순천시라선거구,6460404,4604,순천시,중앙동,선거일투표,1834,624,162,59,182,194,597,27,1210
4600,전라남도,순천시라선거구,6460404,4604,순천시,잘못 투입·구분된 투표지,,0,25,5,1,5,14,25,0,-25
4600,전라남도,순천시마선거구,6460405,4604,순천시,합계,,41717,22979,8329,3443,3792,3205,3091,379,22239,740,18738
4600,전라남도,순천시마선거구,6460405,4604,순천시,거소투표,,58,54,21,7,10,4,8,1,51,3,4
4600,전라남도,순천시마선거구,6460405,4604,순천시,관외사전투표,,3359,3359,1185,449,600,412,498,78,3222,137,0
4600,전라남도,순천시마선거구,6460405,4604,순천시,조곡동,계,5001,2733,830,249,608,655,258,32,2632,101,2268
4600,전라남도,순천시마선거구,6460405,4604,순천시,조곡동,관내사전투표,994,994,345,110,201,174,117,13,960,34,0
4600,전라남도,순천시마선거구,6460405,4604,순천시,조곡동,선거일투표,4007,1739,485,139,407,481,141,19,1672,67,2268
4600,전라남도,순천시마선거구,6460405,4604,순천시,덕연동,계,33299,16833,6293,2738,2574,2134,2327,268,16334,499,16466
4600,전라남도,순천시마선거구,6460405,4604,순천시,덕연동,관내사전투표,4171,4171,1602,651,620,495,626,58,4052,119,0
4600,전라남도,순천시마선거구,6460405,4604,순천시,덕연동,선거일투표,29128,12662,4691,2087,1954,1639,1701,210,12282,380,16466
4600,전라남도,순천시마선거구,6460405,4604,순천시,잘못 투입·구분된 투표지,,0,0,0,0,0,0,0,0,0,0,0
4600,전라남도,순천시바선거구,6460406,4604,순천시,합계,,33478,16873,3897,3136,2557,1511,3529,1752,16382,491,16605
4600,전라남도,순천시바선거구,6460406,4604,순천시,거소투표,,57,51,19,11,10,7,1,2,50,1,6
4600,전라남도,순천시바선거구,6460406,4604,순천시,관외사전투표,,2752,2746,804,468,342,305,436,293,2648,98,6
4600,전라남도,순천시바선거구,6460406,4604,순천시,왕조1동,계,30669,14076,3074,2657,2205,1199,3092,1457,13684,392,16593
4600,전라남도,순천시바선거구,6460406,4604,순천시,왕조1동,관내사전투표,3844,3844,769,822,552,282,858,454,3737,107,0
4600,전라남도,순천시바선거구,6460406,4604,순천시,왕조1동,선거일투표,26825,10232,2305,1835,1653,917,2234,1003,9947,285,16593
4600,전라남도,순천시바선거구,6460406,4604,순천시,잘못 투입·구분된 투표지,,0,0,0,0,0,0,0,0,0,0,0
4600,전라남도,순천시사선거구,6460407,4604,순천시,합계,,15471,8201,3486,2340,2138,7964,237,7270
4600,전라남도,순천시사선거구,6460407,4604,순천시,거소투표,,23,23,7,10,3,20,3,0
4600,전라남도,순천시사선거구,6460407,4604,순천시,관외사전투표,,976,975,433,317,186,936,39,1
4600,전라남도,순천시사선거구,6460407,4604,순천시,왕조2동,계,14472,7194,3041,2011,1949,7001,193,7278
4600,전라남도,순천시사선거구,6460407,4604,순천시,왕조2동,관내사전투표,2971,2965,1251,809,825,2885,80,6
4600,전라남도,순천시사선거구,6460407,4604,순천시,왕조2동,선거일투표,11501,4229,1790,1202,1124,4116,113,7272
4600,전라남도,순천시사선거구,6460407,4604,순천시,잘못 투입·구분된 투표지,,0,9,5,2,0,7,2,-9
4600,전라남도,순천시아선거구,6460408,4604,순천시,합계,,22938,11791,4735,4316,2304,11355,436,11147
4600,전라남도,순천시아선거구,6460408,4604,순천시,거소투표,,30,28,12,11,4,27,1,2
4600,전라남도,순천시아선거구,6460408,4604,순천시,관외사전투표,,1629,1624,680,553,324,1557,67,5
4600,전라남도,순천시아선거구,6460408,4604,순천시,해룡면,계,21279,10127,4036,3751,1972,9759,368,11152
4600,전라남도,순천시아선거구,6460408,4604,순천시,해룡면,관내사전투표,3358,3350,1321,1294,646,3261,89,8
4600,전라남도,순천시아선거구,6460408,4604,순천시,해룡면,선거일투표,17921,6777,2715,2457,1326,6498,279,11144
4600,전라남도,순천시아선거구,6460408,4604,순천시,잘못 투입·구분된 투표지,,0,12,7,1,4,12,0,-12
4600,전라남도,순천시자선거구,6460409,4604,순천시,검색된 결과가 없습니다.
4600,전라남도,나주시가선거구,6460601,4606,나주시,검색된 결과가 없습니다.
4600,전라남도,나주시나선거구,6460602,4606,나주시,합계,,22688,12742,2583,1501,1618,1350,2815,365,490,1555,12277,465,9946
4600,전라남도,나주시나선거구,6460602,4606,나주시,거소투표,,116,109,28,12,13,4,10,2,5,6,80,29,7
4600,전라남도,나주시나선거구,6460602,4606,나주시,관외사전투표,,1506,1505,398,187,208,123,308,42,63,121,1450,55,1
4600,전라남도,나주시나선거구,6460602,4606,나주시,노안면,계,3940,2198,279,141,137,835,98,31,25,559,2105,93,1742
4600,전라남도,나주시나선거구,6460602,4606,나주시,노안면,관내사전투표,1014,1014,117,51,50,369,51,17,14,290,959,55,0
4600,전라남도,나주시나선거구,6460602,4606,나주시,노안면,선거일투표,2926,1184,162,90,87,466,47,14,11,269,1146,38,1742
4600,전라남도,나주시나선거구,6460602,4606,나주시,송월동,계,6170,2921,677,362,378,118,798,125,84,290,2832,89,3249
4600,전라남도,나주시나선거구,6460602,4606,나주시,송월동,관내사전투표,1191,1191,264,145,158,56,323,40,34,129,1149,42,0
4600,전라남도,나주시나선거구,6460602,4606,나주시,송월동,선거일투표,4979,1730,413,217,220,62,475,85,50,161,1683,47,3249
4600,전라남도,나주시나선거구,6460602,4606,나주시,금남동,계,3928,2156,456,304,288,79,583,84,99,198,2091,65,1772
4600,전라남도,나주시나선거구,6460602,4606,나주시,금남동,관내사전투표,1032,1032,200,152,136,25,318,36,39,94,1000,32,0
4600,전라남도,나주시나선거구,6460602,4606,나주시,금남동,선거일투표,2896,1124,256,152,152,54,265,48,60,104,1091,33,1772
4600,전라남도,나주시나선거구,6460602,4606,나주시,성북동,계,7028,3853,745,495,594,191,1018,81,214,381,3719,134,3175
4600,전라남도,나주시나선거구,6460602,4606,나주시,성북동,관내사전투표,1858,1858,355,248,278,92,504,48,114,157,1796,62,0
4600,전라남도,나주시나선거구,6460602,4606,나주시,성북동,선거일투표,5170,1995,390,247,316,99,514,33,100,224,1923,72,3175
4600,전라남도,나주시나선거구,6460602,4606,나주시,잘못 투입·구분된 투표지,,0,0,0,0,0,0,0,0,0,0,0,0,0
4600,전라남도,나주시다선거구,6460603,4606,나주시,합계,,14729,8236,2944,2343,1206,1390,7883,353,6493
4600,전라남도,나주시다선거구,6460603,4606,나주시,거소투표,,50,45,25,9,7,2,43,2,5
4600,전라남도,나주시다선거구,6460603,4606,나주시,관외사전투표,,1018,1017,397,286,162,140,985,32,1
4600,전라남도,나주시다선거구,6460603,4606,나주시,세지면,계,2373,1344,357,159,118,647,1281,63,1029
4600,전라남도,나주시다선거구,6460603,4606,나주시,세지면,관내사전투표,837,833,237,98,75,374,784,49,4
4600,전라남도,나주시다선거구,6460603,4606,나주시,세지면,선거일투표,1536,511,120,61,43,273,497,14,1025
4600,전라남도,나주시다선거구,6460603,4606,나주시,봉황면,계,3447,1819,969,126,506,138,1739,80,1628
4600,전라남도,나주시다선거구,6460603,4606,나주시,봉황면,관내사전투표,989,989,553,60,248,70,931,58,0
4600,전라남도,나주시다선거구,6460603,4606,나주시,봉황면,선거일투표,2458,830,416,66,258,68,808,22,1628
4600,전라남도,나주시다선거구,6460603,4606,나주시,영강동,계,2235,1091,337,438,104,147,1026,65,1144
4600,전라남도,나주시다선거구,6460603,4606,나주시,영강동,관내사전투표,645,620,195,252,53,65,565,55,25
4600,전라남도,나주시다선거구,6460603,4606,나주시,영강동,선거일투표,1590,471,142,186,51,82,461,10,1119
4600,전라남도,나주시다선거구,6460603,4606,나주시,영산동,계,2648,1343,400,639,117,137,1293,50,1305
4600,전라남도,나주시다선거구,6460603,4606,나주시,영산동,관내사전투표,692,691,208,323,67,59,657,34,1
4600,전라남도,나주시다선거구,6460603,4606,나주시,영산동,선거일투표,1956,652,192,316,50,78,636,16,1304
4600,전라남도,나주시다선거구,6460603,4606,나주시,이창동,계,2958,1545,454,673,189,171,1487,58,1413
4600,전라남도,나주시다선거구,6460603,4606,나주시,이창동,관내사전투표,868,866,254,379,107,98,838,28,2
4600,전라남도,나주시다선거구,6460603,4606,나주시,이창동,선거일투표,2090,679,200,294,82,73,649,30,1411
4600,전라남도,나주시다선거구,6460603,4606,나주시,잘못 투입·구분된 투표지,,0,32,5,13,3,8,29,3,-32
4600,전라남도,나주시라선거구,6460604,4606,나주시,합계,,13610,9067,2656,1770,2655,1580,8661,406,4543
4600,전라남도,나주시라선거구,6460604,4606,나주시,거소투표,,54,52,19,9,11,9,48,4,2
4600,전라남도,나주시라선거구,6460604,4606,나주시,관외사전투표,,1149,1149,454,219,291,154,1118,31,0
4600,전라남도,나주시라선거구,6460604,4606,나주시,왕곡면,계,2370,1466,857,132,184,232,1405,61,904
4600,전라남도,나주시라선거구,6460604,4606,나주시,왕곡면,관내사전투표,738,727,419,55,82,129,685,42,11
4600,전라남도,나주시라선거구,6460604,4606,나주시,왕곡면,선거일투표,1632,739,438,77,102,103,720,19,893
4600,전라남도,나주시라선거구,6460604,4606,나주시,반남면,계,1217,815,326,73,97,275,771,44,402
4600,전라남도,나주시라선거구,6460604,4606,나주시,반남면,관내사전투표,444,443,178,33,48,152,411,32,1
4600,전라남도,나주시라선거구,6460604,4606,나주시,반남면,선거일투표,773,372,148,40,49,123,360,12,401
4600,전라남도,나주시라선거구,6460604,4606,나주시,공산면,계,1926,1261,242,317,67,591,1217,44,665
4600,전라남도,나주시라선거구,6460604,4606,나주시,공산면,관내사전투표,725,725,138,162,39,354,693,32,0
4600,전라남도,나주시라선거구,6460604,4606,나주시,공산면,선거일투표,1201,536,104,155,28,237,524,12,665
4600,전라남도,나주시라선거구,6460604,4606,나주시,동강면,계,2138,1322,181,817,99,154,1251,71,816
4600,전라남도,나주시라선거구,6460604,4606,나주시,동강면,관내사전투표,736,734,94,443,56,86,679,55,2
4600,전라남도,나주시라선거구,6460604,4606,나주시,동강면,선거일투표,1402,588,87,374,43,68,572,16,814
4600,전라남도,나주시라선거구,6460604,4606,나주시,다시면,계,3200,2008,365,84,1358,102,1909,99,1192
4600,전라남도,나주시라선거구,6460604,4606,나주시,다시면,관내사전투표,1370,1361,232,53,928,65,1278,83,9
4600,전라남도,나주시라선거구,6460604,4606,나주시,다시면,선거일투표,1830,647,133,31,430,37,631,16,1183
4600,전라남도,나주시라선거구,6460604,4606,나주시,문평면,계,1556,964,205,118,530,59,912,52,592
4600,전라남도,나주시라선거구,6460604,4606,나주시,문평면,관내사전투표,614,608,129,85,324,35,573,35,6
4600,전라남도,나주시라선거구,6460604,4606,나주시,문평면,선거일투표,942,356,76,33,206,24,339,17,586
4600,전라남도,나주시라선거구,6460604,4606,나주시,잘못 투입·구분된 투표지,,0,30,7,1,18,4,30,0,-30
4600,전라남도,나주시마선거구,6460605,4606,나주시,합계,,28820,13443,3020,1476,1476,2325,1081,3439,310,13127,316,15377
4600,전라남도,나주시마선거구,6460605,4606,나주시,거소투표,,21,18,4,4,0,2,2,1,0,13,5,3
4600,전라남도,나주시마선거구,6460605,4606,나주시,관외사전투표,,2709,2708,693,321,261,559,230,523,51,2638,70,1
4600,전라남도,나주시마선거구,6460605,4606,나주시,빛가람동,계,26090,10717,2323,1151,1215,1764,849,2915,259,10476,241,15373
4600,전라남도,나주시마선거구,6460605,4606,나주시,빛가람동,관내사전투표,3756,3756,816,441,454,627,268,990,85,3681,75,0
4600,전라남도,나주시마선거구,6460605,4606,나주시,빛가람동,선거일투표,22334,6961,1507,710,761,1137,581,1925,174,6795,166,15373
4600,전라남도,나주시마선거구,6460605,4606,나주시,잘못 투입·구분된 투표지,,0,0,0,0,0,0,0,0,0,0,0,0
4600,전라남도,광양시가선거구,6460701,4607,광양시,합계,,40374,22712,6956,4059,3307,1710,2914,3062,22008,704,17662
4600,전라남도,광양시가선거구,6460701,4607,광양시,거소투표,,82,79,35,9,5,6,11,8,74,5,3
4600,전라남도,광양시가선거구,6460701,4607,광양시,관외사전투표,,3235,3235,1079,554,412,326,398,367,3136,99,0
4600,전라남도,광양시가선거구,6460701,4607,광양시,광양읍,계,37057,19392,5838,3496,2889,1378,2505,2686,18792,600,17665
4600,전라남도,광양시가선거구,6460701,4607,광양시,광양읍,관내사전투표,6443,6443,2047,1139,986,392,780,962,6306,137,0
4600,전라남도,광양시가선거구,6460701,4607,광양시,광양읍,선거일투표,30614,12949,3791,2357,1903,986,1725,1724,12486,463,17665
4600,전라남도,광양시가선거구,6460701,4607,광양시,잘못 투입·구분된 투표지,,0,6,4,0,1,0,0,1,6,0,-6
4600,전라남도,광양시나선거구,6460702,4607,광양시,합계,,26221,15714,3240,3011,2501,2786,1289,2214,15041,673,10507
4600,전라남도,광양시나선거구,6460702,4607,광양시,거소투표,,62,56,13,8,8,4,3,12,48,8,6
4600,전라남도,광양시나선거구,6460702,4607,광양시,관외사전투표,,1735,1735,426,457,259,280,94,137,1653,82,0
4600,전라남도,광양시나선거구,6460702,4607,광양시,봉강면,계,1782,1072,230,224,161,189,65,140,1009,63,710
4600,전라남도,광양시나선거구,6460702,4607,광양시,봉강면,관내사전투표,464,464,83,96,74,101,18,66,438,26,0
4600,전라남도,광양시나선거구,6460702,4607,광양시,봉강면,선거일투표,1318,608,147,128,87,88,47,74,571,37,710
4600,전라남도,광양시나선거구,6460702,4607,광양시,옥룡면,계,2603,1646,350,423,243,250,91,169,1526,120,957
4600,전라남도,광양시나선거구,6460702,4607,광양시,옥룡면,관내사전투표,814,814,157,228,128,122,49,81,765,49,0
4600,전라남도,광양시나선거구,6460702,4607,광양시,옥룡면,선거일투표,1789,832,193,195,115,128,42,88,761,71,957
4600,전라남도,광양시나선거구,6460702,4607,광양시,옥곡면,계,3846,2117,222,455,250,527,75,535,2064,53,1729
4600,전라남도,광양시나선거구,6460702,4607,광양시,옥곡면,관내사전투표,1014,1014,91,188,132,278,31,262,982,32,0
4600,전라남도,광양시나선거구,6460702,4607,광양시,옥곡면,선거일투표,2832,1103,131,267,118,249,44,273,1082,21,1729
4600,전라남도,광양시나선거구,6460702,4607,광양시,진상면,계,2412,1566,167,172,292,136,598,114,1479,87,846
4600,전라남도,광양시나선거구,6460702,4607,광양시,진상면,관내사전투표,798,798,84,92,154,60,301,63,754,44,0
4600,전라남도,광양시나선거구,6460702,4607,광양시,진상면,선거일투표,1614,768,83,80,138,76,297,51,725,43,846
4600,전라남도,광양시나선거구,6460702,4607,광양시,진월면,계,2437,1534,186,217,598,310,52,113,1476,58,903
4600,전라남도,광양시나선거구,6460702,4607,광양시,진월면,관내사전투표,639,638,71,94,260,130,18,44,617,21,1
4600,전라남도,광양시나선거구,6460702,4607,광양시,진월면,선거일투표,1798,896,115,123,338,180,34,69,859,37,902
4600,전라남도,광양시나선거구,6460702,4607,광양시,다압면,계,1495,943,184,142,227,247,35,65,900,43,552
4600,전라남도,광양시나선거구,6460702,4607,광양시,다압면,관내사전투표,460,460,87,64,120,115,14,39,439,21,0
4600,전라남도,광양시나선거구,6460702,4607,광양시,다압면,선거일투표,1035,483,97,78,107,132,21,26,461,22,552
4600,전라남도,광양시나선거구,6460702,4607,광양시,광영동,계,9849,5045,1462,913,463,843,276,929,4886,159,4804
4600,전라남도,광양시나선거구,6460702,4607,광양시,광영동,관내사전투표,2431,2431,700,454,233,391,133,444,2355,76,0
4600,전라남도,광양시나선거구,6460702,4607,광양시,광영동,선거일투표,7418,2614,762,459,230,452,143,485,2531,83,4804
4600,전라남도,광양시나선거구,6460702,4607,광양시,잘못 투입·구분된 투표지,,0,0,0,0,0,0,0,0,0,0,0
4600,전라남도,광양시다선거구,6460703,4607,광양시,합계,,32458,15392,3214,3980,1367,3435,2979,14975,417,17066
4600,전라남도,광양시다선거구,6460703,4607,광양시,거소투표,,49,43,15,12,2,2,8,39,4,6
4600,전라남도,광양시다선거구,6460703,4607,광양시,관외사전투표,,1800,1799,437,462,168,338,328,1733,66,1
4600,전라남도,광양시다선거구,6460703,4607,광양시,중마동,계,30609,13531,2754,3502,1195,3091,2642,13184,347,17078
4600,전라남도,광양시다선거구,6460703,4607,광양시,중마동,관내사전투표,4970,4955,998,1300,428,1151,951,4828,127,15
4600,전라남도,광양시다선거구,6460703,4607,광양시,중마동,선거일투표,25639,8576,1756,2202,767,1940,1691,8356,220,17063
4600,전라남도,광양시다선거구,6460703,4607,광양시,잘못 투입·구분된 투표지,,0,19,8,4,2,4,1,19,0,-19
4600,전라남도,광양시라선거구,6460704,4607,광양시,합계,,27551,15280,4598,3605,2656,3820,14679,601,12271
4600,전라남도,광양시라선거구,6460704,4607,광양시,거소투표,,31,30,6,9,4,9,28,2,1
4600,전라남도,광양시라선거구,6460704,4607,광양시,관외사전투표,,2014,2014,709,424,319,497,1949,65,0
4600,전라남도,광양시라선거구,6460704,4607,광양시,골약동,계,3158,1629,607,297,257,364,1525,104,1529
4600,전라남도,광양시라선거구,6460704,4607,광양시,골약동,관내사전투표,630,626,216,125,105,151,597,29,4
4600,전라남도,광양시라선거구,6460704,4607,광양시,골약동,선거일투표,2528,1003,391,172,152,213,928,75,1525
4600,전라남도,광양시라선거구,6460704,4607,광양시,중마동,계,11983,5926,1822,1275,1245,1391,5733,193,6057
4600,전라남도,광양시라선거구,6460704,4607,광양시,중마동,관내사전투표,2158,2152,680,476,501,443,2100,52,6
4600,전라남도,광양시라선거구,6460704,4607,광양시,중마동,선거일투표,9825,3774,1142,799,744,948,3633,141,6051
4600,전라남도,광양시라선거구,6460704,4607,광양시,태인동,계,1432,885,240,106,292,184,822,63,547
4600,전라남도,광양시라선거구,6460704,4607,광양시,태인동,관내사전투표,492,492,132,44,184,95,455,37,0
4600,전라남도,광양시라선거구,6460704,4607,광양시,태인동,선거일투표,940,393,108,62,108,89,367,26,547
4600,전라남도,광양시라선거구,6460704,4607,광양시,금호동,계,8933,4781,1208,1490,538,1371,4607,174,4152
4600,전라남도,광양시라선거구,6460704,4607,광양시,금호동,관내사전투표,2047,2044,485,689,254,559,1987,57,3
4600,전라남도,광양시라선거구,6460704,4607,광양시,금호동,선거일투표,6886,2737,723,801,284,812,2620,117,4149
4600,전라남도,광양시라선거구,6460704,4607,광양시,잘못 투입·구분된 투표지,,0,15,6,4,1,4,15,0,-15
4600,전라남도,담양군가선거구,6460801,4608,담양군,합계,,13167,8234,2573,1847,2205,1329,7954,280,4933
4600,전라남도,담양군가선거구,6460801,4608,담양군,거소투표,,60,60,30,18,6,4,58,2,0
4600,전라남도,담양군가선거구,6460801,4608,담양군,관외사전투표,,1542,1541,474,384,427,198,1483,58,1
4600,전라남도,담양군가선거구,6460801,4608,담양군,담양읍,계,11565,6628,2067,1443,1772,1126,6408,220,4937
4600,전라남도,담양군가선거구,6460801,4608,담양군,담양읍,관내사전투표,2767,2763,859,623,736,440,2658,105,4
4600,전라남도,담양군가선거구,6460801,4608,담양군,담양읍,선거일투표,8798,3865,1208,820,1036,686,3750,115,4933
4600,전라남도,담양군가선거구,6460801,4608,담양군,잘못 투입·구분된 투표지,,0,5,2,2,0,1,5,0,-5
4600,전라남도,담양군나선거구,6460802,4608,담양군,합계,,8798,5879,1420,1285,1350,1544,5599,280,2919
4600,전라남도,담양군나선거구,6460802,4608,담양군,거소투표,,39,33,9,5,9,8,31,2,6
4600,전라남도,담양군나선거구,6460802,4608,담양군,관외사전투표,,781,781,208,208,181,159,756,25,0
4600,전라남도,담양군나선거구,6460802,4608,담양군,무정면,계,2234,1296,283,109,731,104,1227,69,938
4600,전라남도,담양군나선거구,6460802,4608,담양군,무정면,관내사전투표,760,760,153,58,441,54,706,54,0
4600,전라남도,담양군나선거구,6460802,4608,담양군,무정면,선거일투표,1474,536,130,51,290,50,521,15,938
4600,전라남도,담양군나선거구,6460802,4608,담양군,금성면,계,2183,1389,319,170,208,617,1314,75,794
4600,전라남도,담양군나선거구,6460802,4608,담양군,금성면,관내사전투표,808,794,169,98,126,349,742,52,14
4600,전라남도,담양군나선거구,6460802,4608,담양군,금성면,선거일투표,1375,595,150,72,82,268,572,23,780
4600,전라남도,담양군나선거구,6460802,4608,담양군,용면,계,1536,1083,249,458,65,271,1043,40,453
4600,전라남도,담양군나선거구,6460802,4608,담양군,용면,관내사전투표,585,583,137,248,29,139,553,30,2
4600,전라남도,담양군나선거구,6460802,4608,담양군,용면,선거일투표,951,500,112,210,36,132,490,10,451
4600,전라남도,담양군나선거구,6460802,4608,담양군,월산면,계,2025,1278,346,335,156,375,1212,66,747
4600,전라남도,담양군나선거구,6460802,4608,담양군,월산면,관내사전투표,792,790,215,209,87,230,741,49,2
4600,전라남도,담양군나선거구,6460802,4608,담양군,월산면,선거일투표,1233,488,131,126,69,145,471,17,745
4600,전라남도,담양군나선거구,6460802,4608,담양군,잘못 투입·구분된 투표지,,0,19,6,0,0,10,16,3,-19
4600,전라남도,담양군다선거구,6460803,4608,담양군,합계,,10663,6567,2589,1360,1507,773,6229,338,4096
4600,전라남도,담양군다선거구,6460803,4608,담양군,거소투표,,25,23,11,2,7,1,21,2,2
4600,전라남도,담양군다선거구,6460803,4608,담양군,관외사전투표,,818,814,364,193,143,86,786,28,4
4600,전라남도,담양군다선거구,6460803,4608,담양군,봉산면,계,2300,1396,727,302,181,123,1333,63,904
4600,전라남도,담양군다선거구,6460803,4608,담양군,봉산면,관내사전투표,750,749,396,158,91,66,711,38,1
4600,전라남도,담양군다선거구,6460803,4608,담양군,봉산면,선거일투표,1550,647,331,144,90,57,622,25,903
4600,전라남도,담양군다선거구,6460803,4608,담양군,수북면,계,3937,2345,1055,583,144,429,2211,134,1592
4600,전라남도,담양군다선거구,6460803,4608,담양군,수북면,관내사전투표,1231,1229,595,276,75,211,1157,72,2
4600,전라남도,담양군다선거구,6460803,4608,담양군,수북면,선거일투표,2706,1116,460,307,69,218,1054,62,1590
4600,전라남도,담양군다선거구,6460803,4608,담양군,대전면,계,3583,1966,425,277,1026,127,1855,111,1617
4600,전라남도,담양군다선거구,6460803,4608,담양군,대전면,관내사전투표,1023,1018,217,125,558,69,969,49,5
4600,전라남도,담양군다선거구,6460803,4608,담양군,대전면,선거일투표,2560,948,208,152,468,58,886,62,1612
4600,전라남도,담양군다선거구,6460803,4608,담양군,잘못 투입·구분된 투표지,,0,23,7,3,6,7,23,0,-23
4600,전라남도,담양군라선거구,6460804,4608,담양군,합계,,9092,5935,2195,1370,608,1494,5667,268,3157
4600,전라남도,담양군라선거구,6460804,4608,담양군,거소투표,,14,13,9,2,0,1,12,1,1
4600,전라남도,담양군라선거구,6460804,4608,담양군,관외사전투표,,768,767,324,179,75,165,743,24,1
4600,전라남도,담양군라선거구,6460804,4608,담양군,고서면,계,2680,1692,268,576,251,523,1618,74,988
4600,전라남도,담양군라선거구,6460804,4608,담양군,고서면,관내사전투표,1123,1109,180,372,165,345,1062,47,14
4600,전라남도,담양군라선거구,6460804,4608,담양군,고서면,선거일투표,1557,583,88,204,86,178,556,27,974
4600,전라남도,담양군라선거구,6460804,4608,담양군,가사문학면,계,1024,641,164,181,73,190,608,33,383
4600,전라남도,담양군라선거구,6460804,4608,담양군,가사문학면,관내사전투표,430,430,109,119,42,135,405,25,0
4600,전라남도,담양군라선거구,6460804,4608,담양군,가사문학면,선거일투표,594,211,55,62,31,55,203,8,383
4600,전라남도,담양군라선거구,6460804,4608,담양군,창평면,계,3035,1904,1072,266,123,348,1809,95,1131
4600,전라남도,담양군라선거구,6460804,4608,담양군,창평면,관내사전투표,1222,1219,711,167,67,200,1145,74,3
4600,전라남도,담양군라선거구,6460804,4608,담양군,창평면,선거일투표,1813,685,361,99,56,148,664,21,1128
4600,전라남도,담양군라선거구,6460804,4608,담양군,대덕면,계,1571,900,353,161,85,260,859,41,671
4600,전라남도,담양군라선거구,6460804,4608,담양군,대덕면,관내사전투표,484,484,201,77,30,157,465,19,0
4600,전라남도,담양군라선거구,6460804,4608,담양군,대덕면,선거일투표,1087,416,152,84,55,103,394,22,671
4600,전라남도,담양군라선거구,6460804,4608,담양군,잘못 투입·구분된 투표지,,0,18,5,5,1,7,18,0,-18
4600,전라남도,장성군가선거구,6460901,4609,장성군,합계,,18835,13516,4226,2232,1852,2100,2078,430,12918,598,5319
4600,전라남도,장성군가선거구,6460901,4609,장성군,거소투표,,98,89,29,9,19,14,8,3,82,7,9
4600,전라남도,장성군가선거구,6460901,4609,장성군,관외사전투표,,1537,1536,552,255,175,300,165,49,1496,40,1
4600,전라남도,장성군가선거구,6460901,4609,장성군,장성읍,계,10419,7083,2250,1439,437,1174,1376,139,6815,268,3336
4600,전라남도,장성군가선거구,6460901,4609,장성군,장성읍,관내사전투표,4243,4243,1365,846,242,741,794,80,4068,175,0
4600,전라남도,장성군가선거구,6460901,4609,장성군,장성읍,선거일투표,6176,2840,885,593,195,433,582,59,2747,93,3336
4600,전라남도,장성군가선거구,6460901,4609,장성군,서삼면,계,1288,898,293,131,70,168,151,30,843,55,390
4600,전라남도,장성군가선거구,6460901,4609,장성군,서삼면,관내사전투표,590,590,184,85,40,124,90,19,542,48,0
4600,전라남도,장성군가선거구,6460901,4609,장성군,서삼면,선거일투표,698,308,109,46,30,44,61,11,301,7,390
4600,전라남도,장성군가선거구,6460901,4609,장성군,북일면,계,1270,953,314,137,117,147,161,27,903,50,317
4600,전라남도,장성군가선거구,6460901,4609,장성군,북일면,관내사전투표,585,585,182,90,72,85,105,13,547,38,0
4600,전라남도,장성군가선거구,6460901,4609,장성군,북일면,선거일투표,685,368,132,47,45,62,56,14,356,12,317
4600,전라남도,장성군가선거구,6460901,4609,장성군,북이면,계,2395,1692,406,135,724,122,71,143,1601,91,703
4600,전라남도,장성군가선거구,6460901,4609,장성군,북이면,관내사전투표,1233,1233,311,98,513,96,54,91,1163,70,0
4600,전라남도,장성군가선거구,6460901,4609,장성군,북이면,선거일투표,1162,459,95,37,211,26,17,52,438,21,703
4600,전라남도,장성군가선거구,6460901,4609,장성군,북하면,계,1828,1262,380,125,310,175,146,39,1175,87,566
4600,전라남도,장성군가선거구,6460901,4609,장성군,북하면,관내사전투표,870,869,254,76,222,126,106,19,803,66,1
4600,전라남도,장성군가선거구,6460901,4609,장성군,북하면,선거일투표,958,393,126,49,88,49,40,20,372,21,565
4600,전라남도,장성군가선거구,6460901,4609,장성군,잘못 투입·구분된 투표지,,0,3,2,1,0,0,0,0,3,0,-3
4600,전라남도,장성군나선거구,6460902,4609,장성군,합계,,10271,6789,3777,1327,1324,6428,361,3482
4600,전라남도,장성군나선거구,6460902,4609,장성군,거소투표,,40,32,15,6,9,30,2,8
4600,전라남도,장성군나선거구,6460902,4609,장성군,관외사전투표,,1179,1179,640,264,222,1126,53,0
4600,전라남도,장성군나선거구,6460902,4609,장성군,진원면,계,2793,1758,915,209,551,1675,83,1035
4600,전라남도,장성군나선거구,6460902,4609,장성군,진원면,관내사전투표,982,980,517,135,270,922,58,2
4600,전라남도,장성군나선거구,6460902,4609,장성군,진원면,선거일투표,1811,778,398,74,281,753,25,1033
4600,전라남도,장성군나선거구,6460902,4609,장성군,남면,계,3126,1804,1327,180,207,1714,90,1322
4600,전라남도,장성군나선거구,6460902,4609,장성군,남면,관내사전투표,1023,1023,766,96,105,967,56,0
4600,전라남도,장성군나선거구,6460902,4609,장성군,남면,선거일투표,2103,781,561,84,102,747,34,1322
4600,전라남도,장성군나선거구,6460902,4609,장성군,황룡면,계,3133,2012,880,667,332,1879,133,1121
4600,전라남도,장성군나선거구,6460902,4609,장성군,황룡면,관내사전투표,1042,1038,452,350,150,952,86,4
4600,전라남도,장성군나선거구,6460902,4609,장성군,황룡면,선거일투표,2091,974,428,317,182,927,47,1117
4600,전라남도,장성군나선거구,6460902,4609,장성군,잘못 투입·구분된 투표지,,0,4,0,1,3,4,0,-4
4600,전라남도,장성군다선거구,6460903,4609,장성군,합계,,9364,6197,1938,1010,1694,1170,5812,385,3167
4600,전라남도,장성군다선거구,6460903,4609,장성군,거소투표,,38,34,12,6,4,9,31,3,4
4600,전라남도,장성군다선거구,6460903,4609,장성군,관외사전투표,,829,828,367,145,175,112,799,29,1
4600,전라남도,장성군다선거구,6460903,4609,장성군,동화면,계,1556,1096,240,519,128,130,1017,79,460
4600,전라남도,장성군다선거구,6460903,4609,장성군,동화면,관내사전투표,649,647,145,314,63,78,600,47,2
4600,전라남도,장성군다선거구,6460903,4609,장성군,동화면,선거일투표,907,449,95,205,65,52,417,32,458
4600,전라남도,장성군다선거구,6460903,4609,장성군,삼서면,계,2528,1692,258,93,684,536,1571,121,836
4600,전라남도,장성군다선거구,6460903,4609,장성군,삼서면,관내사전투표,1094,1093,182,53,433,344,1012,81,1
4600,전라남도,장성군다선거구,6460903,4609,장성군,삼서면,선거일투표,1434,599,76,40,251,192,559,40,835
4600,전라남도,장성군다선거구,6460903,4609,장성군,삼계면,계,4413,2543,1060,246,702,383,2391,152,1870
4600,전라남도,장성군다선거구,6460903,4609,장성군,삼계면,관내사전투표,1578,1576,696,137,438,215,1486,90,2
4600,전라남도,장성군다선거구,6460903,4609,장성군,삼계면,선거일투표,2835,967,364,109,264,168,905,62,1868
4600,전라남도,장성군다선거구,6460903,4609,장성군,잘못 투입·구분된 투표지,,0,4,1,1,1,0,3,1,-4
4600,전라남도,곡성군가선거구,6461001,4610,곡성군,합계,,12719,9552,2231,1564,949,1170,1412,1747,9073,479,3167
4600,전라남도,곡성군가선거구,6461001,4610,곡성군,거소투표,,48,43,14,5,2,4,6,10,41,2,5
4600,전라남도,곡성군가선거구,6461001,4610,곡성군,관외사전투표,,1039,1038,312,143,116,116,119,189,995,43,1
4600,전라남도,곡성군가선거구,6461001,4610,곡성군,곡성읍,계,6378,4727,956,768,537,790,537,955,4543,184,1651
4600,전라남도,곡성군가선거구,6461001,4610,곡성군,곡성읍,관내사전투표,2505,2504,557,403,286,363,290,505,2404,100,1
4600,전라남도,곡성군가선거구,6461001,4610,곡성군,곡성읍,선거일투표,3873,2223,399,365,251,427,247,450,2139,84,1650
4600,전라남도,곡성군가선거구,6461001,4610,곡성군,오곡면,계,1593,1220,183,192,119,105,371,186,1156,64,373
4600,전라남도,곡성군가선거구,6461001,4610,곡성군,오곡면,관내사전투표,683,683,110,113,74,62,185,104,648,35,0
4600,전라남도,곡성군가선거구,6461001,4610,곡성군,오곡면,선거일투표,910,537,73,79,45,43,186,82,508,29,373
4600,전라남도,곡성군가선거구,6461001,4610,곡성군,목사동면,계,1082,696,235,100,40,29,163,97,664,32,386
4600,전라남도,곡성군가선거구,6461001,4610,곡성군,목사동면,관내사전투표,447,447,142,65,22,22,108,65,424,23,0
4600,전라남도,곡성군가선거구,6461001,4610,곡성군,목사동면,선거일투표,635,249,93,35,18,7,55,32,240,9,386
4600,전라남도,곡성군가선거구,6461001,4610,곡성군,죽곡면,계,1536,1063,338,120,87,55,162,225,987,76,473
4600,전라남도,곡성군가선거구,6461001,4610,곡성군,죽곡면,관내사전투표,664,664,215,68,55,25,101,152,616,48,0
4600,전라남도,곡성군가선거구,6461001,4610,곡성군,죽곡면,선거일투표,872,399,123,52,32,30,61,73,371,28,473
4600,전라남도,곡성군가선거구,6461001,4610,곡성군,고달면,계,1043,763,193,236,48,71,52,85,685,78,280
4600,전라남도,곡성군가선거구,6461001,4610,곡성군,고달면,관내사전투표,436,436,108,117,20,47,31,54,377,59,0
4600,전라남도,곡성군가선거구,6461001,4610,곡성군,고달면,선거일투표,607,327,85,119,28,24,21,31,308,19,280
4600,전라남도,곡성군가선거구,6461001,4610,곡성군,잘못 투입·구분된 투표지,,0,2,0,0,0,0,2,0,2,0,-2
4600,전라남도,곡성군나선거구,6461002,4610,곡성군,합계,,12477,9092,1572,1623,1101,1006,1136,242,913,1120,8713,379,3385
4600,전라남도,곡성군나선거구,6461002,4610,곡성군,거소투표,,31,30,4,5,3,5,3,0,3,5,28,2,1
4600,전라남도,곡성군나선거구,6461002,4610,곡성군,관외사전투표,,1009,1009,214,220,133,102,101,20,110,75,975,34,0
4600,전라남도,곡성군나선거구,6461002,4610,곡성군,삼기면,계,1406,968,122,157,77,184,93,20,170,94,917,51,438
4600,전라남도,곡성군나선거구,6461002,4610,곡성군,삼기면,관내사전투표,552,552,64,87,51,100,51,8,94,63,518,34,0
4600,전라남도,곡성군나선거구,6461002,4610,곡성군,삼기면,선거일투표,854,416,58,70,26,84,42,12,76,31,399,17,438
4600,전라남도,곡성군나선거구,6461002,4610,곡성군,석곡면,계,1975,1482,97,52,34,303,70,8,306,537,1407,75,493
4600,전라남도,곡성군나선거구,6461002,4610,곡성군,석곡면,관내사전투표,1018,1017,66,29,26,231,51,6,194,349,952,65,1
4600,전라남도,곡성군나선거구,6461002,4610,곡성군,석곡면,선거일투표,957,465,31,23,8,72,19,2,112,188,455,10,492
4600,전라남도,곡성군나선거구,6461002,4610,곡성군,옥과면,계,3567,2461,790,386,231,147,367,135,179,140,2375,86,1106
4600,전라남도,곡성군나선거구,6461002,4610,곡성군,옥과면,관내사전투표,1375,1375,447,210,146,81,203,73,79,85,1324,51,0
4600,전라남도,곡성군나선거구,6461002,4610,곡성군,옥과면,선거일투표,2192,1086,343,176,85,66,164,62,100,55,1051,35,1106
4600,전라남도,곡성군나선거구,6461002,4610,곡성군,입면,계,1924,1378,105,526,510,68,69,16,13,20,1327,51,546
4600,전라남도,곡성군나선거구,6461002,4610,곡성군,입면,관내사전투표,853,853,64,321,302,49,43,12,7,14,812,41,0
4600,전라남도,곡성군나선거구,6461002,4610,곡성군,입면,선거일투표,1071,525,41,205,208,19,26,4,6,6,515,10,546
4600,전라남도,곡성군나선거구,6461002,4610,곡성군,겸면,계,1372,986,98,115,70,145,349,21,88,42,928,58,386
4600,전라남도,곡성군나선거구,6461002,4610,곡성군,겸면,관내사전투표,559,559,58,62,45,76,197,11,50,24,523,36,0
4600,전라남도,곡성군나선거구,6461002,4610,곡성군,겸면,선거일투표,813,427,40,53,25,69,152,10,38,18,405,22,386
4600,전라남도,곡성군나선거구,6461002,4610,곡성군,오산면,계,1193,778,142,162,43,52,84,22,44,207,756,22,415
4600,전라남도,곡성군나선거구,6461002,4610,곡성군,오산면,관내사전투표,421,421,77,86,23,30,40,8,25,125,414,7,0
4600,전라남도,곡성군나선거구,6461002,4610,곡성군,오산면,선거일투표,772,357,65,76,20,22,44,14,19,82,342,15,415
4600,전라남도,곡성군나선거구,6461002,4610,곡성군,잘못 투입·구분된 투표지,,0,0,0,0,0,0,0,0,0,0,0,0,0
4600,전라남도,구례군가선거구,6461101,4611,구례군,합계,,11932,9208,1682,1369,946,507,409,934,69,1255,1726,8897,311,2724
4600,전라남도,구례군가선거구,6461101,4611,구례군,거소투표,,97,92,11,11,9,1,2,11,0,19,20,84,8,5
4600,전라남도,구례군가선거구,6461101,4611,구례군,관외사전투표,,1134,1134,287,224,108,53,48,64,7,107,201,1099,35,0
4600,전라남도,구례군가선거구,6461101,4611,구례군,구례읍,계,8126,6016,1025,604,648,338,296,753,56,905,1205,5830,186,2110
4600,전라남도,구례군가선거구,6461101,4611,구례군,구례읍,관내사전투표,2657,2657,476,304,285,138,143,291,24,361,560,2582,75,0
4600,전라남도,구례군가선거구,6461101,4611,구례군,구례읍,선거일투표,5469,3359,549,300,363,200,153,462,32,544,645,3248,111,2110
4600,전라남도,구례군가선거구,6461101,4611,구례군,문척면,계,1257,971,257,102,94,65,26,68,5,113,202,932,39,286
4600,전라남도,구례군가선거구,6461101,4611,구례군,문척면,관내사전투표,554,554,140,81,58,39,14,39,2,62,100,535,19,0
4600,전라남도,구례군가선거구,6461101,4611,구례군,문척면,선거일투표,703,417,117,21,36,26,12,29,3,51,102,397,20,286
4600,전라남도,구례군가선거구,6461101,4611,구례군,간전면,계,1318,995,102,428,87,50,37,38,1,111,98,952,43,323
4600,전라남도,구례군가선거구,6461101,4611,구례군,간전면,관내사전투표,488,488,48,215,44,27,19,15,0,55,47,470,18,0
4600,전라남도,구례군가선거구,6461101,4611,구례군,간전면,선거일투표,830,507,54,213,43,23,18,23,1,56,51,482,25,323
4600,전라남도,구례군가선거구,6461101,4611,구례군,잘못 투입·구분된 투표지,,0,0,0,0,0,0,0,0,0,0,0,0,0,0
4600,전라남도,구례군나선거구,6461102,4611,구례군,합계,,10916,8209,2051,831,1053,2014,1879,7828,381,2707
4600,전라남도,구례군나선거구,6461102,4611,구례군,거소투표,,58,57,12,5,4,15,15,51,6,1
4600,전라남도,구례군나선거구,6461102,4611,구례군,관외사전투표,,878,878,245,96,131,197,180,849,29,0
4600,전라남도,구례군나선거구,6461102,4611,구례군,토지면,계,2067,1500,421,204,139,445,212,1421,79,567
4600,전라남도,구례군나선거구,6461102,4611,구례군,토지면,관내사전투표,735,732,227,104,63,207,96,697,35,3
4600,전라남도,구례군나선거구,6461102,4611,구례군,토지면,선거일투표,1332,768,194,100,76,238,116,724,44,564
4600,전라남도,구례군나선거구,6461102,4611,구례군,마산면,계,2227,1606,257,264,118,661,226,1526,80,621
4600,전라남도,구례군나선거구,6461102,4611,구례군,마산면,관내사전투표,911,910,162,163,70,351,112,858,52,1
4600,전라남도,구례군나선거구,6461102,4611,구례군,마산면,선거일투표,1316,696,95,101,48,310,114,668,28,620
4600,전라남도,구례군나선거구,6461102,4611,구례군,광의면,계,1898,1340,516,113,115,329,205,1278,62,558
4600,전라남도,구례군나선거구,6461102,4611,구례군,광의면,관내사전투표,596,594,258,58,42,129,69,556,38,2
4600,전라남도,구례군나선거구,6461102,4611,구례군,광의면,선거일투표,1302,746,258,55,73,200,136,722,24,556
4600,전라남도,구례군나선거구,6461102,4611,구례군,용방면,계,1252,954,443,67,48,173,171,902,52,298
4600,전라남도,구례군나선거구,6461102,4611,구례군,용방면,관내사전투표,508,506,247,45,22,77,86,477,29,2
4600,전라남도,구례군나선거구,6461102,4611,구례군,용방면,선거일투표,744,448,196,22,26,96,85,425,23,296
4600,전라남도,구례군나선거구,6461102,4611,구례군,산동면,계,2536,1862,154,82,495,194,866,1791,71,674
4600,전라남도,구례군나선거구,6461102,4611,구례군,산동면,관내사전투표,849,844,65,53,250,88,364,820,24,5
4600,전라남도,구례군나선거구,6461102,4611,구례군,산동면,선거일투표,1687,1018,89,29,245,106,502,971,47,669
4600,전라남도,구례군나선거구,6461102,4611,구례군,잘못 투입·구분된 투표지,,0,12,3,0,3,0,4,10,2,-12
4600,전라남도,고흥군가선거구,6461201,4612,고흥군,합계,,17006,13256,3900,2174,1004,2049,2110,1306,12543,713,3750
4600,전라남도,고흥군가선거구,6461201,4612,고흥군,거소투표,,196,183,24,10,6,31,89,11,171,12,13
4600,전라남도,고흥군가선거구,6461201,4612,고흥군,관외사전투표,,1679,1678,619,253,144,258,162,171,1607,71,1
4600,전라남도,고흥군가선거구,6461201,4612,고흥군,고흥읍,계,9225,6860,1995,1553,574,1013,637,821,6593,267,2365
4600,전라남도,고흥군가선거구,6461201,4612,고흥군,고흥읍,관내사전투표,3961,3960,1172,868,322,574,397,480,3813,147,1
4600,전라남도,고흥군가선거구,6461201,4612,고흥군,고흥읍,선거일투표,5264,2900,823,685,252,439,240,341,2780,120,2364
4600,전라남도,고흥군가선거구,6461201,4612,고흥군,점암면,계,2224,1681,345,122,91,153,772,81,1564,117,543
4600,전라남도,고흥군가선거구,6461201,4612,고흥군,점암면,관내사전투표,1025,1025,203,67,54,91,480,49,944,81,0
4600,전라남도,고흥군가선거구,6461201,4612,고흥군,점암면,선거일투표,1199,656,142,55,37,62,292,32,620,36,543
4600,전라남도,고흥군가선거구,6461201,4612,고흥군,영남면,계,1081,848,272,50,60,112,226,46,766,82,233
4600,전라남도,고흥군가선거구,6461201,4612,고흥군,영남면,관내사전투표,511,510,144,30,33,70,140,31,448,62,1
4600,전라남도,고흥군가선거구,6461201,4612,고흥군,영남면,선거일투표,570,338,128,20,27,42,86,15,318,20,232
4600,전라남도,고흥군가선거구,6461201,4612,고흥군,두원면,계,2601,2004,645,186,129,480,224,176,1840,164,597
4600,전라남도,고흥군가선거구,6461201,4612,고흥군,두원면,관내사전투표,1288,1288,428,113,82,306,136,100,1165,123,0
4600,전라남도,고흥군가선거구,6461201,4612,고흥군,두원면,선거일투표,1313,716,217,73,47,174,88,76,675,41,597
4600,전라남도,고흥군가선거구,6461201,4612,고흥군,잘못 투입·구분된 투표지,,0,2,0,0,0,2,0,0,2,0,-2
4600,전라남도,고흥군나선거구,6461202,4612,고흥군,합계,,10194,7816,2678,2236,2297,7211,605,2378
4600,전라남도,고흥군나선거구,6461202,4612,고흥군,거소투표,,187,158,37,40,73,150,8,29
4600,전라남도,고흥군나선거구,6461202,4612,고흥군,관외사전투표,,639,638,276,161,177,614,24,1
4600,전라남도,고흥군나선거구,6461202,4612,고흥군,과역면,계,2780,2150,1072,438,483,1993,157,630
4600,전라남도,고흥군나선거구,6461202,4612,고흥군,과역면,관내사전투표,1432,1431,715,283,295,1293,138,1
4600,전라남도,고흥군나선거구,6461202,4612,고흥군,과역면,선거일투표,1348,719,357,155,188,700,19,629
4600,전라남도,고흥군나선거구,6461202,4612,고흥군,남양면,계,1866,1362,644,238,389,1271,91,504
4600,전라남도,고흥군나선거구,6461202,4612,고흥군,남양면,관내사전투표,758,758,359,123,207,689,69,0
4600,전라남도,고흥군나선거구,6461202,4612,고흥군,남양면,선거일투표,1108,604,285,115,182,582,22,504
4600,전라남도,고흥군나선거구,6461202,4612,고흥군,동강면,계,2782,2028,458,533,841,1832,196,754
4600,전라남도,고흥군나선거구,6461202,4612,고흥군,동강면,관내사전투표,1264,1264,277,324,501,1102,162,0
4600,전라남도,고흥군나선거구,6461202,4612,고흥군,동강면,선거일투표,1518,764,181,209,340,730,34,754
4600,전라남도,고흥군나선거구,6461202,4612,고흥군,대서면,계,1940,1475,188,826,332,1346,129,465
4600,전라남도,고흥군나선거구,6461202,4612,고흥군,대서면,관내사전투표,1012,1011,116,566,211,893,118,1
4600,전라남도,고흥군나선거구,6461202,4612,고흥군,대서면,선거일투표,928,464,72,260,121,453,11,464
4600,전라남도,고흥군나선거구,6461202,4612,고흥군,잘못 투입·구분된 투표지,,0,5,3,0,2,5,0,-5
4600,전라남도,고흥군다선거구,6461203,4612,고흥군,합계,,18959,14748,4392,3208,2626,2101,1459,13786,962,4211
4600,전라남도,고흥군다선거구,6461203,4612,고흥군,거소투표,,228,204,55,42,39,33,19,188,16,24
4600,전라남도,고흥군다선거구,6461203,4612,고흥군,관외사전투표,,1075,1075,347,249,191,135,102,1024,51,0
4600,전라남도,고흥군다선거구,6461203,4612,고흥군,도양읍,계,8827,6551,2856,1083,877,596,820,6232,319,2276
4600,전라남도,고흥군다선거구,6461203,4612,고흥군,도양읍,관내사전투표,3769,3760,1672,621,507,336,432,3568,192,9
4600,전라남도,고흥군다선거구,6461203,4612,고흥군,도양읍,선거일투표,5058,2791,1184,462,370,260,388,2664,127,2267
4600,전라남도,고흥군다선거구,6461203,4612,고흥군,풍양면,계,2690,2078,388,135,1130,157,99,1909,169,612
4600,전라남도,고흥군다선거구,6461203,4612,고흥군,풍양면,관내사전투표,1102,1102,222,79,563,85,57,1006,96,0
4600,전라남도,고흥군다선거구,6461203,4612,고흥군,풍양면,선거일투표,1588,976,166,56,567,72,42,903,73,612
4600,전라남도,고흥군다선거구,6461203,4612,고흥군,도덕면,계,2481,1902,479,337,321,316,239,1692,210,579
4600,전라남도,고흥군다선거구,6461203,4612,고흥군,도덕면,관내사전투표,1106,1104,308,200,170,164,119,961,143,2
4600,전라남도,고흥군다선거구,6461203,4612,고흥군,도덕면,선거일투표,1375,798,171,137,151,152,120,731,67,577
4600,전라남도,고흥군다선거구,6461203,4612,고흥군,금산면,계,3658,2927,263,1361,68,862,176,2730,197,731
4600,전라남도,고흥군다선거구,6461203,4612,고흥군,금산면,관내사전투표,2135,2134,184,963,46,660,121,1974,160,1
4600,전라남도,고흥군다선거구,6461203,4612,고흥군,금산면,선거일투표,1523,793,79,398,22,202,55,756,37,730
4600,전라남도,고흥군다선거구,6461203,4612,고흥군,잘못 투입·구분된 투표지,,0,11,4,1,0,2,4,11,0,-11
4600,전라남도,고흥군라선거구,6461204,4612,고흥군,합계,,11212,8845,2934,2584,1560,843,7921,924,2367
4600,전라남도,고흥군라선거구,6461204,4612,고흥군,거소투표,,114,102,32,38,10,15,95,7,12
4600,전라남도,고흥군라선거구,6461204,4612,고흥군,관외사전투표,,818,817,290,237,140,113,780,37,1
4600,전라남도,고흥군라선거구,6461204,4612,고흥군,도화면,계,3448,2741,1437,156,672,143,2408,333,707
4600,전라남도,고흥군라선거구,6461204,4612,고흥군,도화면,관내사전투표,1861,1855,988,116,411,107,1622,233,6
4600,전라남도,고흥군라선거구,6461204,4612,고흥군,도화면,선거일투표,1587,886,449,40,261,36,786,100,701
4600,전라남도,고흥군라선거구,6461204,4612,고흥군,포두면,계,3987,2965,646,1434,339,237,2656,309,1022
4600,전라남도,고흥군라선거구,6461204,4612,고흥군,포두면,관내사전투표,1453,1452,326,683,157,124,1290,162,1
4600,전라남도,고흥군라선거구,6461204,4612,고흥군,포두면,선거일투표,2534,1513,320,751,182,113,1366,147,1021
4600,전라남도,고흥군라선거구,6461204,4612,고흥군,봉래면,계,1599,1235,303,449,237,106,1095,140,364
4600,전라남도,고흥군라선거구,6461204,4612,고흥군,봉래면,관내사전투표,917,915,221,322,183,77,803,112,2
4600,전라남도,고흥군라선거구,6461204,4612,고흥군,봉래면,선거일투표,682,320,82,127,54,29,292,28,362
4600,전라남도,고흥군라선거구,6461204,4612,고흥군,동일면,계,1246,975,220,270,159,228,877,98,271
4600,전라남도,고흥군라선거구,6461204,4612,고흥군,동일면,관내사전투표,684,684,154,202,92,151,599,85,0
4600,전라남도,고흥군라선거구,6461204,4612,고흥군,동일면,선거일투표,562,291,66,68,67,77,278,13,271
4600,전라남도,고흥군라선거구,6461204,4612,고흥군,잘못 투입·구분된 투표지,,0,10,6,0,3,1,10,0,-10
4600,전라남도,보성군가선거구,6461301,4613,보성군,합계,,17453,11388,3390,2108,1668,505,1400,1871,10942,446,6065
4600,전라남도,보성군가선거구,6461301,4613,보성군,거소투표,,77,70,19,19,6,3,6,16,69,1,7
4600,전라남도,보성군가선거구,6461301,4613,보성군,관외사전투표,,938,938,326,209,133,52,94,98,912,26,0
4600,전라남도,보성군가선거구,6461301,4613,보성군,보성읍,계,7107,4468,1228,803,404,209,565,1134,4343,125,2639
4600,전라남도,보성군가선거구,6461301,4613,보성군,보성읍,관내사전투표,2328,2328,695,419,215,100,298,551,2278,50,0
4600,전라남도,보성군가선거구,6461301,4613,보성군,보성읍,선거일투표,4779,2140,533,384,189,109,267,583,2065,75,2639
4600,전라남도,보성군가선거구,6461301,4613,보성군,노동면,계,970,636,190,129,50,37,79,117,602,34,334
4600,전라남도,보성군가선거구,6461301,4613,보성군,노동면,관내사전투표,379,379,106,80,26,23,43,84,362,17,0
4600,전라남도,보성군가선거구,6461301,4613,보성군,노동면,선거일투표,591,257,84,49,24,14,36,33,240,17,334
4600,전라남도,보성군가선거구,6461301,4613,보성군,미력면,계,1220,783,143,112,34,26,354,80,749,34,437
4600,전라남도,보성군가선거구,6461301,4613,보성군,미력면,관내사전투표,414,414,86,72,25,14,154,50,401,13,0
4600,전라남도,보성군가선거구,6461301,4613,보성군,미력면,선거일투표,806,369,57,40,9,12,200,30,348,21,437
4600,전라남도,보성군가선거구,6461301,4613,보성군,득량면,계,3464,2173,998,572,81,57,175,165,2048,125,1291
4600,전라남도,보성군가선거구,6461301,4613,보성군,득량면,관내사전투표,978,978,457,290,30,28,69,65,939,39,0
4600,전라남도,보성군가선거구,6461301,4613,보성군,득량면,선거일투표,2486,1195,541,282,51,29,106,100,1109,86,1291
4600,전라남도,보성군가선거구,6461301,4613,보성군,회천면,계,2666,1633,306,100,919,98,38,107,1568,65,1033
4600,전라남도,보성군가선거구,6461301,4613,보성군,회천면,관내사전투표,699,699,132,38,382,40,16,55,663,36,0
4600,전라남도,보성군가선거구,6461301,4613,보성군,회천면,선거일투표,1967,934,174,62,537,58,22,52,905,29,1033
4600,전라남도,보성군가선거구,6461301,4613,보성군,웅치면,계,1011,687,180,164,41,23,89,154,651,36,324
4600,전라남도,보성군가선거구,6461301,4613,보성군,웅치면,관내사전투표,398,398,97,84,26,12,66,93,378,20,0
4600,전라남도,보성군가선거구,6461301,4613,보성군,웅치면,선거일투표,613,289,83,80,15,11,23,61,273,16,324
4600,전라남도,보성군가선거구,6461301,4613,보성군,잘못 투입·구분된 투표지,,0,0,0,0,0,0,0,0,0,0,0
4600,전라남도,보성군나선거구,6461302,4613,보성군,합계,,10330,6410,1964,1919,884,1358,6125,285,3920
4600,전라남도,보성군나선거구,6461302,4613,보성군,거소투표,,68,66,22,22,2,18,64,2,2
4600,전라남도,보성군나선거구,6461302,4613,보성군,관외사전투표,,526,526,166,167,77,96,506,20,0
4600,전라남도,보성군나선거구,6461302,4613,보성군,벌교읍,계,9736,5817,1775,1730,805,1244,5554,263,3919
4600,전라남도,보성군나선거구,6461302,4613,보성군,벌교읍,관내사전투표,2297,2296,668,700,323,474,2165,131,1
4600,전라남도,보성군나선거구,6461302,4613,보성군,벌교읍,선거일투표,7439,3521,1107,1030,482,770,3389,132,3918
4600,전라남도,보성군나선거구,6461302,4613,보성군,잘못 투입·구분된 투표지,,0,1,1,0,0,0,1,0,-1
4600,전라남도,보성군다선거구,6461303,4613,보성군,합계,,7948,5753,1752,1636,1721,347,5456,297,2195
4600,전라남도,보성군다선거구,6461303,4613,보성군,거소투표,,34,33,7,11,12,2,32,1,1
4600,전라남도,보성군다선거구,6461303,4613,보성군,관외사전투표,,603,603,180,192,192,26,590,13,0
4600,전라남도,보성군다선거구,6461303,4613,보성군,겸백면,계,978,686,108,276,226,37,647,39,292
4600,전라남도,보성군다선거구,6461303,4613,보성군,겸백면,관내사전투표,422,422,68,158,138,25,389,33,0
4600,전라남도,보성군다선거구,6461303,4613,보성군,겸백면,선거일투표,556,264,40,118,88,12,258,6,292
4600,전라남도,보성군다선거구,6461303,4613,보성군,율어면,계,1007,707,79,206,216,174,675,32,300
4600,전라남도,보성군다선거구,6461303,4613,보성군,율어면,관내사전투표,460,460,44,152,127,111,434,26,0
4600,전라남도,보성군다선거구,6461303,4613,보성군,율어면,선거일투표,547,247,35,54,89,63,241,6,300
4600,전라남도,보성군다선거구,6461303,4613,보성군,복내면,계,1359,1058,71,372,538,26,1007,51,301
4600,전라남도,보성군다선거구,6461303,4613,보성군,복내면,관내사전투표,680,680,46,215,353,19,633,47,0
4600,전라남도,보성군다선거구,6461303,4613,보성군,복내면,선거일투표,679,378,25,157,185,7,374,4,301
4600,전라남도,보성군다선거구,6461303,4613,보성군,문덕면,계,752,568,52,267,198,12,529,39,184
4600,전라남도,보성군다선거구,6461303,4613,보성군,문덕면,관내사전투표,395,395,38,189,126,5,358,37,0
4600,전라남도,보성군다선거구,6461303,4613,보성군,문덕면,선거일투표,357,173,14,78,72,7,171,2,184
4600,전라남도,보성군다선거구,6461303,4613,보성군,조성면,계,3215,2098,1255,312,339,70,1976,122,1117
4600,전라남도,보성군다선거구,6461303,4613,보성군,조성면,관내사전투표,1402,1401,850,184,216,48,1298,103,1
4600,전라남도,보성군다선거구,6461303,4613,보성군,조성면,선거일투표,1813,697,405,128,123,22,678,19,1116
4600,전라남도,보성군다선거구,6461303,4613,보성군,잘못 투입·구분된 투표지,,0,0,0,0,0,0,0,0,0
4600,전라남도,화순군가선거구,6461401,4614,화순군,합계,,33709,18319,3275,3171,2889,3103,373,3364,1629,17804,515,15390
4600,전라남도,화순군가선거구,6461401,4614,화순군,거소투표,,52,48,11,9,9,5,4,2,3,43,5,4
4600,전라남도,화순군가선거구,6461401,4614,화순군,관외사전투표,,2232,2229,521,385,305,366,60,341,192,2170,59,3
4600,전라남도,화순군가선거구,6461401,4614,화순군,화순읍,계,31425,16042,2743,2777,2575,2732,309,3021,1434,15591,451,15383
4600,전라남도,화순군가선거구,6461401,4614,화순군,화순읍,관내사전투표,5787,5787,1086,1083,826,1114,121,982,461,5673,114,0
4600,전라남도,화순군가선거구,6461401,4614,화순군,화순읍,선거일투표,25638,10255,1657,1694,1749,1618,188,2039,973,9918,337,15383
4600,전라남도,화순군가선거구,6461401,4614,화순군,잘못 투입·구분된 투표지,,0,0,0,0,0,0,0,0,0,0,0,0
4600,전라남도,화순군나선거구,6461402,4614,화순군,합계,,12526,8189,2250,1237,995,1049,1089,1241,7861,328,4337
4600,전라남도,화순군나선거구,6461402,4614,화순군,거소투표,,26,19,3,2,7,1,3,3,19,0,7
4600,전라남도,화순군나선거구,6461402,4614,화순군,관외사전투표,,1022,1021,352,157,130,115,100,139,993,28,1
4600,전라남도,화순군나선거구,6461402,4614,화순군,한천면,계,1086,643,142,86,78,55,138,117,616,27,443
4600,전라남도,화순군나선거구,6461402,4614,화순군,한천면,관내사전투표,275,275,68,35,25,15,81,43,267,8,0
4600,전라남도,화순군나선거구,6461402,4614,화순군,한천면,선거일투표,811,368,74,51,53,40,57,74,349,19,443
4600,전라남도,화순군나선거구,6461402,4614,화순군,춘양면,계,1566,959,127,121,379,89,89,117,922,37,607
4600,전라남도,화순군나선거구,6461402,4614,화순군,춘양면,관내사전투표,607,607,86,68,258,53,51,68,584,23,0
4600,전라남도,화순군나선거구,6461402,4614,화순군,춘양면,선거일투표,959,352,41,53,121,36,38,49,338,14,607
4600,전라남도,화순군나선거구,6461402,4614,화순군,청풍면,계,850,547,74,208,39,28,40,133,522,25,303
4600,전라남도,화순군나선거구,6461402,4614,화순군,청풍면,관내사전투표,297,297,36,118,21,14,21,71,281,16,0
4600,전라남도,화순군나선거구,6461402,4614,화순군,청풍면,선거일투표,553,250,38,90,18,14,19,62,241,9,303
4600,전라남도,화순군나선거구,6461402,4614,화순군,이양면,계,1574,1035,83,452,34,23,53,336,981,54,539
4600,전라남도,화순군나선거구,6461402,4614,화순군,이양면,관내사전투표,652,652,55,295,16,13,34,198,611,41,0
4600,전라남도,화순군나선거구,6461402,4614,화순군,이양면,선거일투표,922,383,28,157,18,10,19,138,370,13,539
4600,전라남도,화순군나선거구,6461402,4614,화순군,능주면,계,2680,1705,304,117,185,142,589,323,1660,45,975
4600,전라남도,화순군나선거구,6461402,4614,화순군,능주면,관내사전투표,815,814,148,60,82,74,270,155,789,25,1
4600,전라남도,화순군나선거구,6461402,4614,화순군,능주면,선거일투표,1865,891,156,57,103,68,319,168,871,20,974
4600,전라남도,화순군나선거구,6461402,4614,화순군,도곡면,계,2486,1532,814,36,65,435,56,48,1454,78,954
4600,전라남도,화순군나선거구,6461402,4614,화순군,도곡면,관내사전투표,885,885,496,18,26,245,25,27,837,48,0
4600,전라남도,화순군나선거구,6461402,4614,화순군,도곡면,선거일투표,1601,647,318,18,39,190,31,21,617,30,954
4600,전라남도,화순군나선거구,6461402,4614,화순군,도암면,계,1236,728,351,58,78,161,21,25,694,34,508
4600,전라남도,화순군나선거구,6461402,4614,화순군,도암면,관내사전투표,427,427,230,27,37,89,8,15,406,21,0
4600,전라남도,화순군나선거구,6461402,4614,화순군,도암면,선거일투표,809,301,121,31,41,72,13,10,288,13,508
4600,전라남도,화순군나선거구,6461402,4614,화순군,잘못 투입·구분된 투표지,,0,0,0,0,0,0,0,0,0,0,0
4600,전라남도,화순군다선거구,6461403,4614,화순군,합계,,9049,5923,1688,919,1311,1720,5638,285,3126
4600,전라남도,화순군다선거구,6461403,4614,화순군,거소투표,,11,11,5,1,2,2,10,1,0
4600,전라남도,화순군다선거구,6461403,4614,화순군,관외사전투표,,935,935,340,185,180,202,907,28,0
4600,전라남도,화순군다선거구,6461403,4614,화순군,이서면,계,796,479,152,85,115,95,447,32,317
4600,전라남도,화순군다선거구,6461403,4614,화순군,이서면,관내사전투표,243,243,72,40,57,47,216,27,0
4600,전라남도,화순군다선거구,6461403,4614,화순군,이서면,선거일투표,553,236,80,45,58,48,231,5,317
4600,전라남도,화순군다선거구,6461403,4614,화순군,백아면,계,1310,819,231,110,312,123,776,43,491
4600,전라남도,화순군다선거구,6461403,4614,화순군,백아면,관내사전투표,538,538,147,70,204,81,502,36,0
4600,전라남도,화순군다선거구,6461403,4614,화순군,백아면,선거일투표,772,281,84,40,108,42,274,7,491
4600,전라남도,화순군다선거구,6461403,4614,화순군,동복면,계,1382,940,200,266,290,128,884,56,442
4600,전라남도,화순군다선거구,6461403,4614,화순군,동복면,관내사전투표,568,568,124,148,182,70,524,44,0
4600,전라남도,화순군다선거구,6461403,4614,화순군,동복면,선거일투표,814,372,76,118,108,58,360,12,442
4600,전라남도,화순군다선거구,6461403,4614,화순군,사평면,계,1876,1111,361,179,261,251,1052,59,765
4600,전라남도,화순군다선거구,6461403,4614,화순군,사평면,관내사전투표,629,625,200,80,145,155,580,45,4
4600,전라남도,화순군다선거구,6461403,4614,화순군,사평면,선거일투표,1247,486,161,99,116,96,472,14,761
4600,전라남도,화순군다선거구,6461403,4614,화순군,동면,계,2739,1625,398,92,151,918,1559,66,1114
4600,전라남도,화순군다선거구,6461403,4614,화순군,동면,관내사전투표,1027,1025,237,48,97,597,979,46,2
4600,전라남도,화순군다선거구,6461403,4614,화순군,동면,선거일투표,1712,600,161,44,54,321,580,20,1112
4600,전라남도,화순군다선거구,6461403,4614,화순군,잘못 투입·구분된 투표지,,0,3,1,1,0,1,3,0,-3
4600,전라남도,장흥군가선거구,6461501,4615,장흥군,합계,,16884,12123,3634,2098,2487,1629,698,1122,11668,455,4761
4600,전라남도,장흥군가선거구,6461501,4615,장흥군,거소투표,,124,111,31,25,23,12,3,10,104,7,13
4600,전라남도,장흥군가선거구,6461501,4615,장흥군,관외사전투표,,1982,1982,687,307,338,332,81,183,1928,54,0
4600,전라남도,장흥군가선거구,6461501,4615,장흥군,장흥읍,계,10033,6772,2223,717,1396,975,480,744,6535,237,3261
4600,전라남도,장흥군가선거구,6461501,4615,장흥군,장흥읍,관내사전투표,3512,3512,1181,400,747,504,234,322,3388,124,0
4600,전라남도,장흥군가선거구,6461501,4615,장흥군,장흥읍,선거일투표,6521,3260,1042,317,649,471,246,422,3147,113,3261
4600,전라남도,장흥군가선거구,6461501,4615,장흥군,장동면,계,996,724,136,201,168,77,45,55,682,42,272
4600,전라남도,장흥군가선거구,6461501,4615,장흥군,장동면,관내사전투표,404,404,80,103,98,43,21,35,380,24,0
4600,전라남도,장흥군가선거구,6461501,4615,장흥군,장동면,선거일투표,592,320,56,98,70,34,24,20,302,18,272
4600,전라남도,장흥군가선거구,6461501,4615,장흥군,장평면,계,1785,1239,195,650,170,84,27,54,1180,59,546
4600,전라남도,장흥군가선거구,6461501,4615,장흥군,장평면,관내사전투표,648,648,95,335,98,46,15,32,621,27,0
4600,전라남도,장흥군가선거구,6461501,4615,장흥군,장평면,선거일투표,1137,591,100,315,72,38,12,22,559,32,546
4600,전라남도,장흥군가선거구,6461501,4615,장흥군,유치면,계,836,549,133,78,186,77,18,29,521,28,287
4600,전라남도,장흥군가선거구,6461501,4615,장흥군,유치면,관내사전투표,329,329,84,43,108,47,10,19,311,18,0
4600,전라남도,장흥군가선거구,6461501,4615,장흥군,유치면,선거일투표,507,220,49,35,78,30,8,10,210,10,287
4600,전라남도,장흥군가선거구,6461501,4615,장흥군,부산면,계,1128,746,229,120,206,72,44,47,718,28,382
4600,전라남도,장흥군가선거구,6461501,4615,장흥군,부산면,관내사전투표,445,445,130,85,123,38,22,28,426,19,0
4600,전라남도,장흥군가선거구,6461501,4615,장흥군,부산면,선거일투표,683,301,99,35,83,34,22,19,292,9,382
4600,전라남도,장흥군가선거구,6461501,4615,장흥군,잘못 투입·구분된 투표지,,0,0,0,0,0,0,0,0,0,0,0
4600,전라남도,장흥군나선거구,6461502,4615,장흥군,합계,,15626,11133,2915,2263,2098,674,1678,227,702,10557,576,4493
4600,전라남도,장흥군나선거구,6461502,4615,장흥군,거소투표,,48,43,12,12,8,1,4,1,0,38,5,5
4600,전라남도,장흥군나선거구,6461502,4615,장흥군,관외사전투표,,1210,1209,362,226,212,104,131,39,87,1161,48,1
4600,전라남도,장흥군나선거구,6461502,4615,장흥군,장흥읍,계,912,585,156,95,126,40,87,18,33,555,30,327
4600,전라남도,장흥군나선거구,6461502,4615,장흥군,장흥읍,관내사전투표,357,355,85,55,81,30,55,7,22,335,20,2
4600,전라남도,장흥군나선거구,6461502,4615,장흥군,장흥읍,선거일투표,555,230,71,40,45,10,32,11,11,220,10,325
4600,전라남도,장흥군나선거구,6461502,4615,장흥군,관산읍,계,4112,2833,1301,473,425,264,101,31,114,2709,124,1279
4600,전라남도,장흥군나선거구,6461502,4615,장흥군,관산읍,관내사전투표,1559,1559,744,266,203,146,61,14,61,1495,64,0
4600,전라남도,장흥군나선거구,6461502,4615,장흥군,관산읍,선거일투표,2553,1274,557,207,222,118,40,17,53,1214,60,1279
4600,전라남도,장흥군나선거구,6461502,4615,장흥군,대덕읍,계,2809,1898,445,377,299,92,475,25,71,1784,114,911
4600,전라남도,장흥군나선거구,6461502,4615,장흥군,대덕읍,관내사전투표,1043,1043,240,200,159,50,258,14,44,965,78,0
4600,전라남도,장흥군나선거구,6461502,4615,장흥군,대덕읍,선거일투표,1766,855,205,177,140,42,217,11,27,819,36,911
4600,전라남도,장흥군나선거구,6461502,4615,장흥군,용산면,계,1889,1318,149,235,360,52,80,55,307,1238,80,571
4600,전라남도,장흥군나선거구,6461502,4615,장흥군,용산면,관내사전투표,757,757,96,136,201,28,35,28,181,705,52,0
4600,전라남도,장흥군나선거구,6461502,4615,장흥군,용산면,선거일투표,1132,561,53,99,159,24,45,27,126,533,28,571
4600,전라남도,장흥군나선거구,6461502,4615,장흥군,안양면,계,2324,1591,166,628,485,68,64,43,54,1508,83,733
4600,전라남도,장흥군나선거구,6461502,4615,장흥군,안양면,관내사전투표,877,877,109,326,263,40,32,19,36,825,52,0
4600,전라남도,장흥군나선거구,6461502,4615,장흥군,안양면,선거일투표,1447,714,57,302,222,28,32,24,18,683,31,733
4600,전라남도,장흥군나선거구,6461502,4615,장흥군,회진면,계,2322,1654,324,217,182,53,735,15,36,1562,92,668
4600,전라남도,장흥군나선거구,6461502,4615,장흥군,회진면,관내사전투표,1001,1001,209,121,92,31,451,9,27,940,61,0
4600,전라남도,장흥군나선거구,6461502,4615,장흥군,회진면,선거일투표,1321,653,115,96,90,22,284,6,9,622,31,668
4600,전라남도,장흥군나선거구,6461502,4615,장흥군,잘못 투입·구분된 투표지,,0,2,0,0,1,0,1,0,0,2,0,-2
4600,전라남도,강진군가선거구,6461601,4616,강진군,합계,,17710,12796,1772,2187,2160,1439,1785,1146,1769,12258,538,4914
4600,전라남도,강진군가선거구,6461601,4616,강진군,거소투표,,100,97,23,11,12,16,17,1,8,88,9,3
4600,전라남도,강진군가선거구,6461601,4616,강진군,관외사전투표,,1325,1325,215,260,206,163,184,100,143,1271,54,0
4600,전라남도,강진군가선거구,6461601,4616,강진군,강진읍,계,10236,7112,1122,1136,1415,817,1147,505,709,6851,261,3124
4600,전라남도,강진군가선거구,6461601,4616,강진군,강진읍,관내사전투표,3888,3886,607,612,767,429,677,244,407,3743,143,2
4600,전라남도,강진군가선거구,6461601,4616,강진군,강진읍,선거일투표,6348,3226,515,524,648,388,470,261,302,3108,118,3122
4600,전라남도,강진군가선거구,6461601,4616,강진군,도암면,계,2062,1419,140,445,188,145,116,70,246,1350,69,643
4600,전라남도,강진군가선거구,6461601,4616,강진군,도암면,관내사전투표,748,748,72,227,105,74,64,36,134,712,36,0
4600,전라남도,강진군가선거구,6461601,4616,강진군,도암면,선거일투표,1314,671,68,218,83,71,52,34,112,638,33,643
4600,전라남도,강진군가선거구,6461601,4616,강진군,신전면,계,1545,1110,96,135,115,83,87,48,503,1067,43,435
4600,전라남도,강진군가선거구,6461601,4616,강진군,신전면,관내사전투표,556,556,50,58,61,45,35,19,267,535,21,0
4600,전라남도,강진군가선거구,6461601,4616,강진군,신전면,선거일투표,989,554,46,77,54,38,52,29,236,532,22,435
4600,전라남도,강진군가선거구,6461601,4616,강진군,성전면,계,2442,1731,175,200,224,215,234,422,160,1630,101,711
4600,전라남도,강진군가선거구,6461601,4616,강진군,성전면,관내사전투표,1094,1094,115,131,141,139,133,241,114,1014,80,0
4600,전라남도,강진군가선거구,6461601,4616,강진군,성전면,선거일투표,1348,637,60,69,83,76,101,181,46,616,21,711
4600,전라남도,강진군가선거구,6461601,4616,강진군,잘못 투입·구분된 투표지,,0,2,1,0,0,0,0,0,0,1,1,-2
4600,전라남도,강진군나선거구,6461602,4616,강진군,합계,,12438,9148,3333,2070,1817,1361,8581,567,3290
4600,전라남도,강진군나선거구,6461602,4616,강진군,거소투표,,48,43,14,6,14,7,41,2,5
4600,전라남도,강진군나선거구,6461602,4616,강진군,관외사전투표,,1180,1179,450,328,190,176,1144,35,1
4600,전라남도,강진군나선거구,6461602,4616,강진군,군동면,계,3277,2271,561,1069,216,314,2160,111,1006
4600,전라남도,강진군나선거구,6461602,4616,강진군,군동면,관내사전투표,1251,1251,237,647,110,172,1166,85,0
4600,전라남도,강진군나선거구,6461602,4616,강진군,군동면,선거일투표,2026,1020,324,422,106,142,994,26,1006
4600,전라남도,강진군나선거구,6461602,4616,강진군,칠량면,계,1931,1397,406,91,616,137,1250,147,534
4600,전라남도,강진군나선거구,6461602,4616,강진군,칠량면,관내사전투표,868,867,242,55,373,80,750,117,1
4600,전라남도,강진군나선거구,6461602,4616,강진군,칠량면,선거일투표,1063,530,164,36,243,57,500,30,533
4600,전라남도,강진군나선거구,6461602,4616,강진군,대구면,계,959,693,298,74,146,135,653,40,266
4600,전라남도,강진군나선거구,6461602,4616,강진군,대구면,관내사전투표,423,422,170,45,92,80,387,35,1
4600,전라남도,강진군나선거구,6461602,4616,강진군,대구면,선거일투표,536,271,128,29,54,55,266,5,265
4600,전라남도,강진군나선거구,6461602,4616,강진군,마량면,계,1556,1114,546,94,237,166,1043,71,442
4600,전라남도,강진군나선거구,6461602,4616,강진군,마량면,관내사전투표,695,694,340,55,139,99,633,61,1
4600,전라남도,강진군나선거구,6461602,4616,강진군,마량면,선거일투표,861,420,206,39,98,67,410,10,441
4600,전라남도,강진군나선거구,6461602,4616,강진군,작천면,계,1541,1054,489,151,156,180,976,78,487
4600,전라남도,강진군나선거구,6461602,4616,강진군,작천면,관내사전투표,664,664,307,92,90,116,605,59,0
4600,전라남도,강진군나선거구,6461602,4616,강진군,작천면,선거일투표,877,390,182,59,66,64,371,19,487
4600,전라남도,강진군나선거구,6461602,4616,강진군,병영면,계,1437,1021,415,184,187,169,955,66,416
4600,전라남도,강진군나선거구,6461602,4616,강진군,병영면,관내사전투표,673,672,259,121,126,112,618,54,1
4600,전라남도,강진군나선거구,6461602,4616,강진군,병영면,선거일투표,764,349,156,63,61,57,337,12,415
4600,전라남도,강진군나선거구,6461602,4616,강진군,옴천면,계,509,372,153,71,54,77,355,17,137
4600,전라남도,강진군나선거구,6461602,4616,강진군,옴천면,관내사전투표,205,205,82,47,27,37,193,12,0
4600,전라남도,강진군나선거구,6461602,4616,강진군,옴천면,선거일투표,304,167,71,24,27,40,162,5,137
4600,전라남도,강진군나선거구,6461602,4616,강진군,잘못 투입·구분된 투표지,,0,4,1,2,1,0,4,0,-4
4600,전라남도,완도군가선거구,6461701,4617,완도군,합계,,23814,15981,3936,1531,1216,2411,3218,3070,15382,599,7833
4600,전라남도,완도군가선거구,6461701,4617,완도군,거소투표,,193,187,71,12,22,20,46,10,181,6,6
4600,전라남도,완도군가선거구,6461701,4617,완도군,관외사전투표,,1057,1057,331,92,97,105,190,212,1027,30,0
4600,전라남도,완도군가선거구,6461701,4617,완도군,완도읍,계,14387,8893,2598,1164,907,400,2521,1039,8629,264,5494
4600,전라남도,완도군가선거구,6461701,4617,완도군,완도읍,관내사전투표,4307,4307,1226,526,450,228,1153,623,4206,101,0
4600,전라남도,완도군가선거구,6461701,4617,완도군,완도읍,선거일투표,10080,4586,1372,638,457,172,1368,416,4423,163,5494
4600,전라남도,완도군가선거구,6461701,4617,완도군,노화읍,계,4115,2874,315,107,71,1046,116,1076,2731,143,1241
4600,전라남도,완도군가선거구,6461701,4617,완도군,노화읍,관내사전투표,1403,1403,161,42,36,448,57,575,1319,84,0
4600,전라남도,완도군가선거구,6461701,4617,완도군,노화읍,선거일투표,2712,1471,154,65,35,598,59,501,1412,59,1241
4600,전라남도,완도군가선거구,6461701,4617,완도군,소안면,계,1964,1449,359,120,65,353,258,197,1352,97,515
4600,전라남도,완도군가선거구,6461701,4617,완도군,소안면,관내사전투표,872,872,217,73,41,219,144,126,820,52,0
4600,전라남도,완도군가선거구,6461701,4617,완도군,소안면,선거일투표,1092,577,142,47,24,134,114,71,532,45,515
4600,전라남도,완도군가선거구,6461701,4617,완도군,보길면,계,2098,1521,262,36,54,487,87,536,1462,59,577
4600,전라남도,완도군가선거구,6461701,4617,완도군,보길면,관내사전투표,750,750,142,18,32,201,44,281,718,32,0
4600,전라남도,완도군가선거구,6461701,4617,완도군,보길면,선거일투표,1348,771,120,18,22,286,43,255,744,27,577
4600,전라남도,완도군가선거구,6461701,4617,완도군,잘못 투입·구분된 투표지,,0,0,0,0,0,0,0,0,0,0,0
4600,전라남도,완도군나선거구,6461702,4617,완도군,합계,,8656,6859,1252,820,2005,2490,6567,292,1797
4600,전라남도,완도군나선거구,6461702,4617,완도군,거소투표,,521,507,86,38,232,129,485,22,14
4600,전라남도,완도군나선거구,6461702,4617,완도군,관외사전투표,,590,589,120,78,196,180,574,15,1
4600,전라남도,완도군나선거구,6461702,4617,완도군,금일읍,계,2782,2107,563,483,906,57,2009,98,675
4600,전라남도,완도군나선거구,6461702,4617,완도군,금일읍,관내사전투표,883,883,244,155,409,28,836,47,0
4600,전라남도,완도군나선거구,6461702,4617,완도군,금일읍,선거일투표,1899,1224,319,328,497,29,1173,51,675
4600,전라남도,완도군나선거구,6461702,4617,완도군,고금면,계,3393,2580,259,127,198,1885,2469,111,813
4600,전라남도,완도군나선거구,6461702,4617,완도군,고금면,관내사전투표,1738,1736,165,73,120,1285,1643,93,2
4600,전라남도,완도군나선거구,6461702,4617,완도군,고금면,선거일투표,1655,844,94,54,78,600,826,18,811
4600,전라남도,완도군나선거구,6461702,4617,완도군,금당면,계,768,612,119,56,246,168,589,23,156
4600,전라남도,완도군나선거구,6461702,4617,완도군,금당면,관내사전투표,425,424,97,39,159,111,406,18,1
4600,전라남도,완도군나선거구,6461702,4617,완도군,금당면,선거일투표,343,188,22,17,87,57,183,5,155
4600,전라남도,완도군나선거구,6461702,4617,완도군,생일면,계,602,461,105,38,225,70,438,23,141
4600,전라남도,완도군나선거구,6461702,4617,완도군,생일면,관내사전투표,361,361,80,25,186,51,342,19,0
4600,전라남도,완도군나선거구,6461702,4617,완도군,생일면,선거일투표,241,100,25,13,39,19,96,4,141
4600,전라남도,완도군나선거구,6461702,4617,완도군,잘못 투입·구분된 투표지,,0,3,0,0,2,1,3,0,-3
4600,전라남도,완도군다선거구,6461703,4617,완도군,검색된 결과가 없습니다.
4600,전라남도,해남군가선거구,6461801,4618,해남군,합계,,25611,13656,2800,2354,2019,2184,1143,2654,13154,502,11955
4600,전라남도,해남군가선거구,6461801,4618,해남군,거소투표,,246,223,89,28,22,28,7,23,197,26,23
4600,전라남도,해남군가선거구,6461801,4618,해남군,관외사전투표,,1828,1828,457,325,257,291,158,281,1769,59,0
4600,전라남도,해남군가선거구,6461801,4618,해남군,해남읍,계,18363,8723,1354,1539,1422,1612,560,1942,8429,294,9640
4600,전라남도,해남군가선거구,6461801,4618,해남군,해남읍,관내사전투표,3942,3941,638,658,603,808,267,861,3835,106,1
4600,전라남도,해남군가선거구,6461801,4618,해남군,해남읍,선거일투표,14421,4782,716,881,819,804,293,1081,4594,188,9639
4600,전라남도,해남군가선거구,6461801,4618,해남군,마산면,계,2096,1203,167,274,123,124,311,158,1157,46,893
4600,전라남도,해남군가선거구,6461801,4618,해남군,마산면,관내사전투표,569,569,83,140,44,56,164,62,549,20,0
4600,전라남도,해남군가선거구,6461801,4618,해남군,마산면,선거일투표,1527,634,84,134,79,68,147,96,608,26,893
4600,전라남도,해남군가선거구,6461801,4618,해남군,산이면,계,3078,1679,733,188,195,129,107,250,1602,77,1399
4600,전라남도,해남군가선거구,6461801,4618,해남군,산이면,관내사전투표,746,746,357,70,104,46,42,94,713,33,0
4600,전라남도,해남군가선거구,6461801,4618,해남군,산이면,선거일투표,2332,933,376,118,91,83,65,156,889,44,1399
4600,전라남도,해남군가선거구,6461801,4618,해남군,잘못 투입·구분된 투표지,,0,0,0,0,0,0,0,0,0,0,0
4600,전라남도,해남군나선거구,6461802,4618,해남군,합계,,11069,6930,1392,2397,2756,6545,385,4139
4600,전라남도,해남군나선거구,6461802,4618,해남군,거소투표,,64,57,11,18,25,54,3,7
4600,전라남도,해남군나선거구,6461802,4618,해남군,관외사전투표,,523,522,137,150,226,513,9,1
4600,전라남도,해남군나선거구,6461802,4618,해남군,황산면,계,4083,2421,279,1454,567,2300,121,1662
4600,전라남도,해남군나선거구,6461802,4618,해남군,황산면,관내사전투표,1171,1171,136,695,264,1095,76,0
4600,전라남도,해남군나선거구,6461802,4618,해남군,황산면,선거일투표,2912,1250,143,759,303,1205,45,1662
4600,전라남도,해남군나선거구,6461802,4618,해남군,문내면,계,3420,2096,803,511,684,1998,98,1324
4600,전라남도,해남군나선거구,6461802,4618,해남군,문내면,관내사전투표,1060,1060,360,284,357,1001,59,0
4600,전라남도,해남군나선거구,6461802,4618,해남군,문내면,선거일투표,2360,1036,443,227,327,997,39,1324
4600,전라남도,해남군나선거구,6461802,4618,해남군,화원면,계,2979,1832,162,264,1252,1678,154,1147
4600,전라남도,해남군나선거구,6461802,4618,해남군,화원면,관내사전투표,1121,1121,108,150,742,1000,121,0
4600,전라남도,해남군나선거구,6461802,4618,해남군,화원면,선거일투표,1858,711,54,114,510,678,33,1147
4600,전라남도,해남군나선거구,6461802,4618,해남군,잘못 투입·구분된 투표지,,0,2,0,0,2,2,0,-2
4600,전라남도,해남군다선거구,6461803,4618,해남군,합계,,10575,7169,1736,1492,981,1292,1286,6787,382,3406
4600,전라남도,해남군다선거구,6461803,4618,해남군,거소투표,,110,90,23,13,16,8,27,87,3,20
4600,전라남도,해남군다선거구,6461803,4618,해남군,관외사전투표,,497,497,187,91,70,53,81,482,15,0
4600,전라남도,해남군다선거구,6461803,4618,해남군,현산면,계,2491,1541,798,205,166,204,72,1445,96,950
4600,전라남도,해남군다선거구,6461803,4618,해남군,현산면,관내사전투표,639,638,335,80,73,77,24,589,49,1
4600,전라남도,해남군다선거구,6461803,4618,해남군,현산면,선거일투표,1852,903,463,125,93,127,48,856,47,949
4600,전라남도,해남군다선거구,6461803,4618,해남군,송지면,계,5054,3410,358,1080,629,122,1037,3226,184,1644
4600,전라남도,해남군다선거구,6461803,4618,해남군,송지면,관내사전투표,1516,1515,146,473,274,54,463,1410,105,1
4600,전라남도,해남군다선거구,6461803,4618,해남군,송지면,선거일투표,3538,1895,212,607,355,68,574,1816,79,1643
4600,전라남도,해남군다선거구,6461803,4618,해남군,북평면,계,2423,1628,369,103,99,904,69,1544,84,795
4600,전라남도,해남군다선거구,6461803,4618,해남군,북평면,관내사전투표,778,778,185,54,32,423,39,733,45,0
4600,전라남도,해남군다선거구,6461803,4618,해남군,북평면,선거일투표,1645,850,184,49,67,481,30,811,39,795
4600,전라남도,해남군다선거구,6461803,4618,해남군,잘못 투입·구분된 투표지,,0,3,1,0,1,1,0,3,0,-3
4600,전라남도,해남군라선거구,6461804,4618,해남군,합계,,12168,7492,2021,1720,150,1148,1473,662,7174,318,4676
4600,전라남도,해남군라선거구,6461804,4618,해남군,거소투표,,79,68,22,16,2,18,5,4,67,1,11
4600,전라남도,해남군라선거구,6461804,4618,해남군,관외사전투표,,696,695,269,104,7,97,135,61,673,22,1
4600,전라남도,해남군라선거구,6461804,4618,해남군,삼산면,계,2501,1488,215,341,22,601,203,64,1446,42,1013
4600,전라남도,해남군라선거구,6461804,4618,해남군,삼산면,관내사전투표,712,712,95,166,9,296,92,36,694,18,0
4600,전라남도,해남군라선거구,6461804,4618,해남군,삼산면,선거일투표,1789,776,120,175,13,305,111,28,752,24,1013
4600,전라남도,해남군라선거구,6461804,4618,해남군,화산면,계,2706,1524,192,493,31,72,624,45,1457,67,1182
4600,전라남도,해남군라선거구,6461804,4618,해남군,화산면,관내사전투표,584,584,75,217,8,25,212,15,552,32,0
4600,전라남도,해남군라선거구,6461804,4618,해남군,화산면,선거일투표,2122,940,117,276,23,47,412,30,905,35,1182
4600,전라남도,해남군라선거구,6461804,4618,해남군,북일면,계,1775,1028,239,312,25,120,216,69,981,47,747
4600,전라남도,해남군라선거구,6461804,4618,해남군,북일면,관내사전투표,477,477,107,146,13,56,97,34,453,24,0
4600,전라남도,해남군라선거구,6461804,4618,해남군,북일면,선거일투표,1298,551,132,166,12,64,119,35,528,23,747
4600,전라남도,해남군라선거구,6461804,4618,해남군,옥천면,계,2567,1614,763,197,39,102,89,343,1533,81,953
4600,전라남도,해남군라선거구,6461804,4618,해남군,옥천면,관내사전투표,829,829,421,86,15,52,49,170,793,36,0
4600,전라남도,해남군라선거구,6461804,4618,해남군,옥천면,선거일투표,1738,785,342,111,24,50,40,173,740,45,953
4600,전라남도,해남군라선거구,6461804,4618,해남군,계곡면,계,1844,1075,321,257,24,138,201,76,1017,58,769
4600,전라남도,해남군라선거구,6461804,4618,해남군,계곡면,관내사전투표,545,545,159,119,10,68,107,40,503,42,0
4600,전라남도,해남군라선거구,6461804,4618,해남군,계곡면,선거일투표,1299,530,162,138,14,70,94,36,514,16,769
4600,전라남도,해남군라선거구,6461804,4618,해남군,잘못 투입·구분된 투표지,,0,0,0,0,0,0,0,0,0,0,0
4600,전라남도,진도군가선거구,6461901,4619,진도군,합계,,18103,13764,2417,1968,2049,2009,239,1234,781,182,1447,834,13160,604,4339
4600,전라남도,진도군가선거구,6461901,4619,진도군,거소투표,,96,89,20,11,11,9,3,6,6,0,4,7,77,12,7
4600,전라남도,진도군가선거구,6461901,4619,진도군,관외사전투표,,1193,1193,282,185,124,222,51,55,49,18,100,69,1155,38,0
4600,전라남도,진도군가선거구,6461901,4619,진도군,진도읍,계,8109,6020,1090,1046,616,1161,93,302,392,71,469,565,5805,215,2089
4600,전라남도,진도군가선거구,6461901,4619,진도군,진도읍,관내사전투표,3573,3573,646,607,360,677,48,179,248,38,295,340,3438,135,0
4600,전라남도,진도군가선거구,6461901,4619,진도군,진도읍,선거일투표,4536,2447,444,439,256,484,45,123,144,33,174,225,2367,80,2089
4600,전라남도,진도군가선거구,6461901,4619,진도군,군내면,계,2725,2067,376,254,638,219,31,187,102,17,60,81,1965,102,658
4600,전라남도,진도군가선거구,6461901,4619,진도군,군내면,관내사전투표,1024,1024,178,115,283,133,13,100,64,11,33,43,973,51,0
4600,전라남도,진도군가선거구,6461901,4619,진도군,군내면,선거일투표,1701,1043,198,139,355,86,18,87,38,6,27,38,992,51,658
4600,전라남도,진도군가선거구,6461901,4619,진도군,고군면,계,2951,2132,381,235,340,203,18,589,123,20,64,54,2027,105,819
4600,전라남도,진도군가선거구,6461901,4619,진도군,고군면,관내사전투표,1068,1068,186,110,169,131,7,279,71,12,27,26,1018,50,0
4600,전라남도,진도군가선거구,6461901,4619,진도군,고군면,선거일투표,1883,1064,195,125,171,72,11,310,52,8,37,28,1009,55,819
4600,전라남도,진도군가선거구,6461901,4619,진도군,의신면,계,3029,2263,268,237,320,195,43,95,109,56,750,58,2131,132,766
4600,전라남도,진도군가선거구,6461901,4619,진도군,의신면,관내사전투표,1245,1245,152,127,169,105,18,60,75,29,405,34,1174,71,0
4600,전라남도,진도군가선거구,6461901,4619,진도군,의신면,선거일투표,1784,1018,116,110,151,90,25,35,34,27,345,24,957,61,766
4600,전라남도,진도군가선거구,6461901,4619,진도군,잘못 투입·구분된 투표지,,0,0,0,0,0,0,0,0,0,0,0,0,0,0,0
4600,전라남도,진도군나선거구,6461902,4619,진도군,합계,,8645,6652,2538,1709,1962,6209,443,1993
4600,전라남도,진도군나선거구,6461902,4619,진도군,거소투표,,235,205,71,95,35,201,4,30
4600,전라남도,진도군나선거구,6461902,4619,진도군,관외사전투표,,832,831,348,259,195,802,29,1
4600,전라남도,진도군나선거구,6461902,4619,진도군,임회면,계,2889,2128,1198,324,475,1997,131,761
4600,전라남도,진도군나선거구,6461902,4619,진도군,임회면,관내사전투표,1142,1140,650,169,233,1052,88,2
4600,전라남도,진도군나선거구,6461902,4619,진도군,임회면,선거일투표,1747,988,548,155,242,945,43,759
4600,전라남도,진도군나선거구,6461902,4619,진도군,지산면,계,2552,1962,667,241,882,1790,172,590
4600,전라남도,진도군나선거구,6461902,4619,진도군,지산면,관내사전투표,1001,1001,349,127,428,904,97,0
4600,전라남도,진도군나선거구,6461902,4619,진도군,지산면,선거일투표,1551,961,318,114,454,886,75,590
4600,전라남도,진도군나선거구,6461902,4619,진도군,조도면,계,2137,1521,250,790,375,1415,106,616
4600,전라남도,진도군나선거구,6461902,4619,진도군,조도면,관내사전투표,674,673,97,388,132,617,56,1
4600,전라남도,진도군나선거구,6461902,4619,진도군,조도면,선거일투표,1463,848,153,402,243,798,50,615
4600,전라남도,진도군나선거구,6461902,4619,진도군,잘못 투입·구분된 투표지,,0,5,4,0,0,4,1,-5
4600,전라남도,영암군가선거구,6462001,4620,영암군,합계,,19255,13078,2702,2652,2140,3018,1943,12455,623,6177
4600,전라남도,영암군가선거구,6462001,4620,영암군,거소투표,,84,81,24,8,19,16,10,77,4,3
4600,전라남도,영암군가선거구,6462001,4620,영암군,관외사전투표,,1326,1326,344,276,214,277,180,1291,35,0
4600,전라남도,영암군가선거구,6462001,4620,영암군,영암읍,계,6125,4046,709,450,440,1474,825,3898,148,2079
4600,전라남도,영암군가선거구,6462001,4620,영암군,영암읍,관내사전투표,2163,2163,389,254,238,763,435,2079,84,0
4600,전라남도,영암군가선거구,6462001,4620,영암군,영암읍,선거일투표,3962,1883,320,196,202,711,390,1819,64,2079
4600,전라남도,영암군가선거구,6462001,4620,영암군,덕진면,계,1652,1143,219,100,99,298,377,1093,50,509
4600,전라남도,영암군가선거구,6462001,4620,영암군,덕진면,관내사전투표,667,667,133,50,68,176,211,638,29,0
4600,전라남도,영암군가선거구,6462001,4620,영암군,덕진면,선거일투표,985,476,86,50,31,122,166,455,21,509
4600,전라남도,영암군가선거구,6462001,4620,영암군,금정면,계,1824,1226,455,134,140,302,121,1152,74,598
4600,전라남도,영암군가선거구,6462001,4620,영암군,금정면,관내사전투표,887,887,328,84,96,228,91,827,60,0
4600,전라남도,영암군가선거구,6462001,4620,영암군,금정면,선거일투표,937,339,127,50,44,74,30,325,14,598
4600,전라남도,영암군가선거구,6462001,4620,영암군,신북면,계,3251,2030,402,196,974,217,146,1935,95,1221
4600,전라남도,영암군가선거구,6462001,4620,영암군,신북면,관내사전투표,1237,1235,246,111,591,140,85,1173,62,2
4600,전라남도,영암군가선거구,6462001,4620,영암군,신북면,선거일투표,2014,795,156,85,383,77,61,762,33,1219
4600,전라남도,영암군가선거구,6462001,4620,영암군,시종면,계,3058,1986,253,1166,117,201,113,1850,136,1072
4600,전라남도,영암군가선거구,6462001,4620,영암군,시종면,관내사전투표,1147,1146,146,650,66,127,62,1051,95,1
4600,전라남도,영암군가선거구,6462001,4620,영암군,시종면,선거일투표,1911,840,107,516,51,74,51,799,41,1071
4600,전라남도,영암군가선거구,6462001,4620,영암군,도포면,계,1935,1235,296,320,136,232,170,1154,81,700
4600,전라남도,영암군가선거구,6462001,4620,영암군,도포면,관내사전투표,616,615,158,147,56,134,86,581,34,1
4600,전라남도,영암군가선거구,6462001,4620,영암군,도포면,선거일투표,1319,620,138,173,80,98,84,573,47,699
4600,전라남도,영암군가선거구,6462001,4620,영암군,잘못 투입·구분된 투표지,,0,5,0,2,1,1,1,5,0,-5
4600,전라남도,영암군나선거구,6462002,4620,영암군,합계,,18079,8826,2567,724,968,862,1669,448,1278,8516,310,9253
4600,전라남도,영암군나선거구,6462002,4620,영암군,거소투표,,147,137,40,13,10,8,15,7,19,112,25,10
4600,전라남도,영암군나선거구,6462002,4620,영암군,관외사전투표,,1188,1188,490,107,140,72,189,38,108,1144,44,0
4600,전라남도,영암군나선거구,6462002,4620,영암군,삼호읍,계,16744,7501,2037,604,818,782,1465,403,1151,7260,241,9243
4600,전라남도,영암군나선거구,6462002,4620,영암군,삼호읍,관내사전투표,2908,2907,804,197,307,262,621,153,463,2807,100,1
4600,전라남도,영암군나선거구,6462002,4620,영암군,삼호읍,선거일투표,13836,4594,1233,407,511,520,844,250,688,4453,141,9242
4600,전라남도,영암군나선거구,6462002,4620,영암군,잘못 투입·구분된 투표지,,0,0,0,0,0,0,0,0,0,0,0,0
4600,전라남도,영암군다선거구,6462003,4620,영암군,합계,,9517,6790,2209,1749,1682,850,6490,300,2727
4600,전라남도,영암군다선거구,6462003,4620,영암군,거소투표,,25,24,10,10,0,3,23,1,1
4600,전라남도,영암군다선거구,6462003,4620,영암군,관외사전투표,,793,792,265,231,192,81,769,23,1
4600,전라남도,영암군다선거구,6462003,4620,영암군,군서면,계,2680,1865,369,1020,290,100,1779,86,815
4600,전라남도,영암군다선거구,6462003,4620,영암군,군서면,관내사전투표,982,982,186,532,147,48,913,69,0
4600,전라남도,영암군다선거구,6462003,4620,영암군,군서면,선거일투표,1698,883,183,488,143,52,866,17,815
4600,전라남도,영암군다선거구,6462003,4620,영암군,서호면,계,1603,1056,385,267,223,126,1001,55,547
4600,전라남도,영암군다선거구,6462003,4620,영암군,서호면,관내사전투표,632,632,238,156,117,80,591,41,0
4600,전라남도,영암군다선거구,6462003,4620,영암군,서호면,선거일투표,971,424,147,111,106,46,410,14,547
4600,전라남도,영암군다선거구,6462003,4620,영암군,학산면,계,2730,1966,644,152,730,366,1892,74,764
4600,전라남도,영암군다선거구,6462003,4620,영암군,학산면,관내사전투표,1283,1283,449,90,465,231,1235,48,0
4600,전라남도,영암군다선거구,6462003,4620,영암군,학산면,선거일투표,1447,683,195,62,265,135,657,26,764
4600,전라남도,영암군다선거구,6462003,4620,영암군,미암면,계,1686,1086,535,69,247,174,1025,61,600
4600,전라남도,영암군다선거구,6462003,4620,영암군,미암면,관내사전투표,584,584,295,40,123,81,539,45,0
4600,전라남도,영암군다선거구,6462003,4620,영암군,미암면,선거일투표,1102,502,240,29,124,93,486,16,600
4600,전라남도,영암군다선거구,6462003,4620,영암군,잘못 투입·구분된 투표지,,0,1,1,0,0,0,1,0,-1
4600,전라남도,무안군가선거구,6462101,4621,무안군,합계,,37915,23636,6212,3583,1967,2962,4340,3009,571,22644,992,14279
4600,전라남도,무안군가선거구,6462101,4621,무안군,거소투표,,132,109,36,13,3,16,17,11,6,102,7,23
4600,전라남도,무안군가선거구,6462101,4621,무안군,관외사전투표,,3318,3318,1032,544,271,312,519,350,157,3185,133,0
4600,전라남도,무안군가선거구,6462101,4621,무안군,무안읍,계,8979,5488,1058,1615,964,590,925,116,56,5324,164,3491
4600,전라남도,무안군가선거구,6462101,4621,무안군,무안읍,관내사전투표,3409,3409,649,989,589,334,636,76,36,3309,100,0
4600,전라남도,무안군가선거구,6462101,4621,무안군,무안읍,선거일투표,5570,2079,409,626,375,256,289,40,20,2015,64,3491
4600,전라남도,무안군가선거구,6462101,4621,무안군,일로읍,계,10532,5170,1137,458,358,258,521,2027,216,4975,195,5362
4600,전라남도,무안군가선거구,6462101,4621,무안군,일로읍,관내사전투표,1958,1958,376,97,49,76,205,1051,36,1890,68,0
4600,전라남도,무안군가선거구,6462101,4621,무안군,일로읍,선거일투표,8574,3212,761,361,309,182,316,976,180,3085,127,5362
4600,전라남도,무안군가선거구,6462101,4621,무안군,몽탄면,계,2557,1590,333,219,83,166,383,288,29,1501,89,967
4600,전라남도,무안군가선거구,6462101,4621,무안군,몽탄면,관내사전투표,899,898,196,115,47,76,225,160,20,839,59,1
4600,전라남도,무안군가선거구,6462101,4621,무안군,몽탄면,선거일투표,1658,692,137,104,36,90,158,128,9,662,30,966
4600,전라남도,무안군가선거구,6462101,4621,무안군,현경면,계,3949,2288,555,350,109,532,520,67,29,2162,126,1661
4600,전라남도,무안군가선거구,6462101,4621,무안군,현경면,관내사전투표,942,942,241,141,43,199,207,32,11,874,68,0
4600,전라남도,무안군가선거구,6462101,4621,무안군,현경면,선거일투표,3007,1346,314,209,66,333,313,35,18,1288,58,1661
4600,전라남도,무안군가선거구,6462101,4621,무안군,망운면,계,1662,1106,276,164,54,247,255,37,17,1050,56,556
4600,전라남도,무안군가선거구,6462101,4621,무안군,망운면,관내사전투표,555,555,141,72,36,109,139,15,10,522,33,0
4600,전라남도,무안군가선거구,6462101,4621,무안군,망운면,선거일투표,1107,551,135,92,18,138,116,22,7,528,23,556
4600,전라남도,무안군가선거구,6462101,4621,무안군,해제면,계,4349,2961,1545,76,59,187,868,45,40,2820,141,1388
4600,전라남도,무안군가선거구,6462101,4621,무안군,해제면,관내사전투표,1960,1959,1029,48,41,120,563,24,27,1852,107,1
4600,전라남도,무안군가선거구,6462101,4621,무안군,해제면,선거일투표,2389,1002,516,28,18,67,305,21,13,968,34,1387
4600,전라남도,무안군가선거구,6462101,4621,무안군,운남면,계,2437,1604,240,143,66,654,332,67,21,1523,81,833
4600,전라남도,무안군가선거구,6462101,4621,무안군,운남면,관내사전투표,879,879,127,73,40,341,201,32,12,826,53,0
4600,전라남도,무안군가선거구,6462101,4621,무안군,운남면,선거일투표,1558,725,113,70,26,313,131,35,9,697,28,833
4600,전라남도,무안군가선거구,6462101,4621,무안군,잘못 투입·구분된 투표지,,0,2,0,1,0,0,0,1,0,2,0,-2
4600,전라남도,무안군나선거구,6462102,4621,무안군,합계,,36980,17700,3986,3330,3551,2718,2254,990,16829,871,19280
4600,전라남도,무안군나선거구,6462102,4621,무안군,거소투표,,677,581,149,96,57,57,43,43,445,136,96
4600,전라남도,무안군나선거구,6462102,4621,무안군,관외사전투표,,3743,3742,1008,717,636,493,505,216,3575,167,1
4600,전라남도,무안군나선거구,6462102,4621,무안군,삼향읍,계,27133,10437,2279,2260,1358,1940,1572,615,10024,413,16696
4600,전라남도,무안군나선거구,6462102,4621,무안군,삼향읍,관내사전투표,3363,3363,646,746,512,676,485,179,3244,119,0
4600,전라남도,무안군나선거구,6462102,4621,무안군,삼향읍,선거일투표,23770,7074,1633,1514,846,1264,1087,436,6780,294,16696
4600,전라남도,무안군나선거구,6462102,4621,무안군,청계면,계,5427,2940,550,257,1500,228,134,116,2785,155,2487
4600,전라남도,무안군나선거구,6462102,4621,무안군,청계면,관내사전투표,1216,1216,187,111,614,112,67,54,1145,71,0
4600,전라남도,무안군나선거구,6462102,4621,무안군,청계면,선거일투표,4211,1724,363,146,886,116,67,62,1640,84,2487
4600,전라남도,무안군나선거구,6462102,4621,무안군,잘못 투입·구분된 투표지,,0,0,0,0,0,0,0,0,0,0,0
4600,전라남도,영광군가선거구,6462201,4622,영광군,합계,,26652,18643,3507,3454,3526,2920,3219,1375,18001,642,8009
4600,전라남도,영광군가선거구,6462201,4622,영광군,거소투표,,145,139,28,25,28,26,18,7,132,7,6
4600,전라남도,영광군가선거구,6462201,4622,영광군,관외사전투표,,1989,1988,443,393,381,261,370,106,1954,34,1
4600,전라남도,영광군가선거구,6462201,4622,영광군,영광읍,계,15829,10322,1711,1696,2228,1476,1931,966,10008,314,5507
4600,전라남도,영광군가선거구,6462201,4622,영광군,영광읍,관내사전투표,5214,5214,863,946,1264,652,927,441,5093,121,0
4600,전라남도,영광군가선거구,6462201,4622,영광군,영광읍,선거일투표,10615,5108,848,750,964,824,1004,525,4915,193,5507
4600,전라남도,영광군가선거구,6462201,4622,영광군,대마면,계,1520,1036,148,123,190,256,216,49,982,54,484
4600,전라남도,영광군가선거구,6462201,4622,영광군,대마면,관내사전투표,574,573,73,81,117,129,122,28,550,23,1
4600,전라남도,영광군가선거구,6462201,4622,영광군,대마면,선거일투표,946,463,75,42,73,127,94,21,432,31,483
4600,전라남도,영광군가선거구,6462201,4622,영광군,묘량면,계,1512,1072,217,121,192,237,193,68,1028,44,440
4600,전라남도,영광군가선거구,6462201,4622,영광군,묘량면,관내사전투표,589,589,115,72,104,114,119,41,565,24,0
4600,전라남도,영광군가선거구,6462201,4622,영광군,묘량면,선거일투표,923,483,102,49,88,123,74,27,463,20,440
4600,전라남도,영광군가선거구,6462201,4622,영광군,불갑면,계,1215,890,314,108,133,158,111,41,865,25,325
4600,전라남도,영광군가선거구,6462201,4622,영광군,불갑면,관내사전투표,558,558,177,74,77,108,79,23,538,20,0
4600,전라남도,영광군가선거구,6462201,4622,영광군,불갑면,선거일투표,657,332,137,34,56,50,32,18,327,5,325
4600,전라남도,영광군가선거구,6462201,4622,영광군,군서면,계,2373,1768,359,267,280,441,255,86,1688,80,605
4600,전라남도,영광군가선거구,6462201,4622,영광군,군서면,관내사전투표,1128,1128,224,190,192,268,154,53,1081,47,0
4600,전라남도,영광군가선거구,6462201,4622,영광군,군서면,선거일투표,1245,640,135,77,88,173,101,33,607,33,605
4600,전라남도,영광군가선거구,6462201,4622,영광군,군남면,계,2069,1427,287,721,94,65,125,51,1343,84,642
4600,전라남도,영광군가선거구,6462201,4622,영광군,군남면,관내사전투표,895,895,175,458,60,36,83,28,840,55,0
4600,전라남도,영광군가선거구,6462201,4622,영광군,군남면,선거일투표,1174,532,112,263,34,29,42,23,503,29,642
4600,전라남도,영광군가선거구,6462201,4622,영광군,잘못 투입·구분된 투표지,,0,1,0,0,0,0,0,1,1,0,-1
4600,전라남도,영광군나선거구,6462202,4622,영광군,합계,,18647,13177,2360,1613,1550,458,1737,1565,1208,1474,589,12554,623,5470
4600,전라남도,영광군나선거구,6462202,4622,영광군,거소투표,,54,49,7,4,7,2,12,4,3,4,2,45,4,5
4600,전라남도,영광군나선거구,6462202,4622,영광군,관외사전투표,,1687,1686,359,189,215,102,277,170,113,155,54,1634,52,1
4600,전라남도,영광군나선거구,6462202,4622,영광군,백수읍,계,3724,2614,183,125,868,56,830,98,57,210,44,2471,143,1110
4600,전라남도,영광군나선거구,6462202,4622,영광군,백수읍,관내사전투표,1297,1297,91,54,422,30,407,54,23,112,28,1221,76,0
4600,전라남도,영광군나선거구,6462202,4622,영광군,백수읍,선거일투표,2427,1317,92,71,446,26,423,44,34,98,16,1250,67,1110
4600,전라남도,영광군나선거구,6462202,4622,영광군,홍농읍,계,5047,3224,309,304,180,156,170,915,317,700,42,3093,131,1823
4600,전라남도,영광군나선거구,6462202,4622,영광군,홍농읍,관내사전투표,1771,1771,162,164,98,77,84,525,182,383,27,1702,69,0
4600,전라남도,영광군나선거구,6462202,4622,영광군,홍농읍,선거일투표,3276,1453,147,140,82,79,86,390,135,317,15,1391,62,1823
4600,전라남도,영광군나선거구,6462202,4622,영광군,염산면,계,3400,2413,225,801,152,66,217,108,40,222,423,2254,159,987
4600,전라남도,영광군나선거구,6462202,4622,영광군,염산면,관내사전투표,1436,1436,150,449,79,43,135,68,18,142,244,1328,108,0
4600,전라남도,영광군나선거구,6462202,4622,영광군,염산면,선거일투표,1964,977,75,352,73,23,82,40,22,80,179,926,51,987
4600,전라남도,영광군나선거구,6462202,4622,영광군,법성면,계,4367,2948,1217,161,116,72,200,237,665,138,20,2826,122,1419
4600,전라남도,영광군나선거구,6462202,4622,영광군,법성면,관내사전투표,1704,1704,714,93,66,38,105,123,398,75,12,1624,80,0
4600,전라남도,영광군나선거구,6462202,4622,영광군,법성면,선거일투표,2663,1244,503,68,50,34,95,114,267,63,8,1202,42,1419
4600,전라남도,영광군나선거구,6462202,4622,영광군,낙월면,계,368,242,60,29,11,4,31,33,13,45,4,230,12,126
4600,전라남도,영광군나선거구,6462202,4622,영광군,낙월면,관내사전투표,40,40,8,4,3,1,13,4,2,4,0,39,1,0
4600,전라남도,영광군나선거구,6462202,4622,영광군,낙월면,선거일투표,328,202,52,25,8,3,18,29,11,41,4,191,11,126
4600,전라남도,영광군나선거구,6462202,4622,영광군,잘못 투입·구분된 투표지,,0,1,0,0,1,0,0,0,0,0,0,1,0,-1
4600,전라남도,함평군가선거구,6462301,4623,함평군,합계,,13655,9469,2466,1802,1529,1066,2268,9131,338,4186
4600,전라남도,함평군가선거구,6462301,4623,함평군,거소투표,,119,111,28,26,11,12,25,102,9,8
4600,전라남도,함평군가선거구,6462301,4623,함평군,관외사전투표,,914,914,345,183,125,108,128,889,25,0
4600,전라남도,함평군가선거구,6462301,4623,함평군,함평읍,계,6699,4421,1359,737,387,675,1124,4282,139,2278
4600,전라남도,함평군가선거구,6462301,4623,함평군,함평읍,관내사전투표,2292,2292,764,358,199,339,560,2220,72,0
4600,전라남도,함평군가선거구,6462301,4623,함평군,함평읍,선거일투표,4407,2129,595,379,188,336,564,2062,67,2278
4600,전라남도,함평군가선거구,6462301,4623,함평군,손불면,계,2832,1918,221,201,788,127,504,1841,77,914
4600,전라남도,함평군가선거구,6462301,4623,함평군,손불면,관내사전투표,1012,1012,117,95,410,65,274,961,51,0
4600,전라남도,함평군가선거구,6462301,4623,함평군,손불면,선거일투표,1820,906,104,106,378,62,230,880,26,914
4600,전라남도,함평군가선거구,6462301,4623,함평군,신광면,계,1524,1041,240,424,49,56,230,999,42,483
4600,전라남도,함평군가선거구,6462301,4623,함평군,신광면,관내사전투표,535,534,121,218,28,32,116,515,19,1
4600,전라남도,함평군가선거구,6462301,4623,함평군,신광면,선거일투표,989,507,119,206,21,24,114,484,23,482
4600,전라남도,함평군가선거구,6462301,4623,함평군,엄다면,계,1567,1063,273,231,169,88,256,1017,46,504
4600,전라남도,함평군가선거구,6462301,4623,함평군,엄다면,관내사전투표,575,575,169,122,64,49,139,543,32,0
4600,전라남도,함평군가선거구,6462301,4623,함평군,엄다면,선거일투표,992,488,104,109,105,39,117,474,14,504
4600,전라남도,함평군가선거구,6462301,4623,함평군,잘못 투입·구분된 투표지,,0,1,0,0,0,0,1,1,0,-1
4600,전라남도,함평군나선거구,6462302,4623,함평군,합계,,14726,8759,2920,2374,2166,823,8283,476,5967
4600,전라남도,함평군나선거구,6462302,4623,함평군,거소투표,,70,61,14,17,24,1,56,5,9
4600,전라남도,함평군나선거구,6462302,4623,함평군,관외사전투표,,1078,1078,372,274,251,142,1039,39,0
4600,전라남도,함평군나선거구,6462302,4623,함평군,학교면,계,3090,1807,691,378,439,167,1675,132,1283
4600,전라남도,함평군나선거구,6462302,4623,함평군,학교면,관내사전투표,888,887,343,174,217,74,808,79,1
4600,전라남도,함평군나선거구,6462302,4623,함평군,학교면,선거일투표,2202,920,348,204,222,93,867,53,1282
4600,전라남도,함평군나선거구,6462302,4623,함평군,대동면,계,2578,1458,467,486,227,194,1374,84,1120
4600,전라남도,함평군나선거구,6462302,4623,함평군,대동면,관내사전투표,633,633,197,221,96,71,585,48,0
4600,전라남도,함평군나선거구,6462302,4623,함평군,대동면,선거일투표,1945,825,270,265,131,123,789,36,1120
4600,전라남도,함평군나선거구,6462302,4623,함평군,나산면,계,2386,1301,389,366,319,128,1202,99,1085
4600,전라남도,함평군나선거구,6462302,4623,함평군,나산면,관내사전투표,691,689,207,190,166,59,622,67,2
4600,전라남도,함평군나선거구,6462302,4623,함평군,나산면,선거일투표,1695,612,182,176,153,69,580,32,1083
4600,전라남도,함평군나선거구,6462302,4623,함평군,해보면,계,2358,1272,242,706,162,103,1213,59,1086
4600,전라남도,함평군나선거구,6462302,4623,함평군,해보면,관내사전투표,679,679,122,388,80,42,632,47,0
4600,전라남도,함평군나선거구,6462302,4623,함평군,해보면,선거일투표,1679,593,120,318,82,61,581,12,1086
4600,전라남도,함평군나선거구,6462302,4623,함평군,월야면,계,3166,1777,743,146,744,88,1721,56,1389
4600,전라남도,함평군나선거구,6462302,4623,함평군,월야면,관내사전투표,920,920,398,85,372,40,895,25,0
4600,전라남도,함평군나선거구,6462302,4623,함평군,월야면,선거일투표,2246,857,345,61,372,48,826,31,1389
4600,전라남도,함평군나선거구,6462302,4623,함평군,잘못 투입·구분된 투표지,,0,5,2,1,0,0,3,2,-5
4600,전라남도,신안군가선거구,6462401,4624,신안군,합계,,8646,6393,2465,1154,698,808,971,6096,297,2253
4600,전라남도,신안군가선거구,6462401,4624,신안군,거소투표,,59,58,31,7,4,7,6,55,3,1
4600,전라남도,신안군가선거구,6462401,4624,신안군,관외사전투표,,891,889,395,191,90,76,115,867,22,2
4600,전라남도,신안군가선거구,6462401,4624,신안군,지도읍,계,3714,2644,1481,162,97,608,145,2493,151,1070
4600,전라남도,신안군가선거구,6462401,4624,신안군,지도읍,관내사전투표,1662,1661,955,111,47,367,76,1556,105,1
4600,전라남도,신안군가선거구,6462401,4624,신안군,지도읍,선거일투표,2052,983,526,51,50,241,69,937,46,1069
4600,전라남도,신안군가선거구,6462401,4624,신안군,증도면,계,1490,1111,445,342,72,79,118,1056,55,379
4600,전라남도,신안군가선거구,6462401,4624,신안군,증도면,관내사전투표,621,621,250,210,25,35,67,587,34,0
4600,전라남도,신안군가선거구,6462401,4624,신안군,증도면,선거일투표,869,490,195,132,47,44,51,469,21,379
4600,전라남도,신안군가선거구,6462401,4624,신안군,임자면,계,2492,1690,113,452,435,38,586,1624,66,802
4600,전라남도,신안군가선거구,6462401,4624,신안군,임자면,관내사전투표,886,886,54,243,197,19,331,844,42,0
4600,전라남도,신안군가선거구,6462401,4624,신안군,임자면,선거일투표,1606,804,59,209,238,19,255,780,24,802
4600,전라남도,신안군가선거구,6462401,4624,신안군,잘못 투입·구분된 투표지,,0,1,0,0,0,0,1,1,0,-1
4600,전라남도,신안군나선거구,6462402,4624,신안군,합계,,9642,7181,2273,2188,972,1398,6831,350,2461
4600,전라남도,신안군나선거구,6462402,4624,신안군,거소투표,,104,101,52,26,6,9,93,8,3
4600,전라남도,신안군나선거구,6462402,4624,신안군,관외사전투표,,1065,1064,425,292,129,189,1035,29,1
4600,전라남도,신안군나선거구,6462402,4624,신안군,압해읍,계,4985,3476,1318,233,729,1036,3316,160,1509
4600,전라남도,신안군나선거구,6462402,4624,신안군,압해읍,관내사전투표,1791,1789,761,109,308,504,1682,107,2
4600,전라남도,신안군나선거구,6462402,4624,신안군,압해읍,선거일투표,3194,1687,557,124,421,532,1634,53,1507
4600,전라남도,신안군나선거구,6462402,4624,신안군,자은면,계,1908,1355,226,941,44,59,1270,85,553
4600,전라남도,신안군나선거구,6462402,4624,신안군,자은면,관내사전투표,862,861,143,601,25,35,804,57,1
4600,전라남도,신안군나선거구,6462402,4624,신안군,자은면,선거일투표,1046,494,83,340,19,24,466,28,552
4600,전라남도,신안군나선거구,6462402,4624,신안군,암태면,계,1580,1179,249,694,64,104,1111,68,401
4600,전라남도,신안군나선거구,6462402,4624,신안군,암태면,관내사전투표,749,749,169,427,33,67,696,53,0
4600,전라남도,신안군나선거구,6462402,4624,신안군,암태면,선거일투표,831,430,80,267,31,37,415,15,401
4600,전라남도,신안군나선거구,6462402,4624,신안군,잘못 투입·구분된 투표지,,0,6,3,2,0,1,6,0,-6
4600,전라남도,신안군다선거구,6462403,4624,신안군,합계,,8858,6587,2228,1725,382,285,1697,6317,270,2271
4600,전라남도,신안군다선거구,6462403,4624,신안군,거소투표,,71,66,11,38,2,2,10,63,3,5
4600,전라남도,신안군다선거구,6462403,4624,신안군,관외사전투표,,1426,1426,522,467,110,65,228,1392,34,0
4600,전라남도,신안군다선거구,6462403,4624,신안군,비금면,계,2734,1999,919,38,29,20,898,1904,95,735
4600,전라남도,신안군다선거구,6462403,4624,신안군,비금면,관내사전투표,1153,1148,555,18,17,13,489,1092,56,5
4600,전라남도,신안군다선거구,6462403,4624,신안군,비금면,선거일투표,1581,851,364,20,12,7,409,812,39,730
4600,전라남도,신안군다선거구,6462403,4624,신안군,도초면,계,2048,1421,606,193,33,14,485,1331,90,627
4600,전라남도,신안군다선거구,6462403,4624,신안군,도초면,관내사전투표,913,912,381,139,21,8,300,849,63,1
4600,전라남도,신안군다선거구,6462403,4624,신안군,도초면,선거일투표,1135,509,225,54,12,6,185,482,27,626
4600,전라남도,신안군다선거구,6462403,4624,신안군,흑산면,계,2579,1669,166,989,208,184,75,1622,47,910
4600,전라남도,신안군다선거구,6462403,4624,신안군,흑산면,관내사전투표,605,605,54,341,78,87,31,591,14,0
4600,전라남도,신안군다선거구,6462403,4624,신안군,흑산면,선거일투표,1974,1064,112,648,130,97,44,1031,33,910
4600,전라남도,신안군다선거구,6462403,4624,신안군,잘못 투입·구분된 투표지,,0,6,4,0,0,0,1,5,1,-6
4600,전라남도,신안군라선거구,6462404,4624,신안군,합계,,8100,6253,1658,2572,1674,5904,349,1847
4600,전라남도,신안군라선거구,6462404,4624,신안군,거소투표,,77,70,14,24,31,69,1,7
4600,전라남도,신안군라선거구,6462404,4624,신안군,관외사전투표,,1164,1159,320,475,335,1130,29,5
4600,전라남도,신안군라선거구,6462404,4624,신안군,하의면,계,1304,921,193,349,335,877,44,383
4600,전라남도,신안군라선거구,6462404,4624,신안군,하의면,관내사전투표,591,590,121,241,191,553,37,1
4600,전라남도,신안군라선거구,6462404,4624,신안군,하의면,선거일투표,713,331,72,108,144,324,7,382
4600,전라남도,신안군라선거구,6462404,4624,신안군,신의면,계,1123,843,133,131,522,786,57,280
4600,전라남도,신안군라선거구,6462404,4624,신안군,신의면,관내사전투표,599,597,83,82,394,559,38,2
4600,전라남도,신안군라선거구,6462404,4624,신안군,신의면,선거일투표,524,246,50,49,128,227,19,278
4600,전라남도,신안군라선거구,6462404,4624,신안군,장산면,계,1206,858,217,283,293,793,65,348
4600,전라남도,신안군라선거구,6462404,4624,신안군,장산면,관내사전투표,559,557,131,199,187,517,40,2
4600,전라남도,신안군라선거구,6462404,4624,신안군,장산면,선거일투표,647,301,86,84,106,276,25,346
4600,전라남도,신안군라선거구,6462404,4624,신안군,안좌면,계,2387,1752,553,993,96,1642,110,635
4600,전라남도,신안군라선거구,6462404,4624,신안군,안좌면,관내사전투표,1162,1161,385,636,54,1075,86,1
4600,전라남도,신안군라선거구,6462404,4624,신안군,안좌면,선거일투표,1225,591,168,357,42,567,24,634
4600,전라남도,신안군라선거구,6462404,4624,신안군,팔금면,계,839,640,224,315,59,598,42,199
4600,전라남도,신안군라선거구,6462404,4624,신안군,팔금면,관내사전투표,486,486,167,241,43,451,35,0
4600,전라남도,신안군라선거구,6462404,4624,신안군,팔금면,선거일투표,353,154,57,74,16,147,7,199
4600,전라남도,신안군라선거구,6462404,4624,신안군,잘못 투입·구분된 투표지,,0,10,4,2,3,9,1,-104700,경상북도,포항시가선거구,6470101,4701,포항시북구,합계,,34200,15659,3822,5608,5893,15323,336,18541
4700,경상북도,포항시가선거구,6470101,4701,포항시북구,거소투표,,47,45,5,21,13,39,6,2
4700,경상북도,포항시가선거구,6470101,4701,포항시북구,관외사전투표,,1755,1745,500,668,524,1692,53,10
4700,경상북도,포항시가선거구,6470101,4701,포항시북구,흥해읍,계,32398,13856,3312,4914,5354,13580,276,18542
4700,경상북도,포항시가선거구,6470101,4701,포항시북구,흥해읍,관내사전투표,3486,3485,773,1122,1496,3391,94,1
4700,경상북도,포항시가선거구,6470101,4701,포항시북구,흥해읍,선거일투표,28912,10371,2539,3792,3858,10189,182,18541
4700,경상북도,포항시가선거구,6470101,4701,포항시북구,잘못 투입·구분된 투표지,,0,13,5,5,2,12,1,-13
4700,경상북도,포항시나선거구,6470102,4701,포항시북구,합계,,18345,12170,1805,3843,1291,1695,3087,11721,449,6175
4700,경상북도,포항시나선거구,6470102,4701,포항시북구,거소투표,,103,91,22,36,5,6,9,78,13,12
4700,경상북도,포항시나선거구,6470102,4701,포항시북구,관외사전투표,,864,863,190,324,65,101,151,831,32,1
4700,경상북도,포항시나선거구,6470102,4701,포항시북구,신광면,계,2633,1532,283,333,130,255,475,1476,56,1101
4700,경상북도,포항시나선거구,6470102,4701,포항시북구,신광면,관내사전투표,586,572,109,106,49,100,180,544,28,14
4700,경상북도,포항시나선거구,6470102,4701,포항시북구,신광면,선거일투표,2047,960,174,227,81,155,295,932,28,1087
4700,경상북도,포항시나선거구,6470102,4701,포항시북구,청하면,계,4302,2681,693,274,707,821,85,2580,101,1621
4700,경상북도,포항시나선거구,6470102,4701,포항시북구,청하면,관내사전투표,1136,1132,290,117,317,305,37,1066,66,4
4700,경상북도,포항시나선거구,6470102,4701,포항시북구,청하면,선거일투표,3166,1549,403,157,390,516,48,1514,35,1617
4700,경상북도,포항시나선거구,6470102,4701,포항시북구,송라면,계,2234,1374,356,219,301,392,51,1319,55,860
4700,경상북도,포항시나선거구,6470102,4701,포항시북구,송라면,관내사전투표,742,742,187,131,157,206,27,708,34,0
4700,경상북도,포항시나선거구,6470102,4701,포항시북구,송라면,선거일투표,1492,632,169,88,144,186,24,611,21,860
4700,경상북도,포항시나선거구,6470102,4701,포항시북구,기계면,계,4536,3057,107,1766,31,53,999,2956,101,1479
4700,경상북도,포항시나선거구,6470102,4701,포항시북구,기계면,관내사전투표,1511,1505,60,866,15,25,480,1446,59,6
4700,경상북도,포항시나선거구,6470102,4701,포항시북구,기계면,선거일투표,3025,1552,47,900,16,28,519,1510,42,1473
4700,경상북도,포항시나선거구,6470102,4701,포항시북구,죽장면,계,2500,1718,110,515,34,45,956,1660,58,782
4700,경상북도,포항시나선거구,6470102,4701,포항시북구,죽장면,관내사전투표,856,853,59,231,12,18,500,820,33,3
4700,경상북도,포항시나선거구,6470102,4701,포항시북구,죽장면,선거일투표,1644,865,51,284,22,27,456,840,25,779
4700,경상북도,포항시나선거구,6470102,4701,포항시북구,기북면,계,1173,824,40,363,16,18,356,793,31,349
4700,경상북도,포항시나선거구,6470102,4701,포항시북구,기북면,관내사전투표,476,473,21,204,7,8,215,455,18,3
4700,경상북도,포항시나선거구,6470102,4701,포항시북구,기북면,선거일투표,697,351,19,159,9,10,141,338,13,346
4700,경상북도,포항시나선거구,6470102,4701,포항시북구,잘못 투입·구분된 투표지,,0,30,4,13,2,4,5,28,2,-30
4700,경상북도,포항시다선거구,6470103,4701,포항시북구,합계,,46755,21143,3678,8479,5153,2317,1067,20694,449,25612
4700,경상북도,포항시다선거구,6470103,4701,포항시북구,거소투표,,70,64,12,23,14,7,1,57,7,6
4700,경상북도,포항시다선거구,6470103,4701,포항시북구,관외사전투표,,2531,2512,622,988,503,224,118,2455,57,19
4700,경상북도,포항시다선거구,6470103,4701,포항시북구,용흥동,계,18168,8178,1109,4055,1450,1110,273,7997,181,9990
4700,경상북도,포항시다선거구,6470103,4701,포항시북구,용흥동,관내사전투표,2030,1989,301,938,357,282,55,1933,56,41
4700,경상북도,포항시다선거구,6470103,4701,포항시북구,용흥동,선거일투표,16138,6189,808,3117,1093,828,218,6064,125,9949
4700,경상북도,포항시다선거구,6470103,4701,포항시북구,우창동,계,25986,10326,1922,3393,3175,964,670,10124,202,15660
4700,경상북도,포항시다선거구,6470103,4701,포항시북구,우창동,관내사전투표,2835,2833,570,855,902,279,174,2780,53,2
4700,경상북도,포항시다선거구,6470103,4701,포항시북구,우창동,선거일투표,23151,7493,1352,2538,2273,685,496,7344,149,15658
4700,경상북도,포항시다선거구,6470103,4701,포항시북구,잘못 투입·구분된 투표지,,0,63,13,20,11,12,5,61,2,-63
4700,경상북도,포항시라선거구,6470104,4701,포항시북구,합계,,46821,20509,2954,10277,2740,1347,1110,1486,19914,595,26312
4700,경상북도,포항시라선거구,6470104,4701,포항시북구,거소투표,,92,80,13,39,15,1,3,5,76,4,12
4700,경상북도,포항시라선거구,6470104,4701,포항시북구,관외사전투표,,2280,2279,506,1079,264,91,102,159,2201,78,1
4700,경상북도,포항시라선거구,6470104,4701,포항시북구,중앙동,계,13286,5417,703,2749,649,69,621,430,5221,196,7869
4700,경상북도,포항시라선거구,6470104,4701,포항시북구,중앙동,관내사전투표,1508,1508,209,753,174,25,170,132,1463,45,0
4700,경상북도,포항시라선거구,6470104,4701,포항시북구,중앙동,선거일투표,11778,3909,494,1996,475,44,451,298,3758,151,7869
4700,경상북도,포항시라선거구,6470104,4701,포항시북구,양학동,계,13525,5930,956,2170,1097,1068,145,371,5807,123,7595
4700,경상북도,포항시라선거구,6470104,4701,포항시북구,양학동,관내사전투표,2132,2130,391,715,399,414,52,127,2098,32,2
4700,경상북도,포항시라선거구,6470104,4701,포항시북구,양학동,선거일투표,11393,3800,565,1455,698,654,93,244,3709,91,7593
4700,경상북도,포항시라선거구,6470104,4701,포항시북구,죽도동,계,17638,6800,776,4238,714,118,239,521,6606,194,10838
4700,경상북도,포항시라선거구,6470104,4701,포항시북구,죽도동,관내사전투표,1978,1978,215,1277,177,28,70,151,1918,60,0
4700,경상북도,포항시라선거구,6470104,4701,포항시북구,죽도동,선거일투표,15660,4822,561,2961,537,90,169,370,4688,134,10838
4700,경상북도,포항시라선거구,6470104,4701,포항시북구,잘못 투입·구분된 투표지,,0,3,0,2,1,0,0,0,3,0,-3
4700,경상북도,포항시마선거구,6470105,4701,포항시북구,합계,,52280,22910,5139,9619,4281,591,2778,22408,502,29370
4700,경상북도,포항시마선거구,6470105,4701,포항시북구,거소투표,,78,74,12,33,9,5,9,68,6,4
4700,경상북도,포항시마선거구,6470105,4701,포항시북구,관외사전투표,,2537,2536,695,1014,458,77,211,2455,81,1
4700,경상북도,포항시마선거구,6470105,4701,포항시북구,두호동,계,18408,7827,1420,4246,1308,161,543,7678,149,10581
4700,경상북도,포항시마선거구,6470105,4701,포항시북구,두호동,관내사전투표,1988,1951,345,1092,304,38,136,1915,36,37
4700,경상북도,포항시마선거구,6470105,4701,포항시북구,두호동,선거일투표,16420,5876,1075,3154,1004,123,407,5763,113,10544
4700,경상북도,포항시마선거구,6470105,4701,포항시북구,장량동,계,23936,8952,2545,3289,2129,297,499,8759,193,14984
4700,경상북도,포항시마선거구,6470105,4701,포항시북구,장량동,관내사전투표,1985,1975,586,637,530,75,93,1921,54,10
4700,경상북도,포항시마선거구,6470105,4701,포항시북구,장량동,선거일투표,21951,6977,1959,2652,1599,222,406,6838,139,14974
4700,경상북도,포항시마선거구,6470105,4701,포항시북구,환여동,계,7321,3426,444,1004,359,47,1501,3355,71,3895
4700,경상북도,포항시마선거구,6470105,4701,포항시북구,환여동,관내사전투표,1168,1124,164,316,107,15,501,1103,21,44
4700,경상북도,포항시마선거구,6470105,4701,포항시북구,환여동,선거일투표,6153,2302,280,688,252,32,1000,2252,50,3851
4700,경상북도,포항시마선거구,6470105,4701,포항시북구,잘못 투입·구분된 투표지,,0,95,23,33,18,4,15,93,2,-95
4700,경상북도,포항시바선거구,6470201,4701,포항시북구,합계,,32559,13383,2469,5335,2546,2769,13119,264,19176
4700,경상북도,포항시바선거구,6470201,4701,포항시북구,거소투표,,71,67,11,25,8,12,56,11,4
4700,경상북도,포항시바선거구,6470201,4701,포항시북구,관외사전투표,,2287,2285,514,834,409,457,2214,71,2
4700,경상북도,포항시바선거구,6470201,4701,포항시북구,장량동,계,30201,11021,1943,4473,2125,2298,10839,182,19180
4700,경상북도,포항시바선거구,6470201,4701,포항시북구,장량동,관내사전투표,1863,1859,382,689,366,374,1811,48,4
4700,경상북도,포항시바선거구,6470201,4701,포항시북구,장량동,선거일투표,28338,9162,1561,3784,1759,1924,9028,134,19176
4700,경상북도,포항시바선거구,6470201,4701,포항시북구,잘못 투입·구분된 투표지,,0,10,1,3,4,2,10,0,-10
4700,경상북도,포항시사선거구,6470202,4702,포항시남구,합계,,34178,16368,1847,3737,2047,4328,1785,2058,15802,566,17810
4700,경상북도,포항시사선거구,6470202,4702,포항시남구,거소투표,,57,55,11,23,5,4,2,4,49,6,2
4700,경상북도,포항시사선거구,6470202,4702,포항시남구,관외사전투표,,1111,1109,242,334,152,184,83,83,1078,31,2
4700,경상북도,포항시사선거구,6470202,4702,포항시남구,해도동,계,15405,6986,583,1258,416,2916,1264,305,6742,244,8419
4700,경상북도,포항시사선거구,6470202,4702,포항시남구,해도동,관내사전투표,2165,2165,188,329,123,940,411,110,2101,64,0
4700,경상북도,포항시사선거구,6470202,4702,포항시남구,해도동,선거일투표,13240,4821,395,929,293,1976,853,195,4641,180,8419
4700,경상북도,포항시사선거구,6470202,4702,포항시남구,송도동,계,10788,5226,340,1404,325,1067,338,1566,5040,186,5562
4700,경상북도,포항시사선거구,6470202,4702,포항시남구,송도동,관내사전투표,1880,1880,113,476,93,406,101,639,1828,52,0
4700,경상북도,포항시사선거구,6470202,4702,포항시남구,송도동,선거일투표,8908,3346,227,928,232,661,237,927,3212,134,5562
4700,경상북도,포항시사선거구,6470202,4702,포항시남구,청림동,계,4140,1883,430,395,834,84,43,40,1826,57,2257
4700,경상북도,포항시사선거구,6470202,4702,포항시남구,청림동,관내사전투표,730,730,159,141,350,33,12,13,708,22,0
4700,경상북도,포항시사선거구,6470202,4702,포항시남구,청림동,선거일투표,3410,1153,271,254,484,51,31,27,1118,35,2257
4700,경상북도,포항시사선거구,6470202,4702,포항시남구,제철동,계,2677,1107,241,321,315,73,55,60,1065,42,1570
4700,경상북도,포항시사선거구,6470202,4702,포항시남구,제철동,관내사전투표,555,555,110,149,180,45,20,33,537,18,0
4700,경상북도,포항시사선거구,6470202,4702,포항시남구,제철동,선거일투표,2122,552,131,172,135,28,35,27,528,24,1570
4700,경상북도,포항시사선거구,6470202,4702,포항시남구,잘못 투입·구분된 투표지,,0,2,0,2,0,0,0,0,2,0,-2
4700,경상북도,포항시아선거구,6470203,4702,포항시남구,합계,,21233,12402,2403,3935,1932,3187,11457,945,8831
4700,경상북도,포항시아선거구,6470203,4702,포항시남구,거소투표,,54,48,12,23,2,7,44,4,6
4700,경상북도,포항시아선거구,6470203,4702,포항시남구,관외사전투표,,833,832,164,328,137,176,805,27,1
4700,경상북도,포항시아선거구,6470203,4702,포항시남구,구룡포읍,계,6731,3933,1336,1771,300,274,3681,252,2798
4700,경상북도,포항시아선거구,6470203,4702,포항시남구,구룡포읍,관내사전투표,1723,1722,587,779,121,152,1639,83,1
4700,경상북도,포항시아선거구,6470203,4702,포항시남구,구룡포읍,선거일투표,5008,2211,749,992,179,122,2042,169,2797
4700,경상북도,포항시아선거구,6470203,4702,포항시남구,동해면,계,8296,4533,435,758,530,2528,4251,282,3763
4700,경상북도,포항시아선거구,6470203,4702,포항시남구,동해면,관내사전투표,2185,2181,194,305,207,1375,2081,100,4
4700,경상북도,포항시아선거구,6470203,4702,포항시남구,동해면,선거일투표,6111,2352,241,453,323,1153,2170,182,3759
4700,경상북도,포항시아선거구,6470203,4702,포항시남구,장기면,계,3620,2008,223,594,788,123,1728,280,1612
4700,경상북도,포항시아선거구,6470203,4702,포항시남구,장기면,관내사전투표,975,972,114,256,421,54,845,127,3
4700,경상북도,포항시아선거구,6470203,4702,포항시남구,장기면,선거일투표,2645,1036,109,338,367,69,883,153,1609
4700,경상북도,포항시아선거구,6470203,4702,포항시남구,호미곶면,계,1699,1034,231,458,174,74,937,97,665
4700,경상북도,포항시아선거구,6470203,4702,포항시남구,호미곶면,관내사전투표,682,682,163,307,112,45,627,55,0
4700,경상북도,포항시아선거구,6470203,4702,포항시남구,호미곶면,선거일투표,1017,352,68,151,62,29,310,42,665
4700,경상북도,포항시아선거구,6470203,4702,포항시남구,잘못 투입·구분된 투표지,,0,14,2,3,1,5,11,3,-14
4700,경상북도,포항시자선거구,6470204,4702,포항시남구,합계,,50779,23123,4125,6074,5430,3810,671,2357,22467,656,27656
4700,경상북도,포항시자선거구,6470204,4702,포항시남구,거소투표,,85,77,7,17,25,16,0,3,68,9,8
4700,경상북도,포항시자선거구,6470204,4702,포항시남구,관외사전투표,,2406,2406,600,698,432,304,82,215,2331,75,0
4700,경상북도,포항시자선거구,6470204,4702,포항시남구,연일읍,계,23785,10518,1945,2026,3486,656,284,1865,10262,256,13267
4700,경상북도,포항시자선거구,6470204,4702,포항시남구,연일읍,관내사전투표,2866,2866,529,514,1123,169,73,378,2786,80,0
4700,경상북도,포항시자선거구,6470204,4702,포항시남구,연일읍,선거일투표,20919,7652,1416,1512,2363,487,211,1487,7476,176,13267
4700,경상북도,포항시자선거구,6470204,4702,포항시남구,대송면,계,3152,1758,418,643,385,89,59,96,1690,68,1394
4700,경상북도,포항시자선거구,6470204,4702,포항시남구,대송면,관내사전투표,716,715,167,259,169,37,20,35,687,28,1
4700,경상북도,포항시자선거구,6470204,4702,포항시남구,대송면,선거일투표,2436,1043,251,384,216,52,39,61,1003,40,1393
4700,경상북도,포항시자선거구,6470204,4702,포항시남구,상대동,계,21351,8363,1155,2689,1102,2745,246,178,8115,248,12988
4700,경상북도,포항시자선거구,6470204,4702,포항시남구,상대동,관내사전투표,2391,2391,358,700,273,847,70,57,2305,86,0
4700,경상북도,포항시자선거구,6470204,4702,포항시남구,상대동,선거일투표,18960,5972,797,1989,829,1898,176,121,5810,162,12988
4700,경상북도,포항시자선거구,6470204,4702,포항시남구,잘못 투입·구분된 투표지,,0,1,0,1,0,0,0,0,1,0,-1
4700,경상북도,포항시차선거구,6470205,4702,포항시남구,합계,,46038,17681,4051,5281,2442,2732,753,1767,17026,655,28357
4700,경상북도,포항시차선거구,6470205,4702,포항시남구,거소투표,,90,83,12,27,13,9,1,7,69,14,7
4700,경상북도,포항시차선거구,6470205,4702,포항시남구,관외사전투표,,1541,1541,456,429,222,163,58,136,1464,77,0
4700,경상북도,포항시차선거구,6470205,4702,포항시남구,오천읍,계,44407,16056,3583,4825,2207,2560,694,1623,15492,564,28351
4700,경상북도,포항시차선거구,6470205,4702,포항시남구,오천읍,관내사전투표,4672,4672,1117,1378,624,710,191,506,4526,146,0
4700,경상북도,포항시차선거구,6470205,4702,포항시남구,오천읍,선거일투표,39735,11384,2466,3447,1583,1850,503,1117,10966,418,28351
4700,경상북도,포항시차선거구,6470205,4702,포항시남구,잘못 투입·구분된 투표지,,0,1,0,0,0,0,0,1,1,0,-1
4700,경상북도,포항시카선거구,6470206,4702,포항시남구,합계,,44499,20874,5882,5312,3254,4253,898,802,20401,473,23625
4700,경상북도,포항시카선거구,6470206,4702,포항시남구,거소투표,,40,36,13,7,6,4,4,1,35,1,4
4700,경상북도,포항시카선거구,6470206,4702,포항시남구,관외사전투표,,2278,2277,711,616,294,413,81,101,2216,61,1
4700,경상북도,포항시카선거구,6470206,4702,포항시남구,효곡동,계,22418,10350,3034,2281,1612,2658,243,284,10112,238,12068
4700,경상북도,포항시카선거구,6470206,4702,포항시남구,효곡동,관내사전투표,3058,3058,925,689,438,778,68,81,2979,79,0
4700,경상북도,포항시카선거구,6470206,4702,포항시남구,효곡동,선거일투표,19360,7292,2109,1592,1174,1880,175,203,7133,159,12068
4700,경상북도,포항시카선거구,6470206,4702,포항시남구,대이동,계,19763,8210,2124,2408,1342,1178,570,415,8037,173,11553
4700,경상북도,포항시카선거구,6470206,4702,포항시남구,대이동,관내사전투표,2417,2417,655,664,415,327,165,154,2380,37,0
4700,경상북도,포항시카선거구,6470206,4702,포항시남구,대이동,선거일투표,17346,5793,1469,1744,927,851,405,261,5657,136,11553
4700,경상북도,포항시카선거구,6470206,4702,포항시남구,잘못 투입·구분된 투표지,,0,1,0,0,0,0,0,1,1,0,-1
4700,경상북도,울릉군가선거구,6470301,4703,울릉군,합계,,5839,4641,686,461,559,826,968,1010,4510,131,1198
4700,경상북도,울릉군가선거구,6470301,4703,울릉군,거소투표,,44,44,5,8,1,7,4,17,42,2,0
4700,경상북도,울릉군가선거구,6470301,4703,울릉군,관외사전투표,,838,838,138,51,87,178,177,184,815,23,0
4700,경상북도,울릉군가선거구,6470301,4703,울릉군,울릉읍,계,4957,3759,543,402,471,641,787,809,3653,106,1198
4700,경상북도,울릉군가선거구,6470301,4703,울릉군,울릉읍,관내사전투표,1790,1790,271,145,225,317,381,413,1752,38,0
4700,경상북도,울릉군가선거구,6470301,4703,울릉군,울릉읍,선거일투표,3167,1969,272,257,246,324,406,396,1901,68,1198
4700,경상북도,울릉군가선거구,6470301,4703,울릉군,잘못 투입·구분된 투표지,,0,0,0,0,0,0,0,0,0,0,0
4700,경상북도,울릉군나선거구,6470302,4703,울릉군,합계,,2500,2155,651,655,799,2105,50,345
4700,경상북도,울릉군나선거구,6470302,4703,울릉군,거소투표,,16,16,4,6,4,14,2,0
4700,경상북도,울릉군나선거구,6470302,4703,울릉군,관외사전투표,,460,460,133,155,164,452,8,0
4700,경상북도,울릉군나선거구,6470302,4703,울릉군,서면,계,1029,875,243,373,241,857,18,154
4700,경상북도,울릉군나선거구,6470302,4703,울릉군,서면,관내사전투표,437,434,118,191,110,419,15,3
4700,경상북도,울릉군나선거구,6470302,4703,울릉군,서면,선거일투표,592,441,125,182,131,438,3,151
4700,경상북도,울릉군나선거구,6470302,4703,울릉군,북면,계,995,801,269,121,389,779,22,194
4700,경상북도,울릉군나선거구,6470302,4703,울릉군,북면,관내사전투표,402,402,152,42,190,384,18,0
4700,경상북도,울릉군나선거구,6470302,4703,울릉군,북면,선거일투표,593,399,117,79,199,395,4,194
4700,경상북도,울릉군나선거구,6470302,4703,울릉군,잘못 투입·구분된 투표지,,0,3,2,0,1,3,0,-3
4700,경상북도,경주시가선거구,6470401,4704,경주시,합계,,23055,10523,2328,3972,2521,654,790,10265,258,12532
4700,경상북도,경주시가선거구,6470401,4704,경주시,거소투표,,35,30,15,7,4,2,0,28,2,5
4700,경상북도,경주시가선거구,6470401,4704,경주시,관외사전투표,,1520,1512,395,563,319,41,146,1464,48,8
4700,경상북도,경주시가선거구,6470401,4704,경주시,황성동,계,21500,8967,1914,3395,2196,611,644,8760,207,12533
4700,경상북도,경주시가선거구,6470401,4704,경주시,황성동,관내사전투표,3149,3145,739,1181,733,206,212,3071,74,4
4700,경상북도,경주시가선거구,6470401,4704,경주시,황성동,선거일투표,18351,5822,1175,2214,1463,405,432,5689,133,12529
4700,경상북도,경주시가선거구,6470401,4704,경주시,잘못 투입·구분된 투표지,,0,14,4,7,2,0,0,13,1,-14
4700,경상북도,경주시나선거구,6470402,4704,경주시,합계,,30310,14782,2104,5162,3158,2367,770,841,14402,380,15528
4700,경상북도,경주시나선거구,6470402,4704,경주시,거소투표,,50,47,2,20,10,4,5,2,43,4,3
4700,경상북도,경주시나선거구,6470402,4704,경주시,관외사전투표,,2052,2052,403,781,398,232,97,76,1987,65,0
4700,경상북도,경주시나선거구,6470402,4704,경주시,현곡면,계,16251,7639,1088,2003,1593,1561,564,652,7461,178,8612
4700,경상북도,경주시나선거구,6470402,4704,경주시,현곡면,관내사전투표,2158,2157,282,594,453,503,119,137,2088,69,1
4700,경상북도,경주시나선거구,6470402,4704,경주시,현곡면,선거일투표,14093,5482,806,1409,1140,1058,445,515,5373,109,8611
4700,경상북도,경주시나선거구,6470402,4704,경주시,성건동,계,11957,5042,611,2357,1157,570,104,111,4910,132,6915
4700,경상북도,경주시나선거구,6470402,4704,경주시,성건동,관내사전투표,1982,1982,231,897,498,218,46,41,1931,51,0
4700,경상북도,경주시나선거구,6470402,4704,경주시,성건동,선거일투표,9975,3060,380,1460,659,352,58,70,2979,81,6915
4700,경상북도,경주시나선거구,6470402,4704,경주시,잘못 투입·구분된 투표지,,0,2,0,1,0,0,0,0,1,1,-2
4700,경상북도,경주시다선거구,6470403,4704,경주시,합계,,20944,9962,1522,4203,3156,777,9658,304,10982
4700,경상북도,경주시다선거구,6470403,4704,경주시,거소투표,,37,33,6,12,10,2,30,3,4
4700,경상북도,경주시다선거구,6470403,4704,경주시,관외사전투표,,1172,1171,276,485,284,84,1129,42,1
4700,경상북도,경주시다선거구,6470403,4704,경주시,동천동,계,18203,7923,1149,3335,2562,644,7690,233,10280
4700,경상북도,경주시다선거구,6470403,4704,경주시,동천동,관내사전투표,2519,2519,377,1057,836,182,2452,67,0
4700,경상북도,경주시다선거구,6470403,4704,경주시,동천동,선거일투표,15684,5404,772,2278,1726,462,5238,166,10280
4700,경상북도,경주시다선거구,6470403,4704,경주시,보덕동,계,1532,831,90,369,299,47,805,26,701
4700,경상북도,경주시다선거구,6470403,4704,경주시,보덕동,관내사전투표,446,446,43,202,167,19,431,15,0
4700,경상북도,경주시다선거구,6470403,4704,경주시,보덕동,선거일투표,1086,385,47,167,132,28,374,11,701
4700,경상북도,경주시다선거구,6470403,4704,경주시,잘못 투입·구분된 투표지,,0,4,1,2,1,0,4,0,-4
4700,경상북도,경주시라선거구,6470404,4704,경주시,합계,,34725,18026,1946,4475,2211,1765,1581,953,48,1206,3163,17348,678,16699
4700,경상북도,경주시라선거구,6470404,4704,경주시,거소투표,,102,94,9,19,10,9,3,5,1,3,30,89,5,8
4700,경상북도,경주시라선거구,6470404,4704,경주시,관외사전투표,,2146,2145,370,702,307,153,166,58,8,119,182,2065,80,1
4700,경상북도,경주시라선거구,6470404,4704,경주시,감포읍,계,4682,2732,51,153,55,762,17,39,5,19,1519,2620,112,1950
4700,경상북도,경주시라선거구,6470404,4704,경주시,감포읍,관내사전투표,1536,1535,28,71,34,431,10,19,5,9,852,1459,76,1
4700,경상북도,경주시라선거구,6470404,4704,경주시,감포읍,선거일투표,3146,1197,23,82,21,331,7,20,0,10,667,1161,36,1949
4700,경상북도,경주시라선거구,6470404,4704,경주시,외동읍,계,18862,7853,1221,1875,1656,165,1323,45,29,1002,218,7534,319,11009
4700,경상북도,경주시라선거구,6470404,4704,경주시,외동읍,관내사전투표,2063,2063,300,438,415,52,408,13,3,297,54,1980,83,0
4700,경상북도,경주시라선거구,6470404,4704,경주시,외동읍,선거일투표,16799,5790,921,1437,1241,113,915,32,26,705,164,5554,236,11009
4700,경상북도,경주시라선거구,6470404,4704,경주시,문무대왕면,계,3586,2019,86,297,107,402,31,67,2,44,910,1946,73,1567
4700,경상북도,경주시라선거구,6470404,4704,경주시,문무대왕면,관내사전투표,1127,1127,43,154,50,226,14,32,0,23,542,1084,43,0
4700,경상북도,경주시라선거구,6470404,4704,경주시,문무대왕면,선거일투표,2459,892,43,143,57,176,17,35,2,21,368,862,30,1567
4700,경상북도,경주시라선거구,6470404,4704,경주시,양남면,계,5347,3181,209,1428,76,274,41,739,3,19,303,3092,89,2166
4700,경상북도,경주시라선거구,6470404,4704,경주시,양남면,관내사전투표,1645,1645,101,771,37,139,25,368,2,15,140,1598,47,0
4700,경상북도,경주시라선거구,6470404,4704,경주시,양남면,선거일투표,3702,1536,108,657,39,135,16,371,1,4,163,1494,42,2166
4700,경상북도,경주시라선거구,6470404,4704,경주시,잘못 투입·구분된 투표지,,0,2,0,1,0,0,0,0,0,0,1,2,0,-2
4700,경상북도,경주시마선거구,6470405,4704,경주시,합계,,27125,13797,4226,3319,392,3109,2071,13117,680,13328
4700,경상북도,경주시마선거구,6470405,4704,경주시,거소투표,,53,51,26,8,1,7,2,44,7,2
4700,경상북도,경주시마선거구,6470405,4704,경주시,관외사전투표,,1009,1008,455,195,64,110,121,945,63,1
4700,경상북도,경주시마선거구,6470405,4704,경주시,안강읍,계,20699,10240,2697,2494,272,2662,1657,9782,458,10459
4700,경상북도,경주시마선거구,6470405,4704,경주시,안강읍,관내사전투표,4056,4042,989,1012,110,1069,662,3842,200,14
4700,경상북도,경주시마선거구,6470405,4704,경주시,안강읍,선거일투표,16643,6198,1708,1482,162,1593,995,5940,258,10445
4700,경상북도,경주시마선거구,6470405,4704,경주시,강동면,계,5364,2498,1048,622,55,330,291,2346,152,2866
4700,경상북도,경주시마선거구,6470405,4704,경주시,강동면,관내사전투표,1022,1021,427,262,18,124,117,948,73,1
4700,경상북도,경주시마선거구,6470405,4704,경주시,강동면,선거일투표,4342,1477,621,360,37,206,174,1398,79,2865
4700,경상북도,경주시마선거구,6470405,4704,경주시,잘못 투입·구분된 투표지,,0,0,0,0,0,0,0,0,0,0
4700,경상북도,경주시바선거구,6470406,4704,경주시,합계,,24348,11352,2269,4304,4424,10997,355,12996
4700,경상북도,경주시바선거구,6470406,4704,경주시,거소투표,,32,28,4,17,7,28,0,4
4700,경상북도,경주시바선거구,6470406,4704,경주시,관외사전투표,,1652,1652,413,646,549,1608,44,0
4700,경상북도,경주시바선거구,6470406,4704,경주시,천북면,계,5023,2413,299,886,1122,2307,106,2610
4700,경상북도,경주시바선거구,6470406,4704,경주시,천북면,관내사전투표,1078,1078,126,388,515,1029,49,0
4700,경상북도,경주시바선거구,6470406,4704,경주시,천북면,선거일투표,3945,1335,173,498,607,1278,57,2610
4700,경상북도,경주시바선거구,6470406,4704,경주시,용강동,계,17641,7245,1546,2749,2745,7040,205,10396
4700,경상북도,경주시바선거구,6470406,4704,경주시,용강동,관내사전투표,1773,1760,402,607,720,1729,31,13
4700,경상북도,경주시바선거구,6470406,4704,경주시,용강동,선거일투표,15868,5485,1144,2142,2025,5311,174,10383
4700,경상북도,경주시바선거구,6470406,4704,경주시,잘못 투입·구분된 투표지,,0,14,7,6,1,14,0,-14
4700,경상북도,경주시사선거구,6470407,4704,경주시,합계,,31375,17035,2188,3785,3511,2837,4226,16547,488,14340
4700,경상북도,경주시사선거구,6470407,4704,경주시,거소투표,,101,96,18,26,10,7,19,80,16,5
4700,경상북도,경주시사선거구,6470407,4704,경주시,관외사전투표,,1572,1572,329,458,219,165,351,1522,50,0
4700,경상북도,경주시사선거구,6470407,4704,경주시,건천읍,계,8145,4188,362,660,1716,928,413,4079,109,3957
4700,경상북도,경주시사선거구,6470407,4704,경주시,건천읍,관내사전투표,1808,1807,162,260,754,386,196,1758,49,1
4700,경상북도,경주시사선거구,6470407,4704,경주시,건천읍,선거일투표,6337,2381,200,400,962,542,217,2321,60,3956
4700,경상북도,경주시사선거구,6470407,4704,경주시,내남면,계,4131,2199,212,518,400,401,584,2115,84,1932
4700,경상북도,경주시사선거구,6470407,4704,경주시,내남면,관내사전투표,979,977,88,249,185,156,249,927,50,2
4700,경상북도,경주시사선거구,6470407,4704,경주시,내남면,선거일투표,3152,1222,124,269,215,245,335,1188,34,1930
4700,경상북도,경주시사선거구,6470407,4704,경주시,산내면,계,2912,1528,144,393,313,319,291,1460,68,1384
4700,경상북도,경주시사선거구,6470407,4704,경주시,산내면,관내사전투표,798,796,75,204,160,178,138,755,41,2
4700,경상북도,경주시사선거구,6470407,4704,경주시,산내면,선거일투표,2114,732,69,189,153,141,153,705,27,1382
4700,경상북도,경주시사선거구,6470407,4704,경주시,서면,계,2893,1730,214,222,241,656,335,1668,62,1163
4700,경상북도,경주시사선거구,6470407,4704,경주시,서면,관내사전투표,826,824,126,113,112,290,145,786,38,2
4700,경상북도,경주시사선거구,6470407,4704,경주시,서면,선거일투표,2067,906,88,109,129,366,190,882,24,1161
4700,경상북도,경주시사선거구,6470407,4704,경주시,선도동,계,11621,5704,908,1503,608,358,2228,5605,99,5917
4700,경상북도,경주시사선거구,6470407,4704,경주시,선도동,관내사전투표,2467,2456,364,645,239,162,993,2403,53,11
4700,경상북도,경주시사선거구,6470407,4704,경주시,선도동,선거일투표,9154,3248,544,858,369,196,1235,3202,46,5906
4700,경상북도,경주시사선거구,6470407,4704,경주시,잘못 투입·구분된 투표지,,0,18,1,5,4,3,5,18,0,-18
4700,경상북도,경주시아선거구,6470408,4704,경주시,합계,,28608,14148,6327,4665,2649,13641,507,14460
4700,경상북도,경주시아선거구,6470408,4704,경주시,거소투표,,93,86,30,32,17,79,7,7
4700,경상북도,경주시아선거구,6470408,4704,경주시,관외사전투표,,1387,1386,562,453,314,1329,57,1
4700,경상북도,경주시아선거구,6470408,4704,경주시,중부동,계,4364,2013,738,711,492,1941,72,2351
4700,경상북도,경주시아선거구,6470408,4704,경주시,중부동,관내사전투표,767,766,279,266,196,741,25,1
4700,경상북도,경주시아선거구,6470408,4704,경주시,중부동,선거일투표,3597,1247,459,445,296,1200,47,2350
4700,경상북도,경주시아선거구,6470408,4704,경주시,황오동,계,5571,2714,1103,931,582,2616,98,2857
4700,경상북도,경주시아선거구,6470408,4704,경주시,황오동,관내사전투표,1138,1138,469,372,253,1094,44,0
4700,경상북도,경주시아선거구,6470408,4704,경주시,황오동,선거일투표,4433,1576,634,559,329,1522,54,2857
4700,경상북도,경주시아선거구,6470408,4704,경주시,황남동,계,3977,1971,576,1051,266,1893,78,2006
4700,경상북도,경주시아선거구,6470408,4704,경주시,황남동,관내사전투표,1002,995,278,544,128,950,45,7
4700,경상북도,경주시아선거구,6470408,4704,경주시,황남동,선거일투표,2975,976,298,507,138,943,33,1999
4700,경상북도,경주시아선거구,6470408,4704,경주시,월성동,계,4786,2205,881,689,565,2135,70,2581
4700,경상북도,경주시아선거구,6470408,4704,경주시,월성동,관내사전투표,816,810,313,274,195,782,28,6
4700,경상북도,경주시아선거구,6470408,4704,경주시,월성동,선거일투표,3970,1395,568,415,370,1353,42,2575
4700,경상북도,경주시아선거구,6470408,4704,경주시,불국동,계,8430,3749,2429,790,406,3625,124,4681
4700,경상북도,경주시아선거구,6470408,4704,경주시,불국동,관내사전투표,1755,1750,1129,375,181,1685,65,5
4700,경상북도,경주시아선거구,6470408,4704,경주시,불국동,선거일투표,6675,1999,1300,415,225,1940,59,4676
4700,경상북도,경주시아선거구,6470408,4704,경주시,잘못 투입·구분된 투표지,,0,24,8,8,7,23,1,-24
4700,경상북도,김천시가선거구,6470501,4705,김천시,합계,,17036,9135,2031,3637,3067,8735,400,7901
4700,경상북도,김천시가선거구,6470501,4705,김천시,거소투표,,35,30,8,11,10,29,1,5
4700,경상북도,김천시가선거구,6470501,4705,김천시,관외사전투표,,1191,1191,294,447,394,1135,56,0
4700,경상북도,김천시가선거구,6470501,4705,김천시,대곡동,계,15810,7906,1729,3174,2660,7563,343,7904
4700,경상북도,김천시가선거구,6470501,4705,김천시,대곡동,관내사전투표,3695,3690,762,1522,1274,3558,132,5
4700,경상북도,김천시가선거구,6470501,4705,김천시,대곡동,선거일투표,12115,4216,967,1652,1386,4005,211,7899
4700,경상북도,김천시가선거구,6470501,4705,김천시,잘못 투입·구분된 투표지,,0,8,0,5,3,8,0,-8
4700,경상북도,김천시나선거구,6470502,4705,김천시,합계,,14265,9658,1434,2635,2057,740,1404,962,9232,426,4607
4700,경상북도,김천시나선거구,6470502,4705,김천시,거소투표,,76,61,3,13,29,5,4,6,60,1,15
4700,경상북도,김천시나선거구,6470502,4705,김천시,관외사전투표,,1037,1037,195,327,158,85,138,92,995,42,0
4700,경상북도,김천시나선거구,6470502,4705,김천시,봉산면,계,2639,1689,548,138,62,156,658,58,1620,69,950
4700,경상북도,김천시나선거구,6470502,4705,김천시,봉산면,관내사전투표,684,684,221,58,25,75,267,17,663,21,0
4700,경상북도,김천시나선거구,6470502,4705,김천시,봉산면,선거일투표,1955,1005,327,80,37,81,391,41,957,48,950
4700,경상북도,김천시나선거구,6470502,4705,김천시,대항면,계,2972,1755,408,238,105,365,458,97,1671,84,1217
4700,경상북도,김천시나선거구,6470502,4705,김천시,대항면,관내사전투표,659,659,146,88,41,143,173,33,624,35,0
4700,경상북도,김천시나선거구,6470502,4705,김천시,대항면,선거일투표,2313,1096,262,150,64,222,285,64,1047,49,1217
4700,경상북도,김천시나선거구,6470502,4705,김천시,구성면,계,2388,1533,70,1011,229,32,50,80,1472,61,855
4700,경상북도,김천시나선거구,6470502,4705,김천시,구성면,관내사전투표,748,748,29,527,112,19,19,23,729,19,0
4700,경상북도,김천시나선거구,6470502,4705,김천시,구성면,선거일투표,1640,785,41,484,117,13,31,57,743,42,855
4700,경상북도,김천시나선거구,6470502,4705,김천시,지례면,계,1396,1020,48,195,590,32,29,84,978,42,376
4700,경상북도,김천시나선거구,6470502,4705,김천시,지례면,관내사전투표,479,479,25,83,293,14,14,36,465,14,0
4700,경상북도,김천시나선거구,6470502,4705,김천시,지례면,선거일투표,917,541,23,112,297,18,15,48,513,28,376
4700,경상북도,김천시나선거구,6470502,4705,김천시,부항면,계,1050,732,45,202,362,18,27,45,699,33,318
4700,경상북도,김천시나선거구,6470502,4705,김천시,부항면,관내사전투표,495,495,29,146,250,12,18,25,480,15,0
4700,경상북도,김천시나선거구,6470502,4705,김천시,부항면,선거일투표,555,237,16,56,112,6,9,20,219,18,318
4700,경상북도,김천시나선거구,6470502,4705,김천시,대덕면,계,1793,1179,72,292,302,26,15,409,1116,63,614
4700,경상북도,김천시나선거구,6470502,4705,김천시,대덕면,관내사전투표,729,729,39,184,189,11,7,265,695,34,0
4700,경상북도,김천시나선거구,6470502,4705,김천시,대덕면,선거일투표,1064,450,33,108,113,15,8,144,421,29,614
4700,경상북도,김천시나선거구,6470502,4705,김천시,증산면,계,914,652,45,219,220,21,25,91,621,31,262
4700,경상북도,김천시나선거구,6470502,4705,김천시,증산면,관내사전투표,429,429,24,156,135,14,19,59,407,22,0
4700,경상북도,김천시나선거구,6470502,4705,김천시,증산면,선거일투표,485,223,21,63,85,7,6,32,214,9,262
4700,경상북도,김천시나선거구,6470502,4705,김천시,잘못 투입·구분된 투표지,,0,0,0,0,0,0,0,0,0,0,0
4700,경상북도,김천시다선거구,6470503,4705,김천시,합계,,20873,10358,4063,3260,2566,9889,469,10515
4700,경상북도,김천시다선거구,6470503,4705,김천시,거소투표,,78,77,47,19,5,71,6,1
4700,경상북도,김천시다선거구,6470503,4705,김천시,관외사전투표,,1651,1650,560,588,436,1584,66,1
4700,경상북도,김천시다선거구,6470503,4705,김천시,대신동,계,19144,8620,3454,2650,2120,8224,396,10524
4700,경상북도,김천시다선거구,6470503,4705,김천시,대신동,관내사전투표,3018,3014,1201,965,739,2905,109,4
4700,경상북도,김천시다선거구,6470503,4705,김천시,대신동,선거일투표,16126,5606,2253,1685,1381,5319,287,10520
4700,경상북도,김천시다선거구,6470503,4705,김천시,잘못 투입·구분된 투표지,,0,11,2,3,5,10,1,-11
4700,경상북도,김천시라선거구,6470504,4705,김천시,합계,,15296,8302,2171,2132,1734,953,1021,8011,291,6994
4700,경상북도,김천시라선거구,6470504,4705,김천시,거소투표,,21,20,10,4,3,2,0,19,1,1
4700,경상북도,김천시라선거구,6470504,4705,김천시,관외사전투표,,979,977,278,253,212,106,84,933,44,2
4700,경상북도,김천시라선거구,6470504,4705,김천시,자산동,계,5732,3247,591,1182,855,256,246,3130,117,2485
4700,경상북도,김천시라선거구,6470504,4705,김천시,자산동,관내사전투표,1449,1446,262,526,408,99,105,1400,46,3
4700,경상북도,김천시라선거구,6470504,4705,김천시,자산동,선거일투표,4283,1801,329,656,447,157,141,1730,71,2482
4700,경상북도,김천시라선거구,6470504,4705,김천시,지좌동,계,8564,4047,1292,688,663,586,689,3918,129,4517
4700,경상북도,김천시라선거구,6470504,4705,김천시,지좌동,관내사전투표,1877,1871,633,298,306,238,345,1820,51,6
4700,경상북도,김천시라선거구,6470504,4705,김천시,지좌동,선거일투표,6687,2176,659,390,357,348,344,2098,78,4511
4700,경상북도,김천시라선거구,6470504,4705,김천시,잘못 투입·구분된 투표지,,0,11,0,5,1,3,2,11,0,-11
4700,경상북도,김천시마선거구,6470505,4705,김천시,합계,,14273,8579,2819,2892,1342,1036,8089,490,5694
4700,경상북도,김천시마선거구,6470505,4705,김천시,거소투표,,36,33,9,8,7,6,30,3,3
4700,경상북도,김천시마선거구,6470505,4705,김천시,관외사전투표,,849,847,320,262,131,93,806,41,2
4700,경상북도,김천시마선거구,6470505,4705,김천시,감천면,계,1745,1175,339,337,93,336,1105,70,570
4700,경상북도,김천시마선거구,6470505,4705,김천시,감천면,관내사전투표,655,653,194,204,54,167,619,34,2
4700,경상북도,김천시마선거구,6470505,4705,김천시,감천면,선거일투표,1090,522,145,133,39,169,486,36,568
4700,경상북도,김천시마선거구,6470505,4705,김천시,조마면,계,1855,1130,158,716,70,118,1062,68,725
4700,경상북도,김천시마선거구,6470505,4705,김천시,조마면,관내사전투표,596,595,59,424,25,60,568,27,1
4700,경상북도,김천시마선거구,6470505,4705,김천시,조마면,선거일투표,1259,535,99,292,45,58,494,41,724
4700,경상북도,김천시마선거구,6470505,4705,김천시,평화남산동,계,6430,3285,1392,842,651,226,3111,174,3145
4700,경상북도,김천시마선거구,6470505,4705,김천시,평화남산동,관내사전투표,1288,1282,569,292,261,93,1215,67,6
4700,경상북도,김천시마선거구,6470505,4705,김천시,평화남산동,선거일투표,5142,2003,823,550,390,133,1896,107,3139
4700,경상북도,김천시마선거구,6470505,4705,김천시,양금동,계,3358,2092,594,722,387,257,1960,132,1266
4700,경상북도,김천시마선거구,6470505,4705,김천시,양금동,관내사전투표,913,913,246,332,158,132,868,45,0
4700,경상북도,김천시마선거구,6470505,4705,김천시,양금동,선거일투표,2445,1179,348,390,229,125,1092,87,1266
4700,경상북도,김천시마선거구,6470505,4705,김천시,잘못 투입·구분된 투표지,,0,17,7,5,3,0,15,2,-17
4700,경상북도,김천시바선거구,6470506,4705,김천시,합계,,16633,8072,2317,1790,2319,988,442,7856,216,8561
4700,경상북도,김천시바선거구,6470506,4705,김천시,거소투표,,13,13,6,2,1,0,1,10,3,0
4700,경상북도,김천시바선거구,6470506,4705,김천시,관외사전투표,,1348,1346,408,342,347,125,75,1297,49,2
4700,경상북도,김천시바선거구,6470506,4705,김천시,율곡동,계,15272,6700,1900,1442,1967,862,365,6536,164,8572
4700,경상북도,김천시바선거구,6470506,4705,김천시,율곡동,관내사전투표,2933,2925,867,636,833,381,160,2877,48,8
4700,경상북도,김천시바선거구,6470506,4705,김천시,율곡동,선거일투표,12339,3775,1033,806,1134,481,205,3659,116,8564
4700,경상북도,김천시바선거구,6470506,4705,김천시,잘못 투입·구분된 투표지,,0,13,3,4,4,1,1,13,0,-13
4700,경상북도,김천시사선거구,6470507,4705,김천시,합계,,22095,13172,1017,4641,1430,2478,495,1825,694,12580,592,8923
4700,경상북도,김천시사선거구,6470507,4705,김천시,거소투표,,164,163,24,48,20,14,8,17,8,139,24,1
4700,경상북도,김천시사선거구,6470507,4705,김천시,관외사전투표,,1300,1299,206,508,125,199,49,97,59,1243,56,1
4700,경상북도,김천시사선거구,6470507,4705,김천시,아포읍,계,6807,3388,261,2335,185,220,85,113,70,3269,119,3419
4700,경상북도,김천시사선거구,6470507,4705,김천시,아포읍,관내사전투표,1603,1603,145,1126,73,94,38,39,24,1539,64,0
4700,경상북도,김천시사선거구,6470507,4705,김천시,아포읍,선거일투표,5204,1785,116,1209,112,126,47,74,46,1730,55,3419
4700,경상북도,김천시사선거구,6470507,4705,김천시,농소면,계,2633,1565,165,402,164,211,43,160,336,1481,84,1068
4700,경상북도,김천시사선거구,6470507,4705,김천시,농소면,관내사전투표,664,664,70,180,69,87,17,74,130,627,37,0
4700,경상북도,김천시사선거구,6470507,4705,김천시,농소면,선거일투표,1969,901,95,222,95,124,26,86,206,854,47,1068
4700,경상북도,김천시사선거구,6470507,4705,김천시,남면,계,2682,1442,92,380,182,348,32,188,164,1386,56,1240
4700,경상북도,김천시사선거구,6470507,4705,김천시,남면,관내사전투표,601,601,37,146,86,168,19,57,67,580,21,0
4700,경상북도,김천시사선거구,6470507,4705,김천시,남면,선거일투표,2081,841,55,234,96,180,13,131,97,806,35,1240
4700,경상북도,김천시사선거구,6470507,4705,김천시,개령면,계,2167,1320,68,244,426,178,64,263,18,1261,59,847
4700,경상북도,김천시사선거구,6470507,4705,김천시,개령면,관내사전투표,622,622,37,108,202,78,33,124,6,588,34,0
4700,경상북도,김천시사선거구,6470507,4705,김천시,개령면,선거일투표,1545,698,31,136,224,100,31,139,12,673,25,847
4700,경상북도,김천시사선거구,6470507,4705,김천시,감문면,계,2882,1954,76,291,201,984,27,253,12,1844,110,928
4700,경상북도,김천시사선거구,6470507,4705,김천시,감문면,관내사전투표,892,891,27,134,85,481,16,84,3,830,61,1
4700,경상북도,김천시사선거구,6470507,4705,김천시,감문면,선거일투표,1990,1063,49,157,116,503,11,169,9,1014,49,927
4700,경상북도,김천시사선거구,6470507,4705,김천시,어모면,계,3460,2041,125,433,127,324,187,734,27,1957,84,1419
4700,경상북도,김천시사선거구,6470507,4705,김천시,어모면,관내사전투표,827,827,46,192,55,106,86,298,10,793,34,0
4700,경상북도,김천시사선거구,6470507,4705,김천시,어모면,선거일투표,2633,1214,79,241,72,218,101,436,17,1164,50,1419
4700,경상북도,김천시사선거구,6470507,4705,김천시,잘못 투입·구분된 투표지,,0,0,0,0,0,0,0,0,0,0,0,0
4700,경상북도,안동시가선거구,6470601,4706,안동시,합계,,19418,10360,2034,3743,2011,1908,9696,664,9058
4700,경상북도,안동시가선거구,6470601,4706,안동시,거소투표,,96,80,19,26,10,8,63,17,16
4700,경상북도,안동시가선거구,6470601,4706,안동시,관외사전투표,,1378,1378,402,499,286,162,1349,29,0
4700,경상북도,안동시가선거구,6470601,4706,안동시,북후면,계,2660,1542,101,474,139,633,1347,195,1118
4700,경상북도,안동시가선거구,6470601,4706,안동시,북후면,관내사전투표,670,669,56,227,65,221,569,100,1
4700,경상북도,안동시가선거구,6470601,4706,안동시,북후면,선거일투표,1990,873,45,247,74,412,778,95,1117
4700,경상북도,안동시가선거구,6470601,4706,안동시,서후면,계,3089,1542,169,588,262,365,1384,158,1547
4700,경상북도,안동시가선거구,6470601,4706,안동시,서후면,관내사전투표,517,516,79,198,89,102,468,48,1
4700,경상북도,안동시가선거구,6470601,4706,안동시,서후면,선거일투표,2572,1026,90,390,173,263,916,110,1546
4700,경상북도,안동시가선거구,6470601,4706,안동시,송하동,계,12195,5802,1340,2151,1312,736,5539,263,6393
4700,경상북도,안동시가선거구,6470601,4706,안동시,송하동,관내사전투표,2128,2118,499,759,524,281,2063,55,10
4700,경상북도,안동시가선거구,6470601,4706,안동시,송하동,선거일투표,10067,3684,841,1392,788,455,3476,208,6383
4700,경상북도,안동시가선거구,6470601,4706,안동시,잘못 투입·구분된 투표지,,0,16,3,5,2,4,14,2,-16
4700,경상북도,안동시나선거구,6470602,4706,안동시,합계,,17283,8669,2100,3200,1455,1466,8221,448,8614
4700,경상북도,안동시나선거구,6470602,4706,안동시,거소투표,,92,87,8,51,20,5,84,3,5
4700,경상북도,안동시나선거구,6470602,4706,안동시,관외사전투표,,1403,1402,414,517,218,211,1360,42,1
4700,경상북도,안동시나선거구,6470602,4706,안동시,옥동,계,15788,7167,1677,2626,1216,1248,6767,400,8621
4700,경상북도,안동시나선거구,6470602,4706,안동시,옥동,관내사전투표,2109,2106,536,798,357,354,2045,61,3
4700,경상북도,안동시나선거구,6470602,4706,안동시,옥동,선거일투표,13679,5061,1141,1828,859,894,4722,339,8618
4700,경상북도,안동시나선거구,6470602,4706,안동시,잘못 투입·구분된 투표지,,0,13,1,6,1,2,10,3,-13
4700,경상북도,안동시다선거구,6470603,4706,안동시,합계,,16371,9140,1428,4743,1284,1079,8534,606,7231
4700,경상북도,안동시다선거구,6470603,4706,안동시,거소투표,,30,28,4,15,3,2,24,4,2
4700,경상북도,안동시다선거구,6470603,4706,안동시,관외사전투표,,1253,1251,351,552,198,117,1218,33,2
4700,경상북도,안동시다선거구,6470603,4706,안동시,풍산읍,계,5724,3053,270,1652,230,613,2765,288,2671
4700,경상북도,안동시다선거구,6470603,4706,안동시,풍산읍,관내사전투표,1096,1095,118,602,91,221,1032,63,1
4700,경상북도,안동시다선거구,6470603,4706,안동시,풍산읍,선거일투표,4628,1958,152,1050,139,392,1733,225,2670
4700,경상북도,안동시다선거구,6470603,4706,안동시,풍천면,계,5501,2556,646,946,648,166,2406,150,2945
4700,경상북도,안동시다선거구,6470603,4706,안동시,풍천면,관내사전투표,748,742,162,273,232,37,704,38,6
4700,경상북도,안동시다선거구,6470603,4706,안동시,풍천면,선거일투표,4753,1814,484,673,416,129,1702,112,2939
4700,경상북도,안동시다선거구,6470603,4706,안동시,일직면,계,2380,1342,93,968,126,97,1284,58,1038
4700,경상북도,안동시다선거구,6470603,4706,안동시,일직면,관내사전투표,739,737,42,537,75,50,704,33,2
4700,경상북도,안동시다선거구,6470603,4706,안동시,일직면,선거일투표,1641,605,51,431,51,47,580,25,1036
4700,경상북도,안동시다선거구,6470603,4706,안동시,남후면,계,1483,898,63,603,78,82,826,72,585
4700,경상북도,안동시다선거구,6470603,4706,안동시,남후면,관내사전투표,399,397,31,293,31,26,381,16,2
4700,경상북도,안동시다선거구,6470603,4706,안동시,남후면,선거일투표,1084,501,32,310,47,56,445,56,583
4700,경상북도,안동시다선거구,6470603,4706,안동시,잘못 투입·구분된 투표지,,0,12,1,7,1,2,11,1,-12
4700,경상북도,안동시라선거구,6470604,4706,안동시,합계,,12804,8037,1734,3259,2673,7666,371,4767
4700,경상북도,안동시라선거구,6470604,4706,안동시,거소투표,,29,25,3,13,9,25,0,4
4700,경상북도,안동시라선거구,6470604,4706,안동시,관외사전투표,,775,775,184,273,283,740,35,0
4700,경상북도,안동시라선거구,6470604,4706,안동시,와룡면,계,3505,1957,385,822,651,1858,99,1548
4700,경상북도,안동시라선거구,6470604,4706,안동시,와룡면,관내사전투표,892,892,163,356,314,833,59,0
4700,경상북도,안동시라선거구,6470604,4706,안동시,와룡면,선거일투표,2613,1065,222,466,337,1025,40,1548
4700,경상북도,안동시라선거구,6470604,4706,안동시,길안면,계,2443,1498,632,511,262,1405,93,945
4700,경상북도,안동시라선거구,6470604,4706,안동시,길안면,관내사전투표,513,513,224,163,101,488,25,0
4700,경상북도,안동시라선거구,6470604,4706,안동시,길안면,선거일투표,1930,985,408,348,161,917,68,945
4700,경상북도,안동시라선거구,6470604,4706,안동시,임동면,계,1495,960,130,604,191,925,35,535
4700,경상북도,안동시라선거구,6470604,4706,안동시,임동면,관내사전투표,521,520,62,344,87,493,27,1
4700,경상북도,안동시라선거구,6470604,4706,안동시,임동면,선거일투표,974,440,68,260,104,432,8,534
4700,경상북도,안동시라선거구,6470604,4706,안동시,예안면,계,1634,1009,125,304,538,967,42,625
4700,경상북도,안동시라선거구,6470604,4706,안동시,예안면,관내사전투표,400,400,37,129,210,376,24,0
4700,경상북도,안동시라선거구,6470604,4706,안동시,예안면,선거일투표,1234,609,88,175,328,591,18,625
4700,경상북도,안동시라선거구,6470604,4706,안동시,도산면,계,1392,875,98,405,341,844,31,517
4700,경상북도,안동시라선거구,6470604,4706,안동시,도산면,관내사전투표,302,302,29,141,120,290,12,0
4700,경상북도,안동시라선거구,6470604,4706,안동시,도산면,선거일투표,1090,573,69,264,221,554,19,517
4700,경상북도,안동시라선거구,6470604,4706,안동시,녹전면,계,1531,935,177,326,397,900,35,596
4700,경상북도,안동시라선거구,6470604,4706,안동시,녹전면,관내사전투표,238,238,45,78,102,225,13,0
4700,경상북도,안동시라선거구,6470604,4706,안동시,녹전면,선거일투표,1293,697,132,248,295,675,22,596
4700,경상북도,안동시라선거구,6470604,4706,안동시,잘못 투입·구분된 투표지,,0,3,0,1,1,2,1,-3
4700,경상북도,안동시마선거구,6470605,4706,안동시,합계,,12841,7726,879,1839,822,1346,916,1675,7477,249,5115
4700,경상북도,안동시마선거구,6470605,4706,안동시,거소투표,,133,101,24,22,9,6,8,9,78,23,32
4700,경상북도,안동시마선거구,6470605,4706,안동시,관외사전투표,,960,960,182,271,76,160,87,158,934,26,0
4700,경상북도,안동시마선거구,6470605,4706,안동시,남선면,계,1784,1122,97,317,176,84,182,241,1097,25,662
4700,경상북도,안동시마선거구,6470605,4706,안동시,남선면,관내사전투표,279,279,31,71,43,17,49,60,271,8,0
4700,경상북도,안동시마선거구,6470605,4706,안동시,남선면,선거일투표,1505,843,66,246,133,67,133,181,826,17,662
4700,경상북도,안동시마선거구,6470605,4706,안동시,임하면,계,2366,1413,105,584,138,52,184,287,1350,63,953
4700,경상북도,안동시마선거구,6470605,4706,안동시,임하면,관내사전투표,714,714,64,292,65,28,88,143,680,34,0
4700,경상북도,안동시마선거구,6470605,4706,안동시,임하면,선거일투표,1652,699,41,292,73,24,96,144,670,29,953
4700,경상북도,안동시마선거구,6470605,4706,안동시,강남동,계,7598,4130,471,645,423,1044,455,980,4018,112,3468
4700,경상북도,안동시마선거구,6470605,4706,안동시,강남동,관내사전투표,1554,1554,198,216,145,444,176,336,1515,39,0
4700,경상북도,안동시마선거구,6470605,4706,안동시,강남동,선거일투표,6044,2576,273,429,278,600,279,644,2503,73,3468
4700,경상북도,안동시마선거구,6470605,4706,안동시,잘못 투입·구분된 투표지,,0,0,0,0,0,0,0,0,0,0,0
4700,경상북도,안동시바선거구,6470606,4706,안동시,합계,,18420,9420,2952,2976,3100,9028,392,9000
4700,경상북도,안동시바선거구,6470606,4706,안동시,거소투표,,28,26,12,7,5,24,2,2
4700,경상북도,안동시바선거구,6470606,4706,안동시,관외사전투표,,1226,1226,406,332,431,1169,57,0
4700,경상북도,안동시바선거구,6470606,4706,안동시,용상동,계,17166,8167,2534,2636,2664,7834,333,8999
4700,경상북도,안동시바선거구,6470606,4706,안동시,용상동,관내사전투표,3029,3024,917,1020,934,2871,153,5
4700,경상북도,안동시바선거구,6470606,4706,안동시,용상동,선거일투표,14137,5143,1617,1616,1730,4963,180,8994
4700,경상북도,안동시바선거구,6470606,4706,안동시,잘못 투입·구분된 투표지,,0,1,0,1,0,1,0,-1
4700,경상북도,안동시사선거구,6470607,4706,안동시,합계,,22220,12138,3395,4112,3925,11432,706,10082
4700,경상북도,안동시사선거구,6470607,4706,안동시,거소투표,,57,53,20,22,11,53,0,4
4700,경상북도,안동시사선거구,6470607,4706,안동시,관외사전투표,,1649,1649,545,529,500,1574,75,0
4700,경상북도,안동시사선거구,6470607,4706,안동시,태화동,계,10174,4763,1147,1684,1694,4525,238,5411
4700,경상북도,안동시사선거구,6470607,4706,안동시,태화동,관내사전투표,1555,1555,372,542,588,1502,53,0
4700,경상북도,안동시사선거구,6470607,4706,안동시,태화동,선거일투표,8619,3208,775,1142,1106,3023,185,5411
4700,경상북도,안동시사선거구,6470607,4706,안동시,평화동,계,5158,2766,776,972,829,2577,189,2392
4700,경상북도,안동시사선거구,6470607,4706,안동시,평화동,관내사전투표,970,969,267,354,315,936,33,1
4700,경상북도,안동시사선거구,6470607,4706,안동시,평화동,선거일투표,4188,1797,509,618,514,1641,156,2391
4700,경상북도,안동시사선거구,6470607,4706,안동시,안기동,계,5182,2896,903,904,887,2694,202,2286
4700,경상북도,안동시사선거구,6470607,4706,안동시,안기동,관내사전투표,1100,1099,345,364,343,1052,47,1
4700,경상북도,안동시사선거구,6470607,4706,안동시,안기동,선거일투표,4082,1797,558,540,544,1642,155,2285
4700,경상북도,안동시사선거구,6470607,4706,안동시,잘못 투입·구분된 투표지,,0,11,4,1,4,9,2,-11
4700,경상북도,안동시아선거구,6470608,4706,안동시,합계,,16505,9043,1841,3882,2860,8583,460,7462
4700,경상북도,안동시아선거구,6470608,4706,안동시,거소투표,,29,27,7,9,8,24,3,2
4700,경상북도,안동시아선거구,6470608,4706,안동시,관외사전투표,,927,927,306,390,200,896,31,0
4700,경상북도,안동시아선거구,6470608,4706,안동시,중구동,계,4362,2216,415,932,738,2085,131,2146
4700,경상북도,안동시아선거구,6470608,4706,안동시,중구동,관내사전투표,800,794,168,322,262,752,42,6
4700,경상북도,안동시아선거구,6470608,4706,안동시,중구동,선거일투표,3562,1422,247,610,476,1333,89,2140
4700,경상북도,안동시아선거구,6470608,4706,안동시,명륜동,계,4140,2202,385,847,842,2074,128,1938
4700,경상북도,안동시아선거구,6470608,4706,안동시,명륜동,관내사전투표,1016,1015,187,399,385,971,44,1
4700,경상북도,안동시아선거구,6470608,4706,안동시,명륜동,선거일투표,3124,1187,198,448,457,1103,84,1937
4700,경상북도,안동시아선거구,6470608,4706,안동시,서구동,계,7047,3664,727,1701,1069,3497,167,3383
4700,경상북도,안동시아선거구,6470608,4706,안동시,서구동,관내사전투표,938,938,264,377,267,908,30,0
4700,경상북도,안동시아선거구,6470608,4706,안동시,서구동,선거일투표,6109,2726,463,1324,802,2589,137,3383
4700,경상북도,안동시아선거구,6470608,4706,안동시,잘못 투입·구분된 투표지,,0,7,1,3,3,7,0,-7
4700,경상북도,구미시가선거구,6470701,4707,구미시,합계,,52463,24694,4324,7956,3085,5565,899,266,81,1748,23924,770,27769
4700,경상북도,구미시가선거구,6470701,4707,구미시,거소투표,,74,68,12,30,4,7,1,0,2,3,59,9,6
4700,경상북도,구미시가선거구,6470701,4707,구미시,관외사전투표,,2181,2181,571,736,202,389,65,18,12,111,2104,77,0
4700,경상북도,구미시가선거구,6470701,4707,구미시,송정동,계,18859,8275,1473,3002,810,1508,267,85,26,852,8023,252,10584
4700,경상북도,구미시가선거구,6470701,4707,구미시,송정동,관내사전투표,2626,2626,512,917,227,495,82,29,9,276,2547,79,0
4700,경상북도,구미시가선거구,6470701,4707,구미시,송정동,선거일투표,16233,5649,961,2085,583,1013,185,56,17,576,5476,173,10584
4700,경상북도,구미시가선거구,6470701,4707,구미시,원평동,계,5928,2385,306,1158,231,376,49,22,11,121,2274,111,3543
4700,경상북도,구미시가선거구,6470701,4707,구미시,원평동,관내사전투표,820,820,127,374,76,141,13,7,3,44,785,35,0
4700,경상북도,구미시가선거구,6470701,4707,구미시,원평동,선거일투표,5108,1565,179,784,155,235,36,15,8,77,1489,76,3543
4700,경상북도,구미시가선거구,6470701,4707,구미시,형곡1동,계,11806,5842,998,1418,777,1784,318,62,12,323,5692,150,5964
4700,경상북도,구미시가선거구,6470701,4707,구미시,형곡1동,관내사전투표,2614,2613,466,644,322,794,137,18,6,159,2546,67,1
4700,경상북도,구미시가선거구,6470701,4707,구미시,형곡1동,선거일투표,9192,3229,532,774,455,990,181,44,6,164,3146,83,5963
4700,경상북도,구미시가선거구,6470701,4707,구미시,형곡2동,계,13615,5941,964,1611,1061,1500,199,79,18,338,5770,171,7674
4700,경상북도,구미시가선거구,6470701,4707,구미시,형곡2동,관내사전투표,2024,2024,372,521,354,504,66,24,10,104,1955,69,0
4700,경상북도,구미시가선거구,6470701,4707,구미시,형곡2동,선거일투표,11591,3917,592,1090,707,996,133,55,8,234,3815,102,7674
4700,경상북도,구미시가선거구,6470701,4707,구미시,잘못 투입·구분된 투표지,,0,2,0,1,0,1,0,0,0,0,2,0,-2
4700,경상북도,구미시나선거구,6470702,4707,구미시,합계,,31322,13740,2976,6193,3757,261,13187,553,17582
4700,경상북도,구미시나선거구,6470702,4707,구미시,거소투표,,27,27,6,13,5,0,24,3,0
4700,경상북도,구미시나선거구,6470702,4707,구미시,관외사전투표,,2035,1982,531,945,393,68,1937,45,53
4700,경상북도,구미시나선거구,6470702,4707,구미시,선주원남동,계,29260,11671,2424,5206,3347,191,11168,503,17589
4700,경상북도,구미시나선거구,6470702,4707,구미시,선주원남동,관내사전투표,3100,3099,765,1230,1003,40,3038,61,1
4700,경상북도,구미시나선거구,6470702,4707,구미시,선주원남동,선거일투표,26160,8572,1659,3976,2344,151,8130,442,17588
4700,경상북도,구미시나선거구,6470702,4707,구미시,잘못 투입·구분된 투표지,,0,60,15,29,12,2,58,2,-60
4700,경상북도,구미시다선거구,6470703,4707,구미시,합계,,24117,11312,2361,4151,4210,10722,590,12805
4700,경상북도,구미시다선거구,6470703,4707,구미시,거소투표,,43,42,5,22,11,38,4,1
4700,경상북도,구미시다선거구,6470703,4707,구미시,관외사전투표,,1525,1524,438,600,440,1478,46,1
4700,경상북도,구미시다선거구,6470703,4707,구미시,도량동,계,22549,9725,1915,3523,3752,9190,535,12824
4700,경상북도,구미시다선거구,6470703,4707,구미시,도량동,관내사전투표,2316,2307,476,840,940,2256,51,9
4700,경상북도,구미시다선거구,6470703,4707,구미시,도량동,선거일투표,20233,7418,1439,2683,2812,6934,484,12815
4700,경상북도,구미시다선거구,6470703,4707,구미시,잘못 투입·구분된 투표지,,0,21,3,6,7,16,5,-21
4700,경상북도,구미시라선거구,6470704,4707,구미시,합계,,25610,11343,2129,5945,2218,562,10854,489,14267
4700,경상북도,구미시라선거구,6470704,4707,구미시,거소투표,,21,20,3,10,4,2,19,1,1
4700,경상북도,구미시라선거구,6470704,4707,구미시,관외사전투표,,860,858,221,436,138,36,831,27,2
4700,경상북도,구미시라선거구,6470704,4707,구미시,지산동,계,1905,1009,90,661,191,29,971,38,896
4700,경상북도,구미시라선거구,6470704,4707,구미시,지산동,관내사전투표,335,331,27,215,70,9,321,10,4
4700,경상북도,구미시라선거구,6470704,4707,구미시,지산동,선거일투표,1570,678,63,446,121,20,650,28,892
4700,경상북도,구미시라선거구,6470704,4707,구미시,신평1동,계,3232,1569,269,742,353,110,1474,95,1663
4700,경상북도,구미시라선거구,6470704,4707,구미시,신평1동,관내사전투표,702,702,144,331,155,48,678,24,0
4700,경상북도,구미시라선거구,6470704,4707,구미시,신평1동,선거일투표,2530,867,125,411,198,62,796,71,1663
4700,경상북도,구미시라선거구,6470704,4707,구미시,신평2동,계,2470,1140,179,552,213,134,1078,62,1330
4700,경상북도,구미시라선거구,6470704,4707,구미시,신평2동,관내사전투표,391,391,72,183,69,54,378,13,0
4700,경상북도,구미시라선거구,6470704,4707,구미시,신평2동,선거일투표,2079,749,107,369,144,80,700,49,1330
4700,경상북도,구미시라선거구,6470704,4707,구미시,비산동,계,10023,3901,777,2035,778,154,3744,157,6122
4700,경상북도,구미시라선거구,6470704,4707,구미시,비산동,관내사전투표,1523,1523,318,804,299,70,1491,32,0
4700,경상북도,구미시라선거구,6470704,4707,구미시,비산동,선거일투표,8500,2378,459,1231,479,84,2253,125,6122
4700,경상북도,구미시라선거구,6470704,4707,구미시,공단동,계,3511,1301,284,689,241,43,1257,44,2210
4700,경상북도,구미시라선거구,6470704,4707,구미시,공단동,관내사전투표,550,549,136,271,103,26,536,13,1
4700,경상북도,구미시라선거구,6470704,4707,구미시,공단동,선거일투표,2961,752,148,418,138,17,721,31,2209
4700,경상북도,구미시라선거구,6470704,4707,구미시,광평동,계,3588,1527,303,812,296,54,1465,62,2061
4700,경상북도,구미시라선거구,6470704,4707,구미시,광평동,관내사전투표,611,607,117,333,118,19,587,20,4
4700,경상북도,구미시라선거구,6470704,4707,구미시,광평동,선거일투표,2977,920,186,479,178,35,878,42,2057
4700,경상북도,구미시라선거구,6470704,4707,구미시,잘못 투입·구분된 투표지,,0,18,3,8,4,0,15,3,-18
4700,경상북도,구미시마선거구,6470705,4707,구미시,합계,,40125,16217,3347,5976,4488,2064,15875,342,23908
4700,경상북도,구미시마선거구,6470705,4707,구미시,거소투표,,55,53,18,22,7,3,50,3,2
4700,경상북도,구미시마선거구,6470705,4707,구미시,관외사전투표,,1709,1708,469,670,342,172,1653,55,1
4700,경상북도,구미시마선거구,6470705,4707,구미시,상모사곡동,계,24486,9488,1925,3304,2577,1484,9290,198,14998
4700,경상북도,구미시마선거구,6470705,4707,구미시,상모사곡동,관내사전투표,2752,2752,621,910,766,383,2680,72,0
4700,경상북도,구미시마선거구,6470705,4707,구미시,상모사곡동,선거일투표,21734,6736,1304,2394,1811,1101,6610,126,14998
4700,경상북도,구미시마선거구,6470705,4707,구미시,임오동,계,13875,4958,932,1977,1559,404,4872,86,8917
4700,경상북도,구미시마선거구,6470705,4707,구미시,임오동,관내사전투표,1175,1172,236,440,386,85,1147,25,3
4700,경상북도,구미시마선거구,6470705,4707,구미시,임오동,선거일투표,12700,3786,696,1537,1173,319,3725,61,8914
4700,경상북도,구미시마선거구,6470705,4707,구미시,잘못 투입·구분된 투표지,,0,10,3,3,3,1,10,0,-10
4700,경상북도,구미시바선거구,6470706,4707,구미시,합계,,18226,10282,1346,3153,4742,300,9541,741,7944
4700,경상북도,구미시바선거구,6470706,4707,구미시,거소투표,,85,82,21,18,21,3,63,19,3
4700,경상북도,구미시바선거구,6470706,4707,구미시,관외사전투표,,745,745,154,240,286,34,714,31,0
4700,경상북도,구미시바선거구,6470706,4707,구미시,선산읍,계,12325,6448,903,1960,2879,222,5964,484,5877
4700,경상북도,구미시바선거구,6470706,4707,구미시,선산읍,관내사전투표,2495,2494,386,763,1165,56,2370,124,1
4700,경상북도,구미시바선거구,6470706,4707,구미시,선산읍,선거일투표,9830,3954,517,1197,1714,166,3594,360,5876
4700,경상북도,구미시바선거구,6470706,4707,구미시,무을면,계,1639,993,85,308,521,8,922,71,646
4700,경상북도,구미시바선거구,6470706,4707,구미시,무을면,관내사전투표,366,365,29,122,189,3,343,22,1
4700,경상북도,구미시바선거구,6470706,4707,구미시,무을면,선거일투표,1273,628,56,186,332,5,579,49,645
4700,경상북도,구미시바선거구,6470706,4707,구미시,옥성면,계,1480,886,104,225,462,16,807,79,594
4700,경상북도,구미시바선거구,6470706,4707,구미시,옥성면,관내사전투표,390,388,49,89,200,15,353,35,2
4700,경상북도,구미시바선거구,6470706,4707,구미시,옥성면,선거일투표,1090,498,55,136,262,1,454,44,592
4700,경상북도,구미시바선거구,6470706,4707,구미시,도개면,계,1952,1120,78,401,568,17,1064,56,832
4700,경상북도,구미시바선거구,6470706,4707,구미시,도개면,관내사전투표,455,454,36,143,249,7,435,19,1
4700,경상북도,구미시바선거구,6470706,4707,구미시,도개면,선거일투표,1497,666,42,258,319,10,629,37,831
4700,경상북도,구미시바선거구,6470706,4707,구미시,잘못 투입·구분된 투표지,,0,8,1,1,5,0,7,1,-8
4700,경상북도,구미시사선거구,6470707,4707,구미시,합계,,31960,16204,2630,5907,7056,15593,611,15756
4700,경상북도,구미시사선거구,6470707,4707,구미시,거소투표,,38,34,4,11,17,32,2,4
4700,경상북도,구미시사선거구,6470707,4707,구미시,관외사전투표,,3618,3613,774,1343,1411,3528,85,5
4700,경상북도,구미시사선거구,6470707,4707,구미시,고아읍,계,28304,12545,1850,4550,5622,12022,523,15759
4700,경상북도,구미시사선거구,6470707,4707,구미시,고아읍,관내사전투표,1920,1918,262,703,873,1838,80,2
4700,경상북도,구미시사선거구,6470707,4707,구미시,고아읍,선거일투표,26384,10627,1588,3847,4749,10184,443,15757
4700,경상북도,구미시사선거구,6470707,4707,구미시,잘못 투입·구분된 투표지,,0,12,2,3,6,11,1,-12
4700,경상북도,구미시아선거구,6470708,4707,구미시,합계,,25732,11062,2702,5058,2255,512,158,10685,377,14670
4700,경상북도,구미시아선거구,6470708,4707,구미시,거소투표,,33,32,8,11,7,3,1,30,2,1
4700,경상북도,구미시아선거구,6470708,4707,구미시,관외사전투표,,1309,1309,374,655,189,39,23,1280,29,0
4700,경상북도,구미시아선거구,6470708,4707,구미시,산동읍,계,18010,6109,2022,2354,1335,129,102,5942,167,11901
4700,경상북도,구미시아선거구,6470708,4707,구미시,산동읍,관내사전투표,954,949,320,377,191,21,15,924,25,5
4700,경상북도,구미시아선거구,6470708,4707,구미시,산동읍,선거일투표,17056,5160,1702,1977,1144,108,87,5018,142,11896
4700,경상북도,구미시아선거구,6470708,4707,구미시,해평면,계,3596,1983,137,1157,276,308,14,1892,91,1613
4700,경상북도,구미시아선거구,6470708,4707,구미시,해평면,관내사전투표,729,729,66,416,107,103,10,702,27,0
4700,경상북도,구미시아선거구,6470708,4707,구미시,해평면,선거일투표,2867,1254,71,741,169,205,4,1190,64,1613
4700,경상북도,구미시아선거구,6470708,4707,구미시,장천면,계,2784,1621,158,877,448,32,18,1533,88,1163
4700,경상북도,구미시아선거구,6470708,4707,구미시,장천면,관내사전투표,675,674,96,365,161,14,7,643,31,1
4700,경상북도,구미시아선거구,6470708,4707,구미시,장천면,선거일투표,2109,947,62,512,287,18,11,890,57,1162
4700,경상북도,구미시아선거구,6470708,4707,구미시,잘못 투입·구분된 투표지,,0,8,3,4,0,1,0,8,0,-8
4700,경상북도,구미시자선거구,6470709,4707,구미시,합계,,53817,17022,4000,6264,4743,1236,16243,779,36795
4700,경상북도,구미시자선거구,6470709,4707,구미시,거소투표,,66,62,15,24,10,7,56,6,4
4700,경상북도,구미시자선거구,6470709,4707,구미시,관외사전투표,,1583,1582,494,542,380,104,1520,62,1
4700,경상북도,구미시자선거구,6470709,4707,구미시,인동동,계,37065,11844,2619,4456,3359,865,11299,545,25221
4700,경상북도,구미시자선거구,6470709,4707,구미시,인동동,관내사전투표,2861,2858,738,1013,863,179,2793,65,3
4700,경상북도,구미시자선거구,6470709,4707,구미시,인동동,선거일투표,34204,8986,1881,3443,2496,686,8506,480,25218
4700,경상북도,구미시자선거구,6470709,4707,구미시,진미동,계,15103,3517,869,1236,990,257,3352,165,11586
4700,경상북도,구미시자선거구,6470709,4707,구미시,진미동,관내사전투표,1451,1449,416,446,404,118,1384,65,2
4700,경상북도,구미시자선거구,6470709,4707,구미시,진미동,선거일투표,13652,2068,453,790,586,139,1968,100,11584
4700,경상북도,구미시자선거구,6470709,4707,구미시,잘못 투입·구분된 투표지,,0,17,3,6,4,3,16,1,-17
4700,경상북도,구미시차선거구,6470710,4707,구미시,합계,,34138,12691,3895,5009,2420,848,12172,519,21447
4700,경상북도,구미시차선거구,6470710,4707,구미시,거소투표,,28,25,5,14,4,1,24,1,3
4700,경상북도,구미시차선거구,6470710,4707,구미시,관외사전투표,,1527,1526,521,585,275,87,1468,58,1
4700,경상북도,구미시차선거구,6470710,4707,구미시,양포동,계,32583,11129,3365,4405,2140,759,10669,460,21454
4700,경상북도,구미시차선거구,6470710,4707,구미시,양포동,관내사전투표,2630,2627,966,933,490,180,2569,58,3
4700,경상북도,구미시차선거구,6470710,4707,구미시,양포동,선거일투표,29953,8502,2399,3472,1650,579,8100,402,21451
4700,경상북도,구미시차선거구,6470710,4707,구미시,잘못 투입·구분된 투표지,,0,11,4,5,1,1,11,0,-11
4700,경상북도,영주시가선거구,6470801,4708,영주시,합계,,12825,8523,1919,2286,860,1169,1067,821,8122,401,4302
4700,경상북도,영주시가선거구,6470801,4708,영주시,거소투표,,40,36,13,14,1,2,1,1,32,4,4
4700,경상북도,영주시가선거구,6470801,4708,영주시,관외사전투표,,920,920,210,264,96,107,53,125,855,65,0
4700,경상북도,영주시가선거구,6470801,4708,영주시,순흥면,계,1780,1231,230,288,92,333,76,155,1174,57,549
4700,경상북도,영주시가선거구,6470801,4708,영주시,순흥면,관내사전투표,460,460,89,106,36,123,25,57,436,24,0
4700,경상북도,영주시가선거구,6470801,4708,영주시,순흥면,선거일투표,1320,771,141,182,56,210,51,98,738,33,549
4700,경상북도,영주시가선거구,6470801,4708,영주시,단산면,계,1633,1151,156,146,371,354,37,35,1099,52,482
4700,경상북도,영주시가선거구,6470801,4708,영주시,단산면,관내사전투표,465,465,71,54,137,140,15,20,437,28,0
4700,경상북도,영주시가선거구,6470801,4708,영주시,단산면,선거일투표,1168,686,85,92,234,214,22,15,662,24,482
4700,경상북도,영주시가선거구,6470801,4708,영주시,부석면,계,2686,1884,608,231,101,151,689,42,1822,62,802
4700,경상북도,영주시가선거구,6470801,4708,영주시,부석면,관내사전투표,720,720,235,93,26,41,285,15,695,25,0
4700,경상북도,영주시가선거구,6470801,4708,영주시,부석면,선거일투표,1966,1164,373,138,75,110,404,27,1127,37,802
4700,경상북도,영주시가선거구,6470801,4708,영주시,상망동,계,5766,3301,702,1343,199,222,211,463,3140,161,2465
4700,경상북도,영주시가선거구,6470801,4708,영주시,상망동,관내사전투표,1181,1181,233,522,64,74,53,187,1133,48,0
4700,경상북도,영주시가선거구,6470801,4708,영주시,상망동,선거일투표,4585,2120,469,821,135,148,158,276,2007,113,2465
4700,경상북도,영주시가선거구,6470801,4708,영주시,잘못 투입·구분된 투표지,,0,0,0,0,0,0,0,0,0,0,0
4700,경상북도,영주시나선거구,6470802,4708,영주시,합계,,13092,8339,1169,2676,1732,532,152,1729,7990,349,4753
4700,경상북도,영주시나선거구,6470802,4708,영주시,거소투표,,25,24,5,8,3,2,0,4,22,2,1
4700,경상북도,영주시나선거구,6470802,4708,영주시,관외사전투표,,788,788,196,217,161,38,9,125,746,42,0
4700,경상북도,영주시나선거구,6470802,4708,영주시,하망동,계,4710,2874,428,908,579,218,44,587,2764,110,1836
4700,경상북도,영주시나선거구,6470802,4708,영주시,하망동,관내사전투표,1043,1043,157,352,207,72,13,195,996,47,0
4700,경상북도,영주시나선거구,6470802,4708,영주시,하망동,선거일투표,3667,1831,271,556,372,146,31,392,1768,63,1836
4700,경상북도,영주시나선거구,6470802,4708,영주시,영주1동,계,3342,2023,221,684,458,137,37,395,1932,91,1319
4700,경상북도,영주시나선거구,6470802,4708,영주시,영주1동,관내사전투표,721,721,76,245,168,52,9,131,681,40,0
4700,경상북도,영주시나선거구,6470802,4708,영주시,영주1동,선거일투표,2621,1302,145,439,290,85,28,264,1251,51,1319
4700,경상북도,영주시나선거구,6470802,4708,영주시,영주2동,계,4227,2629,319,858,531,137,62,618,2525,104,1598
4700,경상북도,영주시나선거구,6470802,4708,영주시,영주2동,관내사전투표,1065,1064,138,329,213,50,19,273,1022,42,1
4700,경상북도,영주시나선거구,6470802,4708,영주시,영주2동,선거일투표,3162,1565,181,529,318,87,43,345,1503,62,1597
4700,경상북도,영주시나선거구,6470802,4708,영주시,잘못 투입·구분된 투표지,,0,1,0,1,0,0,0,0,1,0,-1
4700,경상북도,영주시다선거구,6470803,4708,영주시,합계,,20374,11670,2134,3048,1942,4196,11320,350,8704
4700,경상북도,영주시다선거구,6470803,4708,영주시,거소투표,,112,111,17,46,12,12,87,24,1
4700,경상북도,영주시다선거구,6470803,4708,영주시,관외사전투표,,1871,1871,454,454,244,652,1804,67,0
4700,경상북도,영주시다선거구,6470803,4708,영주시,가흥1동,계,10953,5767,1140,1468,966,2054,5628,139,5186
4700,경상북도,영주시다선거구,6470803,4708,영주시,가흥1동,관내사전투표,2028,2027,424,452,302,788,1966,61,1
4700,경상북도,영주시다선거구,6470803,4708,영주시,가흥1동,선거일투표,8925,3740,716,1016,664,1266,3662,78,5185
4700,경상북도,영주시다선거구,6470803,4708,영주시,가흥2동,계,7438,3917,522,1080,720,1476,3798,119,3521
4700,경상북도,영주시다선거구,6470803,4708,영주시,가흥2동,관내사전투표,1529,1527,216,394,296,561,1467,60,2
4700,경상북도,영주시다선거구,6470803,4708,영주시,가흥2동,선거일투표,5909,2390,306,686,424,915,2331,59,3519
4700,경상북도,영주시다선거구,6470803,4708,영주시,잘못 투입·구분된 투표지,,0,4,1,0,0,2,3,1,-4
4700,경상북도,영주시라선거구,6470804,4708,영주시,합계,,12654,8348,1286,2727,1642,2399,8054,294,4306
4700,경상북도,영주시라선거구,6470804,4708,영주시,거소투표,,25,22,9,6,4,0,19,3,3
4700,경상북도,영주시라선거구,6470804,4708,영주시,관외사전투표,,1165,1165,246,399,220,245,1110,55,0
4700,경상북도,영주시라선거구,6470804,4708,영주시,이산면,계,1918,1239,85,330,108,675,1198,41,679
4700,경상북도,영주시라선거구,6470804,4708,영주시,이산면,관내사전투표,481,480,31,121,41,265,458,22,1
4700,경상북도,영주시라선거구,6470804,4708,영주시,이산면,선거일투표,1437,759,54,209,67,410,740,19,678
4700,경상북도,영주시라선거구,6470804,4708,영주시,평은면,계,1271,851,62,289,115,342,808,43,420
4700,경상북도,영주시라선거구,6470804,4708,영주시,평은면,관내사전투표,362,362,30,134,39,135,338,24,0
4700,경상북도,영주시라선거구,6470804,4708,영주시,평은면,선거일투표,909,489,32,155,76,207,470,19,420
4700,경상북도,영주시라선거구,6470804,4708,영주시,문수면,계,1678,1117,167,348,141,414,1070,47,561
4700,경상북도,영주시라선거구,6470804,4708,영주시,문수면,관내사전투표,493,493,73,155,65,174,467,26,0
4700,경상북도,영주시라선거구,6470804,4708,영주시,문수면,선거일투표,1185,624,94,193,76,240,603,21,561
4700,경상북도,영주시라선거구,6470804,4708,영주시,장수면,계,1831,1218,135,613,134,282,1164,54,613
4700,경상북도,영주시라선거구,6470804,4708,영주시,장수면,관내사전투표,520,520,55,269,61,102,487,33,0
4700,경상북도,영주시라선거구,6470804,4708,영주시,장수면,선거일투표,1311,698,80,344,73,180,677,21,613
4700,경상북도,영주시라선거구,6470804,4708,영주시,휴천1동,계,4766,2734,582,741,920,440,2683,51,2032
4700,경상북도,영주시라선거구,6470804,4708,영주시,휴천1동,관내사전투표,1028,1028,245,302,303,153,1003,25,0
4700,경상북도,영주시라선거구,6470804,4708,영주시,휴천1동,선거일투표,3738,1706,337,439,617,287,1680,26,2032
4700,경상북도,영주시라선거구,6470804,4708,영주시,잘못 투입·구분된 투표지,,0,2,0,1,0,1,2,0,-2
4700,경상북도,영주시마선거구,6470805,4708,영주시,합계,,15401,9537,1754,2656,3474,1199,9083,454,5864
4700,경상북도,영주시마선거구,6470805,4708,영주시,거소투표,,35,34,7,9,13,0,29,5,1
4700,경상북도,영주시마선거구,6470805,4708,영주시,관외사전투표,,1190,1190,348,254,399,113,1114,76,0
4700,경상북도,영주시마선거구,6470805,4708,영주시,휴천2동,계,8154,4869,816,1580,1578,669,4643,226,3285
4700,경상북도,영주시마선거구,6470805,4708,영주시,휴천2동,관내사전투표,1494,1493,307,426,509,164,1406,87,1
4700,경상북도,영주시마선거구,6470805,4708,영주시,휴천2동,선거일투표,6660,3376,509,1154,1069,505,3237,139,3284
4700,경상북도,영주시마선거구,6470805,4708,영주시,휴천3동,계,6022,3441,583,812,1483,417,3295,146,2581
4700,경상북도,영주시마선거구,6470805,4708,영주시,휴천3동,관내사전투표,1128,1126,208,268,451,136,1063,63,2
4700,경상북도,영주시마선거구,6470805,4708,영주시,휴천3동,선거일투표,4894,2315,375,544,1032,281,2232,83,2579
4700,경상북도,영주시마선거구,6470805,4708,영주시,잘못 투입·구분된 투표지,,0,3,0,1,1,0,2,1,-3
4700,경상북도,영주시바선거구,6470806,4708,영주시,합계,,14715,9879,1817,2084,1855,3741,9497,382,4836
4700,경상북도,영주시바선거구,6470806,4708,영주시,거소투표,,39,32,8,2,8,12,30,2,7
4700,경상북도,영주시바선거구,6470806,4708,영주시,관외사전투표,,612,612,149,141,95,191,576,36,0
4700,경상북도,영주시바선거구,6470806,4708,영주시,풍기읍,계,9012,5887,1165,1301,1270,1928,5664,223,3125
4700,경상북도,영주시바선거구,6470806,4708,영주시,풍기읍,관내사전투표,2291,2287,484,468,437,789,2178,109,4
4700,경상북도,영주시바선거구,6470806,4708,영주시,풍기읍,선거일투표,6721,3600,681,833,833,1139,3486,114,3121
4700,경상북도,영주시바선거구,6470806,4708,영주시,안정면,계,2617,1724,265,352,265,771,1653,71,893
4700,경상북도,영주시바선거구,6470806,4708,영주시,안정면,관내사전투표,751,749,97,158,76,375,706,43,2
4700,경상북도,영주시바선거구,6470806,4708,영주시,안정면,선거일투표,1866,975,168,194,189,396,947,28,891
4700,경상북도,영주시바선거구,6470806,4708,영주시,봉현면,계,2435,1616,226,287,214,839,1566,50,819
4700,경상북도,영주시바선거구,6470806,4708,영주시,봉현면,관내사전투표,550,549,71,98,73,288,530,19,1
4700,경상북도,영주시바선거구,6470806,4708,영주시,봉현면,선거일투표,1885,1067,155,189,141,551,1036,31,818
4700,경상북도,영주시바선거구,6470806,4708,영주시,잘못 투입·구분된 투표지,,0,8,4,1,3,0,8,0,-8
4700,경상북도,영천시가선거구,6470901,4709,영천시,합계,,20479,11324,2755,3958,4084,10797,527,9155
4700,경상북도,영천시가선거구,6470901,4709,영천시,거소투표,,69,62,22,13,24,59,3,7
4700,경상북도,영천시가선거구,6470901,4709,영천시,관외사전투표,,1294,1294,456,398,391,1245,49,0
4700,경상북도,영천시가선거구,6470901,4709,영천시,북안면,계,3946,2235,404,553,1105,2062,173,1711
4700,경상북도,영천시가선거구,6470901,4709,영천시,북안면,관내사전투표,1138,1138,205,264,539,1008,130,0
4700,경상북도,영천시가선거구,6470901,4709,영천시,북안면,선거일투표,2808,1097,199,289,566,1054,43,1711
4700,경상북도,영천시가선거구,6470901,4709,영천시,서부동,계,4064,2213,511,833,780,2124,89,1851
4700,경상북도,영천시가선거구,6470901,4709,영천시,서부동,관내사전투표,935,932,239,344,311,894,38,3
4700,경상북도,영천시가선거구,6470901,4709,영천시,서부동,선거일투표,3129,1281,272,489,469,1230,51,1848
4700,경상북도,영천시가선거구,6470901,4709,영천시,완산동,계,7631,3901,1080,1522,1161,3763,138,3730
4700,경상북도,영천시가선거구,6470901,4709,영천시,완산동,관내사전투표,1482,1482,425,588,412,1425,57,0
4700,경상북도,영천시가선거구,6470901,4709,영천시,완산동,선거일투표,6149,2419,655,934,749,2338,81,3730
4700,경상북도,영천시가선거구,6470901,4709,영천시,남부동,계,3475,1611,281,635,620,1536,75,1864
4700,경상북도,영천시가선거구,6470901,4709,영천시,남부동,관내사전투표,565,562,112,211,206,529,33,3
4700,경상북도,영천시가선거구,6470901,4709,영천시,남부동,선거일투표,2910,1049,169,424,414,1007,42,1861
4700,경상북도,영천시가선거구,6470901,4709,영천시,잘못 투입·구분된 투표지,,0,8,1,4,3,8,0,-8
4700,경상북도,영천시나선거구,6470902,4709,영천시,합계,,23105,13128,1640,4213,1739,2226,361,1838,629,12646,482,9977
4700,경상북도,영천시나선거구,6470902,4709,영천시,거소투표,,32,32,6,9,3,0,2,1,5,26,6,0
4700,경상북도,영천시나선거구,6470902,4709,영천시,관외사전투표,,1470,1470,328,560,144,211,38,105,41,1427,43,0
4700,경상북도,영천시나선거구,6470902,4709,영천시,금호읍,계,9265,4825,388,1965,381,280,56,1280,333,4683,142,4440
4700,경상북도,영천시나선거구,6470902,4709,영천시,금호읍,관내사전투표,1361,1361,148,545,96,79,13,347,92,1320,41,0
4700,경상북도,영천시나선거구,6470902,4709,영천시,금호읍,선거일투표,7904,3464,240,1420,285,201,43,933,241,3363,101,4440
4700,경상북도,영천시나선거구,6470902,4709,영천시,청통면,계,3501,2001,429,414,585,190,150,76,79,1923,78,1500
4700,경상북도,영천시나선거구,6470902,4709,영천시,청통면,관내사전투표,813,812,204,159,251,75,38,18,32,777,35,1
4700,경상북도,영천시나선거구,6470902,4709,영천시,청통면,선거일투표,2688,1189,225,255,334,115,112,58,47,1146,43,1499
4700,경상북도,영천시나선거구,6470902,4709,영천시,신녕면,계,3330,1863,150,340,132,1070,39,44,18,1793,70,1467
4700,경상북도,영천시나선거구,6470902,4709,영천시,신녕면,관내사전투표,966,966,71,190,73,557,11,15,9,926,40,0
4700,경상북도,영천시나선거구,6470902,4709,영천시,신녕면,선거일투표,2364,897,79,150,59,513,28,29,9,867,30,1467
4700,경상북도,영천시나선거구,6470902,4709,영천시,화산면,계,2775,1424,188,406,289,232,53,106,74,1348,76,1351
4700,경상북도,영천시나선거구,6470902,4709,영천시,화산면,관내사전투표,614,614,95,164,113,94,21,52,38,577,37,0
4700,경상북도,영천시나선거구,6470902,4709,영천시,화산면,선거일투표,2161,810,93,242,176,138,32,54,36,771,39,1351
4700,경상북도,영천시나선거구,6470902,4709,영천시,대창면,계,2732,1513,151,519,205,243,23,226,79,1446,67,1219
4700,경상북도,영천시나선거구,6470902,4709,영천시,대창면,관내사전투표,605,605,62,214,82,101,9,87,21,576,29,0
4700,경상북도,영천시나선거구,6470902,4709,영천시,대창면,선거일투표,2127,908,89,305,123,142,14,139,58,870,38,1219
4700,경상북도,영천시나선거구,6470902,4709,영천시,잘못 투입·구분된 투표지,,0,0,0,0,0,0,0,0,0,0,0,0
4700,경상북도,영천시다선거구,6470903,4709,영천시,합계,,31901,17630,2644,4635,3841,3116,165,2697,17098,532,14271
4700,경상북도,영천시다선거구,6470903,4709,영천시,거소투표,,62,57,14,12,18,2,1,8,55,2,5
4700,경상북도,영천시다선거구,6470903,4709,영천시,관외사전투표,,2370,2369,432,678,479,334,29,331,2283,86,1
4700,경상북도,영천시다선거구,6470903,4709,영천시,동부동,계,21403,10573,1548,2924,2202,1999,99,1476,10248,325,10830
4700,경상북도,영천시다선거구,6470903,4709,영천시,동부동,관내사전투표,2797,2797,455,776,591,517,24,374,2737,60,0
4700,경상북도,영천시다선거구,6470903,4709,영천시,동부동,선거일투표,18606,7776,1093,2148,1611,1482,75,1102,7511,265,10830
4700,경상북도,영천시다선거구,6470903,4709,영천시,중앙동,계,8066,4629,650,1020,1142,781,36,882,4511,118,3437
4700,경상북도,영천시다선거구,6470903,4709,영천시,중앙동,관내사전투표,2188,2188,332,458,574,407,16,339,2126,62,0
4700,경상북도,영천시다선거구,6470903,4709,영천시,중앙동,선거일투표,5878,2441,318,562,568,374,20,543,2385,56,3437
4700,경상북도,영천시다선거구,6470903,4709,영천시,잘못 투입·구분된 투표지,,0,2,0,1,0,0,0,0,1,1,-2
4700,경상북도,영천시라선거구,6470904,4709,영천시,합계,,15447,9624,2941,3207,2510,8658,966,5823
4700,경상북도,영천시라선거구,6470904,4709,영천시,거소투표,,38,34,14,8,10,32,2,4
4700,경상북도,영천시라선거구,6470904,4709,영천시,관외사전투표,,1242,1241,457,393,343,1193,48,1
4700,경상북도,영천시라선거구,6470904,4709,영천시,화북면,계,1913,1174,397,392,232,1021,153,739
4700,경상북도,영천시라선거구,6470904,4709,영천시,화북면,관내사전투표,460,460,172,158,93,423,37,0
4700,경상북도,영천시라선거구,6470904,4709,영천시,화북면,선거일투표,1453,714,225,234,139,598,116,739
4700,경상북도,영천시라선거구,6470904,4709,영천시,화남면,계,2834,1594,569,563,295,1427,167,1240
4700,경상북도,영천시라선거구,6470904,4709,영천시,화남면,관내사전투표,500,500,198,189,87,474,26,0
4700,경상북도,영천시라선거구,6470904,4709,영천시,화남면,선거일투표,2334,1094,371,374,208,953,141,1240
4700,경상북도,영천시라선거구,6470904,4709,영천시,자양면,계,952,580,133,222,135,490,90,372
4700,경상북도,영천시라선거구,6470904,4709,영천시,자양면,관내사전투표,279,279,56,117,75,248,31,0
4700,경상북도,영천시라선거구,6470904,4709,영천시,자양면,선거일투표,673,301,77,105,60,242,59,372
4700,경상북도,영천시라선거구,6470904,4709,영천시,임고면,계,3758,2297,451,1183,457,2091,206,1461
4700,경상북도,영천시라선거구,6470904,4709,영천시,임고면,관내사전투표,789,789,181,394,172,747,42,0
4700,경상북도,영천시라선거구,6470904,4709,영천시,임고면,선거일투표,2969,1508,270,789,285,1344,164,1461
4700,경상북도,영천시라선거구,6470904,4709,영천시,고경면,계,4710,2696,915,444,1038,2397,299,2014
4700,경상북도,영천시라선거구,6470904,4709,영천시,고경면,관내사전투표,878,874,324,177,324,825,49,4
4700,경상북도,영천시라선거구,6470904,4709,영천시,고경면,선거일투표,3832,1822,591,267,714,1572,250,2010
4700,경상북도,영천시라선거구,6470904,4709,영천시,잘못 투입·구분된 투표지,,0,8,5,2,0,7,1,-8
4700,경상북도,상주시가선거구,6471001,4710,상주시,합계,,10931,7258,1619,2160,1437,1063,558,6837,421,3673
4700,경상북도,상주시가선거구,6471001,4710,상주시,거소투표,,84,78,8,34,10,14,4,70,8,6
4700,경상북도,상주시가선거구,6471001,4710,상주시,관외사전투표,,516,516,154,143,92,72,27,488,28,0
4700,경상북도,상주시가선거구,6471001,4710,상주시,함창읍,계,5395,3434,494,1001,918,518,317,3248,186,1961
4700,경상북도,상주시가선거구,6471001,4710,상주시,함창읍,관내사전투표,1868,1866,269,529,496,305,164,1763,103,2
4700,경상북도,상주시가선거구,6471001,4710,상주시,함창읍,선거일투표,3527,1568,225,472,422,213,153,1485,83,1959
4700,경상북도,상주시가선거구,6471001,4710,상주시,은척면,계,1355,905,206,277,99,168,82,832,73,450
4700,경상북도,상주시가선거구,6471001,4710,상주시,은척면,관내사전투표,415,415,95,123,42,84,39,383,32,0
4700,경상북도,상주시가선거구,6471001,4710,상주시,은척면,선거일투표,940,490,111,154,57,84,43,449,41,450
4700,경상북도,상주시가선거구,6471001,4710,상주시,공검면,계,1896,1223,586,298,106,147,25,1162,61,673
4700,경상북도,상주시가선거구,6471001,4710,상주시,공검면,관내사전투표,528,527,233,144,50,62,11,500,27,1
4700,경상북도,상주시가선거구,6471001,4710,상주시,공검면,선거일투표,1368,696,353,154,56,85,14,662,34,672
4700,경상북도,상주시가선거구,6471001,4710,상주시,이안면,계,1685,1096,171,406,211,143,103,1034,62,589
4700,경상북도,상주시가선거구,6471001,4710,상주시,이안면,관내사전투표,421,421,73,152,67,47,55,394,27,0
4700,경상북도,상주시가선거구,6471001,4710,상주시,이안면,선거일투표,1264,675,98,254,144,96,48,640,35,589
4700,경상북도,상주시가선거구,6471001,4710,상주시,잘못 투입·구분된 투표지,,0,6,0,1,1,1,0,3,3,-6
4700,경상북도,상주시나선거구,6471002,4710,상주시,합계,,11023,7561,1561,2159,687,962,1833,7202,359,3462
4700,경상북도,상주시나선거구,6471002,4710,상주시,거소투표,,99,95,13,12,3,9,56,93,2,4
4700,경상북도,상주시나선거구,6471002,4710,상주시,관외사전투표,,1239,1239,364,262,76,194,276,1172,67,0
4700,경상북도,상주시나선거구,6471002,4710,상주시,사벌국면,계,3198,2105,329,295,33,423,919,1999,106,1093
4700,경상북도,상주시나선거구,6471002,4710,상주시,사벌국면,관내사전투표,1010,1009,150,150,15,182,450,947,62,1
4700,경상북도,상주시나선거구,6471002,4710,상주시,사벌국면,선거일투표,2188,1096,179,145,18,241,469,1052,44,1092
4700,경상북도,상주시나선거구,6471002,4710,상주시,중동면,계,1151,825,170,247,31,158,173,779,46,326
4700,경상북도,상주시나선거구,6471002,4710,상주시,중동면,관내사전투표,456,453,93,144,14,83,83,417,36,3
4700,경상북도,상주시나선거구,6471002,4710,상주시,중동면,선거일투표,695,372,77,103,17,75,90,362,10,323
4700,경상북도,상주시나선거구,6471002,4710,상주시,낙동면,계,3453,2216,224,1191,496,58,155,2124,92,1237
4700,경상북도,상주시나선거구,6471002,4710,상주시,낙동면,관내사전투표,924,924,93,482,225,23,55,878,46,0
4700,경상북도,상주시나선거구,6471002,4710,상주시,낙동면,선거일투표,2529,1292,131,709,271,35,100,1246,46,1237
4700,경상북도,상주시나선거구,6471002,4710,상주시,외서면,계,1883,1077,461,150,48,120,252,1031,46,806
4700,경상북도,상주시나선거구,6471002,4710,상주시,외서면,관내사전투표,490,490,227,66,22,45,110,470,20,0
4700,경상북도,상주시나선거구,6471002,4710,상주시,외서면,선거일투표,1393,587,234,84,26,75,142,561,26,806
4700,경상북도,상주시나선거구,6471002,4710,상주시,잘못 투입·구분된 투표지,,0,4,0,2,0,0,2,4,0,-4
4700,경상북도,상주시다선거구,6471003,4710,상주시,합계,,22223,13334,1936,2600,2432,1852,764,974,1480,871,12909,425,8889
4700,경상북도,상주시다선거구,6471003,4710,상주시,거소투표,,103,100,10,51,11,8,3,4,3,6,96,4,3
4700,경상북도,상주시다선거구,6471003,4710,상주시,관외사전투표,,1906,1906,438,406,254,259,79,94,225,90,1845,61,0
4700,경상북도,상주시다선거구,6471003,4710,상주시,북문동,계,7259,4128,537,910,634,524,211,367,428,395,4006,122,3131
4700,경상북도,상주시다선거구,6471003,4710,상주시,북문동,관내사전투표,1726,1726,243,344,285,207,70,134,197,191,1671,55,0
4700,경상북도,상주시다선거구,6471003,4710,상주시,북문동,선거일투표,5533,2402,294,566,349,317,141,233,231,204,2335,67,3131
4700,경상북도,상주시다선거구,6471003,4710,상주시,계림동,계,6815,3727,477,570,926,451,256,273,467,174,3594,133,3088
4700,경상북도,상주시다선거구,6471003,4710,상주시,계림동,관내사전투표,1606,1606,222,238,402,194,88,125,198,74,1541,65,0
4700,경상북도,상주시다선거구,6471003,4710,상주시,계림동,선거일투표,5209,2121,255,332,524,257,168,148,269,100,2053,68,3088
4700,경상북도,상주시다선거구,6471003,4710,상주시,동문동,계,6140,3473,474,663,607,610,215,236,357,206,3368,105,2667
4700,경상북도,상주시다선거구,6471003,4710,상주시,동문동,관내사전투표,1269,1269,198,232,243,228,66,71,130,64,1232,37,0
4700,경상북도,상주시다선거구,6471003,4710,상주시,동문동,선거일투표,4871,2204,276,431,364,382,149,165,227,142,2136,68,2667
4700,경상북도,상주시다선거구,6471003,4710,상주시,잘못 투입·구분된 투표지,,0,0,0,0,0,0,0,0,0,0,0,0,0
4700,경상북도,상주시라선거구,6471004,4710,상주시,합계,,7556,5364,1850,1334,1808,4992,372,2192
4700,경상북도,상주시라선거구,6471004,4710,상주시,거소투표,,50,45,13,19,6,38,7,5
4700,경상북도,상주시라선거구,6471004,4710,상주시,관외사전투표,,405,405,221,68,100,389,16,0
4700,경상북도,상주시라선거구,6471004,4710,상주시,청리면,계,2244,1538,542,47,855,1444,94,706
4700,경상북도,상주시라선거구,6471004,4710,상주시,청리면,관내사전투표,733,733,280,15,407,702,31,0
4700,경상북도,상주시라선거구,6471004,4710,상주시,청리면,선거일투표,1511,805,262,32,448,742,63,706
4700,경상북도,상주시라선거구,6471004,4710,상주시,공성면,계,3444,2380,632,1102,479,2213,167,1064
4700,경상북도,상주시라선거구,6471004,4710,상주시,공성면,관내사전투표,1145,1144,307,562,181,1050,94,1
4700,경상북도,상주시라선거구,6471004,4710,상주시,공성면,선거일투표,2299,1236,325,540,298,1163,73,1063
4700,경상북도,상주시라선거구,6471004,4710,상주시,외남면,계,1413,991,441,98,365,904,87,422
4700,경상북도,상주시라선거구,6471004,4710,상주시,외남면,관내사전투표,483,483,218,54,153,425,58,0
4700,경상북도,상주시라선거구,6471004,4710,상주시,외남면,선거일투표,930,508,223,44,212,479,29,422
4700,경상북도,상주시라선거구,6471004,4710,상주시,잘못 투입·구분된 투표지,,0,5,1,0,3,4,1,-5
4700,경상북도,상주시마선거구,6471005,4710,상주시,합계,,20321,12103,1341,2501,1981,2399,289,1473,1317,432,11733,370,8218
4700,경상북도,상주시마선거구,6471005,4710,상주시,거소투표,,53,42,6,11,4,8,0,7,0,0,36,6,11
4700,경상북도,상주시마선거구,6471005,4710,상주시,관외사전투표,,1585,1583,287,384,166,298,44,153,149,56,1537,46,2
4700,경상북도,상주시마선거구,6471005,4710,상주시,남원동,계,9115,5274,554,1130,833,1099,114,758,441,200,5129,145,3841
4700,경상북도,상주시마선거구,6471005,4710,상주시,남원동,관내사전투표,2049,2049,248,483,290,429,32,291,144,69,1986,63,0
4700,경상북도,상주시마선거구,6471005,4710,상주시,남원동,선거일투표,7066,3225,306,647,543,670,82,467,297,131,3143,82,3841
4700,경상북도,상주시마선거구,6471005,4710,상주시,동성동,계,2932,1744,147,376,341,347,43,157,224,44,1679,65,1188
4700,경상북도,상주시마선거구,6471005,4710,상주시,동성동,관내사전투표,642,642,67,145,106,132,20,56,77,24,627,15,0
4700,경상북도,상주시마선거구,6471005,4710,상주시,동성동,선거일투표,2290,1102,80,231,235,215,23,101,147,20,1052,50,1188
4700,경상북도,상주시마선거구,6471005,4710,상주시,신흥동,계,6636,3459,347,600,637,647,88,398,503,132,3352,107,3177
4700,경상북도,상주시마선거구,6471005,4710,상주시,신흥동,관내사전투표,1549,1549,174,260,229,309,32,198,233,72,1507,42,0
4700,경상북도,상주시마선거구,6471005,4710,상주시,신흥동,선거일투표,5087,1910,173,340,408,338,56,200,270,60,1845,65,3177
4700,경상북도,상주시마선거구,6471005,4710,상주시,잘못 투입·구분된 투표지,,0,1,0,0,0,0,0,0,0,0,0,1,-1
4700,경상북도,상주시바선거구,6471006,4710,상주시,합계,,12926,8747,1029,1791,1827,1260,826,1635,8368,379,4179
4700,경상북도,상주시바선거구,6471006,4710,상주시,거소투표,,108,93,23,29,12,7,2,15,88,5,15
4700,경상북도,상주시바선거구,6471006,4710,상주시,관외사전투표,,632,632,123,196,106,89,34,65,613,19,0
4700,경상북도,상주시바선거구,6471006,4710,상주시,내서면,계,1586,1053,121,211,248,128,29,270,1007,46,533
4700,경상북도,상주시바선거구,6471006,4710,상주시,내서면,관내사전투표,373,373,42,67,89,39,6,116,359,14,0
4700,경상북도,상주시바선거구,6471006,4710,상주시,내서면,선거일투표,1213,680,79,144,159,89,23,154,648,32,533
4700,경상북도,상주시바선거구,6471006,4710,상주시,모동면,계,2260,1530,108,424,210,35,630,67,1474,56,730
4700,경상북도,상주시바선거구,6471006,4710,상주시,모동면,관내사전투표,613,613,47,170,95,15,247,19,593,20,0
4700,경상북도,상주시바선거구,6471006,4710,상주시,모동면,선거일투표,1647,917,61,254,115,20,383,48,881,36,730
4700,경상북도,상주시바선거구,6471006,4710,상주시,모서면,계,2186,1406,364,299,574,26,42,47,1352,54,780
4700,경상북도,상주시바선거구,6471006,4710,상주시,모서면,관내사전투표,567,567,147,121,230,14,13,25,550,17,0
4700,경상북도,상주시바선거구,6471006,4710,상주시,모서면,선거일투표,1619,839,217,178,344,12,29,22,802,37,780
4700,경상북도,상주시바선거구,6471006,4710,상주시,화동면,계,1689,1107,93,220,369,126,46,200,1054,53,582
4700,경상북도,상주시바선거구,6471006,4710,상주시,화동면,관내사전투표,447,447,39,79,144,61,14,91,428,19,0
4700,경상북도,상주시바선거구,6471006,4710,상주시,화동면,선거일투표,1242,660,54,141,225,65,32,109,626,34,582
4700,경상북도,상주시바선거구,6471006,4710,상주시,화서면,계,2512,1681,81,191,136,594,24,563,1589,92,831
4700,경상북도,상주시바선거구,6471006,4710,상주시,화서면,관내사전투표,716,716,37,102,50,252,11,217,669,47,0
4700,경상북도,상주시바선거구,6471006,4710,상주시,화서면,선거일투표,1796,965,44,89,86,342,13,346,920,45,831
4700,경상북도,상주시바선거구,6471006,4710,상주시,화북면,계,1317,851,72,143,130,170,15,284,814,37,466
4700,경상북도,상주시바선거구,6471006,4710,상주시,화북면,관내사전투표,354,354,21,60,54,73,6,121,335,19,0
4700,경상북도,상주시바선거구,6471006,4710,상주시,화북면,선거일투표,963,497,51,83,76,97,9,163,479,18,466
4700,경상북도,상주시바선거구,6471006,4710,상주시,화남면,계,636,394,44,78,42,85,4,124,377,17,242
4700,경상북도,상주시바선거구,6471006,4710,상주시,화남면,관내사전투표,197,197,21,39,24,35,3,66,188,9,0
4700,경상북도,상주시바선거구,6471006,4710,상주시,화남면,선거일투표,439,197,23,39,18,50,1,58,189,8,242
4700,경상북도,상주시바선거구,6471006,4710,상주시,잘못 투입·구분된 투표지,,0,0,0,0,0,0,0,0,0,0,0
4700,경상북도,문경시가선거구,6471101,4711,문경시,합계,,16236,10600,2260,3677,1679,1179,1336,10131,469,5636
4700,경상북도,문경시가선거구,6471101,4711,문경시,거소투표,,125,111,27,28,20,19,15,109,2,14
4700,경상북도,문경시가선거구,6471101,4711,문경시,관외사전투표,,881,881,271,248,140,64,118,841,40,0
4700,경상북도,문경시가선거구,6471101,4711,문경시,문경읍,계,6148,3765,313,2439,245,265,400,3662,103,2383
4700,경상북도,문경시가선거구,6471101,4711,문경시,문경읍,관내사전투표,1640,1639,136,1049,105,119,184,1593,46,1
4700,경상북도,문경시가선거구,6471101,4711,문경시,문경읍,선거일투표,4508,2126,177,1390,140,146,216,2069,57,2382
4700,경상북도,문경시가선거구,6471101,4711,문경시,가은읍,계,3555,2371,799,235,868,198,143,2243,128,1184
4700,경상북도,문경시가선거구,6471101,4711,문경시,가은읍,관내사전투표,1203,1201,415,131,419,97,65,1127,74,2
4700,경상북도,문경시가선거구,6471101,4711,문경시,가은읍,선거일투표,2352,1170,384,104,449,101,78,1116,54,1182
4700,경상북도,문경시가선거구,6471101,4711,문경시,마성면,계,3199,2000,330,433,120,422,583,1888,112,1199
4700,경상북도,문경시가선거구,6471101,4711,문경시,마성면,관내사전투표,1006,1003,163,226,63,203,277,932,71,3
4700,경상북도,문경시가선거구,6471101,4711,문경시,마성면,선거일투표,2193,997,167,207,57,219,306,956,41,1196
4700,경상북도,문경시가선거구,6471101,4711,문경시,농암면,계,2328,1465,517,293,285,211,75,1381,84,863
4700,경상북도,문경시가선거구,6471101,4711,문경시,농암면,관내사전투표,725,725,252,145,127,129,30,683,42,0
4700,경상북도,문경시가선거구,6471101,4711,문경시,농암면,선거일투표,1603,740,265,148,158,82,45,698,42,863
4700,경상북도,문경시가선거구,6471101,4711,문경시,잘못 투입·구분된 투표지,,0,7,3,1,1,0,2,7,0,-7
4700,경상북도,문경시나선거구,6471102,4711,문경시,합계,,22747,13383,2180,4839,3313,2638,12970,413,9364
4700,경상북도,문경시나선거구,6471102,4711,문경시,거소투표,,84,77,11,33,15,16,75,2,7
4700,경상북도,문경시나선거구,6471102,4711,문경시,관외사전투표,,1967,1966,463,613,497,337,1910,56,1
4700,경상북도,문경시나선거구,6471102,4711,문경시,점촌2동,계,5980,3390,443,1265,882,668,3258,132,2590
4700,경상북도,문경시나선거구,6471102,4711,문경시,점촌2동,관내사전투표,1521,1519,217,508,430,282,1437,82,2
4700,경상북도,문경시나선거구,6471102,4711,문경시,점촌2동,선거일투표,4459,1871,226,757,452,386,1821,50,2588
4700,경상북도,문경시나선거구,6471102,4711,문경시,점촌4동,계,2697,1512,173,596,368,333,1470,42,1185
4700,경상북도,문경시나선거구,6471102,4711,문경시,점촌4동,관내사전투표,537,537,63,208,134,108,513,24,0
4700,경상북도,문경시나선거구,6471102,4711,문경시,점촌4동,선거일투표,2160,975,110,388,234,225,957,18,1185
4700,경상북도,문경시나선거구,6471102,4711,문경시,점촌5동,계,12019,6432,1090,2329,1550,1283,6252,180,5587
4700,경상북도,문경시나선거구,6471102,4711,문경시,점촌5동,관내사전투표,3062,3060,505,1096,778,581,2960,100,2
4700,경상북도,문경시나선거구,6471102,4711,문경시,점촌5동,선거일투표,8957,3372,585,1233,772,702,3292,80,5585
4700,경상북도,문경시나선거구,6471102,4711,문경시,잘못 투입·구분된 투표지,,0,6,0,3,1,1,5,1,-6
4700,경상북도,문경시다선거구,6471103,4711,문경시,합계,,9626,6711,1868,1952,1561,896,6277,434,2915
4700,경상북도,문경시다선거구,6471103,4711,문경시,거소투표,,65,58,11,20,18,4,53,5,7
4700,경상북도,문경시다선거구,6471103,4711,문경시,관외사전투표,,809,808,277,244,118,131,770,38,1
4700,경상북도,문경시다선거구,6471103,4711,문경시,영순면,계,1962,1316,178,893,42,109,1222,94,646
4700,경상북도,문경시다선거구,6471103,4711,문경시,영순면,관내사전투표,746,746,96,492,24,71,683,63,0
4700,경상북도,문경시다선거구,6471103,4711,문경시,영순면,선거일투표,1216,570,82,401,18,38,539,31,646
4700,경상북도,문경시다선거구,6471103,4711,문경시,산양면,계,2581,1717,896,275,141,293,1605,112,864
4700,경상북도,문경시다선거구,6471103,4711,문경시,산양면,관내사전투표,778,778,417,118,66,131,732,46,0
4700,경상북도,문경시다선거구,6471103,4711,문경시,산양면,선거일투표,1803,939,479,157,75,162,873,66,864
4700,경상북도,문경시다선거구,6471103,4711,문경시,산북면,계,2454,1668,219,257,926,142,1544,124,786
4700,경상북도,문경시다선거구,6471103,4711,문경시,산북면,관내사전투표,860,860,110,134,491,73,808,52,0
4700,경상북도,문경시다선거구,6471103,4711,문경시,산북면,선거일투표,1594,808,109,123,435,69,736,72,786
4700,경상북도,문경시다선거구,6471103,4711,문경시,동로면,계,1755,1143,287,263,315,217,1082,61,612
4700,경상북도,문경시다선거구,6471103,4711,문경시,동로면,관내사전투표,580,580,147,119,149,129,544,36,0
4700,경상북도,문경시다선거구,6471103,4711,문경시,동로면,선거일투표,1175,563,140,144,166,88,538,25,612
4700,경상북도,문경시다선거구,6471103,4711,문경시,잘못 투입·구분된 투표지,,0,1,0,0,1,0,1,0,-1
4700,경상북도,문경시라선거구,6471104,4711,문경시,합계,,15551,9690,2704,2487,2506,1485,9182,508,5861
4700,경상북도,문경시라선거구,6471104,4711,문경시,거소투표,,53,49,11,17,10,5,43,6,4
4700,경상북도,문경시라선거구,6471104,4711,문경시,관외사전투표,,1098,1097,310,253,326,152,1041,56,1
4700,경상북도,문경시라선거구,6471104,4711,문경시,호계면,계,2194,1317,340,325,284,265,1214,103,877
4700,경상북도,문경시라선거구,6471104,4711,문경시,호계면,관내사전투표,742,740,182,186,169,144,681,59,2
4700,경상북도,문경시라선거구,6471104,4711,문경시,호계면,선거일투표,1452,577,158,139,115,121,533,44,875
4700,경상북도,문경시라선거구,6471104,4711,문경시,점촌1동,계,4973,3124,1002,823,715,423,2963,161,1849
4700,경상북도,문경시라선거구,6471104,4711,문경시,점촌1동,관내사전투표,1480,1478,496,369,339,203,1407,71,2
4700,경상북도,문경시라선거구,6471104,4711,문경시,점촌1동,선거일투표,3493,1646,506,454,376,220,1556,90,1847
4700,경상북도,문경시라선거구,6471104,4711,문경시,점촌3동,계,7233,4095,1038,1067,1168,640,3913,182,3138
4700,경상북도,문경시라선거구,6471104,4711,문경시,점촌3동,관내사전투표,1812,1812,436,468,549,275,1728,84,0
4700,경상북도,문경시라선거구,6471104,4711,문경시,점촌3동,선거일투표,5421,2283,602,599,619,365,2185,98,3138
4700,경상북도,문경시라선거구,6471104,4711,문경시,잘못 투입·구분된 투표지,,0,8,3,2,3,0,8,0,-8
4700,경상북도,예천군가선거구,6471201,4712,예천군,합계,,12891,7923,2158,1818,2355,1340,7671,252,4968
4700,경상북도,예천군가선거구,6471201,4712,예천군,거소투표,,24,24,8,5,3,5,21,3,0
4700,경상북도,예천군가선거구,6471201,4712,예천군,관외사전투표,,780,777,283,201,122,141,747,30,3
4700,경상북도,예천군가선거구,6471201,4712,예천군,예천읍,계,12087,7112,1864,1612,2227,1190,6893,219,4975
4700,경상북도,예천군가선거구,6471201,4712,예천군,예천읍,관내사전투표,2888,2886,686,758,853,505,2802,84,2
4700,경상북도,예천군가선거구,6471201,4712,예천군,예천읍,선거일투표,9199,4226,1178,854,1374,685,4091,135,4973
4700,경상북도,예천군가선거구,6471201,4712,예천군,잘못 투입·구분된 투표지,,0,10,3,0,3,4,10,0,-10
4700,경상북도,예천군나선거구,6471202,4712,예천군,합계,,10894,7710,3558,2336,1373,7267,443,3184
4700,경상북도,예천군나선거구,6471202,4712,예천군,거소투표,,111,98,41,22,21,84,14,13
4700,경상북도,예천군나선거구,6471202,4712,예천군,관외사전투표,,615,615,311,177,100,588,27,0
4700,경상북도,예천군나선거구,6471202,4712,예천군,용문면,계,2008,1358,683,341,260,1284,74,650
4700,경상북도,예천군나선거구,6471202,4712,예천군,용문면,관내사전투표,709,708,377,158,130,665,43,1
4700,경상북도,예천군나선거구,6471202,4712,예천군,용문면,선거일투표,1299,650,306,183,130,619,31,649
4700,경상북도,예천군나선거구,6471202,4712,예천군,효자면,계,985,724,525,111,52,688,36,261
4700,경상북도,예천군나선거구,6471202,4712,예천군,효자면,관내사전투표,387,387,285,66,27,378,9,0
4700,경상북도,예천군나선거구,6471202,4712,예천군,효자면,선거일투표,598,337,240,45,25,310,27,261
4700,경상북도,예천군나선거구,6471202,4712,예천군,은풍면,계,1268,954,656,149,94,899,55,314
4700,경상북도,예천군나선거구,6471202,4712,예천군,은풍면,관내사전투표,505,505,366,84,37,487,18,0
4700,경상북도,예천군나선거구,6471202,4712,예천군,은풍면,선거일투표,763,449,290,65,57,412,37,314
4700,경상북도,예천군나선거구,6471202,4712,예천군,감천면,계,2335,1637,467,965,119,1551,86,698
4700,경상북도,예천군나선거구,6471202,4712,예천군,감천면,관내사전투표,765,765,227,433,48,708,57,0
4700,경상북도,예천군나선거구,6471202,4712,예천군,감천면,선거일투표,1570,872,240,532,71,843,29,698
4700,경상북도,예천군나선거구,6471202,4712,예천군,보문면,계,1450,983,525,291,106,922,61,467
4700,경상북도,예천군나선거구,6471202,4712,예천군,보문면,관내사전투표,417,417,245,120,33,398,19,0
4700,경상북도,예천군나선거구,6471202,4712,예천군,보문면,선거일투표,1033,566,280,171,73,524,42,467
4700,경상북도,예천군나선거구,6471202,4712,예천군,유천면,계,2122,1332,348,279,620,1247,85,790
4700,경상북도,예천군나선거구,6471202,4712,예천군,유천면,관내사전투표,556,556,155,119,242,516,40,0
4700,경상북도,예천군나선거구,6471202,4712,예천군,유천면,선거일투표,1566,776,193,160,378,731,45,790
4700,경상북도,예천군나선거구,6471202,4712,예천군,잘못 투입·구분된 투표지,,0,9,2,1,1,4,5,-9
4700,경상북도,예천군다선거구,6471203,4712,예천군,합계,,14566,7795,2241,1690,1621,1319,727,7598,197,6771
4700,경상북도,예천군다선거구,6471203,4712,예천군,거소투표,,17,15,5,6,2,2,0,15,0,2
4700,경상북도,예천군다선거구,6471203,4712,예천군,관외사전투표,,1462,1462,455,341,312,196,115,1419,43,0
4700,경상북도,예천군다선거구,6471203,4712,예천군,호명면,계,13087,6312,1779,1343,1306,1120,610,6158,154,6775
4700,경상북도,예천군다선거구,6471203,4712,예천군,호명면,관내사전투표,2421,2415,719,471,492,488,197,2367,48,6
4700,경상북도,예천군다선거구,6471203,4712,예천군,호명면,선거일투표,10666,3897,1060,872,814,632,413,3791,106,6769
4700,경상북도,예천군다선거구,6471203,4712,예천군,잘못 투입·구분된 투표지,,0,6,2,0,1,1,2,6,0,-6
4700,경상북도,예천군라선거구,6471204,4712,예천군,검색된 결과가 없습니다.
4700,경상북도,경산시가선거구,6471301,4713,경산시,합계,,52316,23557,3446,7008,4428,4040,1158,2648,22728,829,28759
4700,경상북도,경산시가선거구,6471301,4713,경산시,거소투표,,56,53,11,11,14,8,1,6,51,2,3
4700,경상북도,경산시가선거구,6471301,4713,경산시,관외사전투표,,2918,2918,599,843,581,391,147,269,2830,88,0
4700,경상북도,경산시가선거구,6471301,4713,경산시,남산면,계,3273,1644,141,649,353,129,44,235,1551,93,1629
4700,경상북도,경산시가선거구,6471301,4713,경산시,남산면,관내사전투표,486,486,47,186,110,40,7,63,453,33,0
4700,경상북도,경산시가선거구,6471301,4713,경산시,남산면,선거일투표,2787,1158,94,463,243,89,37,172,1098,60,1629
4700,경상북도,경산시가선거구,6471301,4713,경산시,남천면,계,2671,1562,93,385,286,98,30,613,1505,57,1109
4700,경상북도,경산시가선거구,6471301,4713,경산시,남천면,관내사전투표,562,562,44,150,89,49,11,202,545,17,0
4700,경상북도,경산시가선거구,6471301,4713,경산시,남천면,선거일투표,2109,1000,49,235,197,49,19,411,960,40,1109
4700,경상북도,경산시가선거구,6471301,4713,경산시,서부1동,계,27198,10563,1587,3080,1931,2312,609,710,10229,334,16635
4700,경상북도,경산시가선거구,6471301,4713,경산시,서부1동,관내사전투표,2035,2035,286,629,366,454,119,115,1969,66,0
4700,경상북도,경산시가선거구,6471301,4713,경산시,서부1동,선거일투표,25163,8528,1301,2451,1565,1858,490,595,8260,268,16635
4700,경상북도,경산시가선거구,6471301,4713,경산시,남부동,계,16200,6814,1015,2038,1263,1102,327,814,6559,255,9386
4700,경상북도,경산시가선거구,6471301,4713,경산시,남부동,관내사전투표,1810,1810,296,526,343,284,105,199,1753,57,0
4700,경상북도,경산시가선거구,6471301,4713,경산시,남부동,선거일투표,14390,5004,719,1512,920,818,222,615,4806,198,9386
4700,경상북도,경산시가선거구,6471301,4713,경산시,잘못 투입·구분된 투표지,,0,3,0,2,0,0,0,1,3,0,-3
4700,경상북도,경산시나선거구,6471302,4713,경산시,합계,,30905,12919,2034,6970,2450,781,12235,684,17986
4700,경상북도,경산시나선거구,6471302,4713,경산시,거소투표,,37,35,7,15,8,1,31,4,2
4700,경상북도,경산시나선거구,6471302,4713,경산시,관외사전투표,,1310,1310,288,675,230,76,1269,41,0
4700,경상북도,경산시나선거구,6471302,4713,경산시,진량읍,계,29558,11564,1739,6278,2210,704,10931,633,17994
4700,경상북도,경산시나선거구,6471302,4713,경산시,진량읍,관내사전투표,2849,2849,497,1501,597,175,2770,79,0
4700,경상북도,경산시나선거구,6471302,4713,경산시,진량읍,선거일투표,26709,8715,1242,4777,1613,529,8161,554,17994
4700,경상북도,경산시나선거구,6471302,4713,경산시,잘못 투입·구분된 투표지,,0,10,0,2,2,0,4,6,-10
4700,경상북도,경산시다선거구,6471303,4713,경산시,합계,,29613,13627,2058,5335,2677,2837,12907,720,15986
4700,경상북도,경산시다선거구,6471303,4713,경산시,거소투표,,40,36,3,13,12,6,34,2,4
4700,경상북도,경산시다선거구,6471303,4713,경산시,관외사전투표,,1211,1210,270,488,242,167,1167,43,1
4700,경상북도,경산시다선거구,6471303,4713,경산시,하양읍,계,23099,9722,1353,3852,2001,2018,9224,498,13377
4700,경상북도,경산시다선거구,6471303,4713,경산시,하양읍,관내사전투표,2501,2498,394,958,540,552,2444,54,3
4700,경상북도,경산시다선거구,6471303,4713,경산시,하양읍,선거일투표,20598,7224,959,2894,1461,1466,6780,444,13374
4700,경상북도,경산시다선거구,6471303,4713,경산시,와촌면,계,5263,2650,432,977,422,644,2475,175,2613
4700,경상북도,경산시다선거구,6471303,4713,경산시,와촌면,관내사전투표,890,890,142,327,150,196,815,75,0
4700,경상북도,경산시다선거구,6471303,4713,경산시,와촌면,선거일투표,4373,1760,290,650,272,448,1660,100,2613
4700,경상북도,경산시다선거구,6471303,4713,경산시,잘못 투입·구분된 투표지,,0,9,0,5,0,2,7,2,-9
4700,경상북도,경산시라선거구,6471304,4713,경산시,합계,,59342,24846,4345,10647,2497,4697,1776,23962,884,34496
4700,경상북도,경산시라선거구,6471304,4713,경산시,거소투표,,73,65,12,24,8,10,7,61,4,8
4700,경상북도,경산시라선거구,6471304,4713,경산시,관외사전투표,,3159,3154,732,1348,329,419,200,3028,126,5
4700,경상북도,경산시라선거구,6471304,4713,경산시,중앙동,계,5786,2512,355,1120,316,462,155,2408,104,3274
4700,경상북도,경산시라선거구,6471304,4713,경산시,중앙동,관내사전투표,814,811,136,306,138,154,44,778,33,3
4700,경상북도,경산시라선거구,6471304,4713,경산시,중앙동,선거일투표,4972,1701,219,814,178,308,111,1630,71,3271
4700,경상북도,경산시라선거구,6471304,4713,경산시,서부2동,계,27871,10960,1924,4714,994,2038,935,10605,355,16911
4700,경상북도,경산시라선거구,6471304,4713,경산시,서부2동,관내사전투표,2213,2209,394,894,188,468,198,2142,67,4
4700,경상북도,경산시라선거구,6471304,4713,경산시,서부2동,선거일투표,25658,8751,1530,3820,806,1570,737,8463,288,16907
4700,경상북도,경산시라선거구,6471304,4713,경산시,북부동,계,13865,4145,752,2011,322,682,236,4003,142,9720
4700,경상북도,경산시라선거구,6471304,4713,경산시,북부동,관내사전투표,872,872,192,397,73,142,50,854,18,0
4700,경상북도,경산시라선거구,6471304,4713,경산시,북부동,선거일투표,12993,3273,560,1614,249,540,186,3149,124,9720
4700,경상북도,경산시라선거구,6471304,4713,경산시,중방동,계,8588,3994,567,1424,526,1082,243,3842,152,4594
4700,경상북도,경산시라선거구,6471304,4713,경산시,중방동,관내사전투표,1468,1468,245,484,199,415,94,1437,31,0
4700,경상북도,경산시라선거구,6471304,4713,경산시,중방동,선거일투표,7120,2526,322,940,327,667,149,2405,121,4594
4700,경상북도,경산시라선거구,6471304,4713,경산시,잘못 투입·구분된 투표지,,0,16,3,6,2,4,0,15,1,-16
4700,경상북도,경산시마선거구,6471305,4713,경산시,합계,,58500,25102,3343,7992,5297,3031,3063,1614,24340,762,33398
4700,경상북도,경산시마선거구,6471305,4713,경산시,거소투표,,96,88,26,21,11,9,8,7,82,6,8
4700,경상북도,경산시마선거구,6471305,4713,경산시,관외사전투표,,2627,2627,567,971,380,298,190,123,2529,98,0
4700,경상북도,경산시마선거구,6471305,4713,경산시,압량읍,계,16886,6137,851,1760,2450,361,363,173,5958,179,10749
4700,경상북도,경산시마선거구,6471305,4713,경산시,압량읍,관내사전투표,1814,1813,241,476,781,109,105,47,1759,54,1
4700,경상북도,경산시마선거구,6471305,4713,경산시,압량읍,선거일투표,15072,4324,610,1284,1669,252,258,126,4199,125,10748
4700,경상북도,경산시마선거구,6471305,4713,경산시,자인면,계,5100,2704,147,854,395,277,293,633,2599,105,2396
4700,경상북도,경산시마선거구,6471305,4713,경산시,자인면,관내사전투표,1149,1149,74,362,152,140,121,253,1102,47,0
4700,경상북도,경산시마선거구,6471305,4713,경산시,자인면,선거일투표,3951,1555,73,492,243,137,172,380,1497,58,2396
4700,경상북도,경산시마선거구,6471305,4713,경산시,용성면,계,2952,1731,113,385,160,137,811,58,1664,67,1221
4700,경상북도,경산시마선거구,6471305,4713,경산시,용성면,관내사전투표,685,685,56,164,67,72,273,21,653,32,0
4700,경상북도,경산시마선거구,6471305,4713,경산시,용성면,선거일투표,2267,1046,57,221,93,65,538,37,1011,35,1221
4700,경상북도,경산시마선거구,6471305,4713,경산시,동부동,계,30839,11813,1639,4000,1900,1949,1398,620,11506,307,19026
4700,경상북도,경산시마선거구,6471305,4713,경산시,동부동,관내사전투표,2545,2545,367,819,450,442,300,114,2492,53,0
4700,경상북도,경산시마선거구,6471305,4713,경산시,동부동,선거일투표,28294,9268,1272,3181,1450,1507,1098,506,9014,254,19026
4700,경상북도,경산시마선거구,6471305,4713,경산시,잘못 투입·구분된 투표지,,0,2,0,1,1,0,0,0,2,0,-2
4700,경상북도,청도군가선거구,6471401,4714,청도군,합계,,19269,13643,1962,4081,2568,2076,2338,13025,618,5626
4700,경상북도,청도군가선거구,6471401,4714,청도군,거소투표,,69,66,14,23,9,9,7,62,4,3
4700,경상북도,청도군가선거구,6471401,4714,청도군,관외사전투표,,1313,1308,247,438,213,218,155,1271,37,5
4700,경상북도,청도군가선거구,6471401,4714,청도군,청도읍,계,9981,6730,755,2243,1609,1284,546,6437,293,3251
4700,경상북도,청도군가선거구,6471401,4714,청도군,청도읍,관내사전투표,2523,2522,280,761,664,512,193,2410,112,1
4700,경상북도,청도군가선거구,6471401,4714,청도군,청도읍,선거일투표,7458,4208,475,1482,945,772,353,4027,181,3250
4700,경상북도,청도군가선거구,6471401,4714,청도군,운문면,계,1792,1251,103,351,135,125,468,1182,69,541
4700,경상북도,청도군가선거구,6471401,4714,청도군,운문면,관내사전투표,416,416,32,87,46,38,194,397,19,0
4700,경상북도,청도군가선거구,6471401,4714,청도군,운문면,선거일투표,1376,835,71,264,89,87,274,785,50,541
4700,경상북도,청도군가선거구,6471401,4714,청도군,금천면,계,2936,2097,225,437,392,176,770,2000,97,839
4700,경상북도,청도군가선거구,6471401,4714,청도군,금천면,관내사전투표,989,988,103,207,189,80,350,929,59,1
4700,경상북도,청도군가선거구,6471401,4714,청도군,금천면,선거일투표,1947,1109,122,230,203,96,420,1071,38,838
4700,경상북도,청도군가선거구,6471401,4714,청도군,매전면,계,3178,2183,615,586,210,263,392,2066,117,995
4700,경상북도,청도군가선거구,6471401,4714,청도군,매전면,관내사전투표,746,746,209,202,91,95,119,716,30,0
4700,경상북도,청도군가선거구,6471401,4714,청도군,매전면,선거일투표,2432,1437,406,384,119,168,273,1350,87,995
4700,경상북도,청도군가선거구,6471401,4714,청도군,잘못 투입·구분된 투표지,,0,8,3,3,0,1,0,7,1,-8
4700,경상북도,청도군나선거구,6471402,4714,청도군,합계,,19305,13669,3880,3233,2725,2056,1031,12925,744,5636
4700,경상북도,청도군나선거구,6471402,4714,청도군,거소투표,,110,95,39,9,33,7,5,93,2,15
4700,경상북도,청도군나선거구,6471402,4714,청도군,관외사전투표,,1869,1865,615,437,306,266,162,1786,79,4
4700,경상북도,청도군나선거구,6471402,4714,청도군,화양읍,계,6161,3997,1070,1471,429,557,262,3789,208,2164
4700,경상북도,청도군나선거구,6471402,4714,청도군,화양읍,관내사전투표,1256,1256,314,463,140,189,73,1179,77,0
4700,경상북도,청도군나선거구,6471402,4714,청도군,화양읍,선거일투표,4905,2741,756,1008,289,368,189,2610,131,2164
4700,경상북도,청도군나선거구,6471402,4714,청도군,각남면,계,1884,1388,526,270,197,184,130,1307,81,496
4700,경상북도,청도군나선거구,6471402,4714,청도군,각남면,관내사전투표,752,749,306,132,96,107,62,703,46,3
4700,경상북도,청도군나선거구,6471402,4714,청도군,각남면,선거일투표,1132,639,220,138,101,77,68,604,35,493
4700,경상북도,청도군나선거구,6471402,4714,청도군,풍각면,계,3590,2488,615,415,851,239,228,2348,140,1102
4700,경상북도,청도군나선거구,6471402,4714,청도군,풍각면,관내사전투표,1186,1184,301,203,378,119,109,1110,74,2
4700,경상북도,청도군나선거구,6471402,4714,청도군,풍각면,선거일투표,2404,1304,314,212,473,120,119,1238,66,1100
4700,경상북도,청도군나선거구,6471402,4714,청도군,각북면,계,1899,1282,256,181,575,125,73,1210,72,617
4700,경상북도,청도군나선거구,6471402,4714,청도군,각북면,관내사전투표,728,725,147,95,322,79,39,682,43,3
4700,경상북도,청도군나선거구,6471402,4714,청도군,각북면,선거일투표,1171,557,109,86,253,46,34,528,29,614
4700,경상북도,청도군나선거구,6471402,4714,청도군,이서면,계,3792,2541,757,444,333,675,170,2379,162,1251
4700,경상북도,청도군나선거구,6471402,4714,청도군,이서면,관내사전투표,1148,1144,360,179,143,299,90,1071,73,4
4700,경상북도,청도군나선거구,6471402,4714,청도군,이서면,선거일투표,2644,1397,397,265,190,376,80,1308,89,1247
4700,경상북도,청도군나선거구,6471402,4714,청도군,잘못 투입·구분된 투표지,,0,13,2,6,1,3,1,13,0,-13
4700,경상북도,고령군가선거구,6471501,4715,고령군,합계,,11722,7507,2465,2744,2024,7233,274,4215
4700,경상북도,고령군가선거구,6471501,4715,고령군,거소투표,,22,21,7,4,6,17,4,1
4700,경상북도,고령군가선거구,6471501,4715,고령군,관외사전투표,,619,619,243,231,118,592,27,0
4700,경상북도,고령군가선거구,6471501,4715,고령군,대가야읍,계,8176,4977,1631,1734,1440,4805,172,3199
4700,경상북도,고령군가선거구,6471501,4715,고령군,대가야읍,관내사전투표,2279,2276,709,794,692,2195,81,3
4700,경상북도,고령군가선거구,6471501,4715,고령군,대가야읍,선거일투표,5897,2701,922,940,748,2610,91,3196
4700,경상북도,고령군가선거구,6471501,4715,고령군,덕곡면,계,1262,829,183,368,248,799,30,433
4700,경상북도,고령군가선거구,6471501,4715,고령군,덕곡면,관내사전투표,269,269,63,109,82,254,15,0
4700,경상북도,고령군가선거구,6471501,4715,고령군,덕곡면,선거일투표,993,560,120,259,166,545,15,433
4700,경상북도,고령군가선거구,6471501,4715,고령군,운수면,계,1643,1057,399,405,212,1016,41,586
4700,경상북도,고령군가선거구,6471501,4715,고령군,운수면,관내사전투표,384,383,136,145,79,360,23,1
4700,경상북도,고령군가선거구,6471501,4715,고령군,운수면,선거일투표,1259,674,263,260,133,656,18,585
4700,경상북도,고령군가선거구,6471501,4715,고령군,잘못 투입·구분된 투표지,,0,4,2,2,0,4,0,-4
4700,경상북도,고령군나선거구,6471502,4715,고령군,합계,,9662,5607,942,2186,1526,244,346,227,5471,136,4055
4700,경상북도,고령군나선거구,6471502,4715,고령군,거소투표,,13,13,0,4,4,1,4,0,13,0,0
4700,경상북도,고령군나선거구,6471502,4715,고령군,관외사전투표,,513,513,91,250,120,11,18,13,503,10,0
4700,경상북도,고령군나선거구,6471502,4715,고령군,성산면,계,2224,1305,92,265,841,27,28,18,1271,34,919
4700,경상북도,고령군나선거구,6471502,4715,고령군,성산면,관내사전투표,488,488,35,103,318,9,6,4,475,13,0
4700,경상북도,고령군나선거구,6471502,4715,고령군,성산면,선거일투표,1736,817,57,162,523,18,22,14,796,21,919
4700,경상북도,고령군나선거구,6471502,4715,고령군,다산면,계,6912,3776,759,1667,561,205,296,196,3684,92,3136
4700,경상북도,고령군나선거구,6471502,4715,고령군,다산면,관내사전투표,1539,1539,330,682,205,86,122,79,1504,35,0
4700,경상북도,고령군나선거구,6471502,4715,고령군,다산면,선거일투표,5373,2237,429,985,356,119,174,117,2180,57,3136
4700,경상북도,고령군나선거구,6471502,4715,고령군,잘못 투입·구분된 투표지,,0,0,0,0,0,0,0,0,0,0,0
4700,경상북도,고령군다선거구,6471503,4715,고령군,합계,,6373,4308,1147,1376,1199,424,4146,162,2065
4700,경상북도,고령군다선거구,6471503,4715,고령군,거소투표,,76,72,20,21,6,5,52,20,4
4700,경상북도,고령군다선거구,6471503,4715,고령군,관외사전투표,,480,480,162,145,124,34,465,15,0
4700,경상북도,고령군다선거구,6471503,4715,고령군,개진면,계,1662,1014,179,650,106,52,987,27,648
4700,경상북도,고령군다선거구,6471503,4715,고령군,개진면,관내사전투표,310,310,61,177,42,13,293,17,0
4700,경상북도,고령군다선거구,6471503,4715,고령군,개진면,선거일투표,1352,704,118,473,64,39,694,10,648
4700,경상북도,고령군다선거구,6471503,4715,고령군,우곡면,계,1321,890,509,252,69,31,861,29,431
4700,경상북도,고령군다선거구,6471503,4715,고령군,우곡면,관내사전투표,278,278,148,77,25,12,262,16,0
4700,경상북도,고령군다선거구,6471503,4715,고령군,우곡면,선거일투표,1043,612,361,175,44,19,599,13,431
4700,경상북도,고령군다선거구,6471503,4715,고령군,쌍림면,계,2834,1851,277,308,894,302,1781,70,983
4700,경상북도,고령군다선거구,6471503,4715,고령군,쌍림면,관내사전투표,522,522,84,84,258,60,486,36,0
4700,경상북도,고령군다선거구,6471503,4715,고령군,쌍림면,선거일투표,2312,1329,193,224,636,242,1295,34,983
4700,경상북도,고령군다선거구,6471503,4715,고령군,잘못 투입·구분된 투표지,,0,1,0,0,0,0,0,1,-1
4700,경상북도,성주군가선거구,6471601,4716,성주군,합계,,20544,13216,1205,3631,2430,3054,908,654,841,12723,493,7328
4700,경상북도,성주군가선거구,6471601,4716,성주군,거소투표,,86,79,8,25,20,10,3,4,4,74,5,7
4700,경상북도,성주군가선거구,6471601,4716,성주군,관외사전투표,,1318,1317,189,425,202,281,81,39,61,1278,39,1
4700,경상북도,성주군가선거구,6471601,4716,성주군,성주읍,계,10804,6649,699,2038,599,1838,289,436,508,6407,242,4155
4700,경상북도,성주군가선거구,6471601,4716,성주군,성주읍,관내사전투표,2985,2985,360,944,271,799,121,177,217,2889,96,0
4700,경상북도,성주군가선거구,6471601,4716,성주군,성주읍,선거일투표,7819,3664,339,1094,328,1039,168,259,291,3518,146,4155
4700,경상북도,성주군가선거구,6471601,4716,성주군,선남면,계,5408,3318,189,606,1409,325,421,63,182,3195,123,2090
4700,경상북도,성주군가선거구,6471601,4716,성주군,선남면,관내사전투표,1629,1629,93,278,714,167,180,28,93,1553,76,0
4700,경상북도,성주군가선거구,6471601,4716,성주군,선남면,선거일투표,3779,1689,96,328,695,158,241,35,89,1642,47,2090
4700,경상북도,성주군가선거구,6471601,4716,성주군,월항면,계,2928,1853,120,537,200,600,114,112,86,1769,84,1075
4700,경상북도,성주군가선거구,6471601,4716,성주군,월항면,관내사전투표,846,846,52,252,89,273,50,52,42,810,36,0
4700,경상북도,성주군가선거구,6471601,4716,성주군,월항면,선거일투표,2082,1007,68,285,111,327,64,60,44,959,48,1075
4700,경상북도,성주군가선거구,6471601,4716,성주군,잘못 투입·구분된 투표지,,0,0,0,0,0,0,0,0,0,0,0,0
4700,경상북도,성주군나선거구,6471602,4716,성주군,합계,,8849,6593,1647,2099,1352,1148,6246,347,2256
4700,경상북도,성주군나선거구,6471602,4716,성주군,거소투표,,83,72,6,17,23,23,69,3,11
4700,경상북도,성주군나선거구,6471602,4716,성주군,관외사전투표,,952,952,262,293,186,167,908,44,0
4700,경상북도,성주군나선거구,6471602,4716,성주군,용암면,계,3187,2187,251,1483,252,95,2081,106,1000
4700,경상북도,성주군나선거구,6471602,4716,성주군,용암면,관내사전투표,1215,1214,144,835,119,60,1158,56,1
4700,경상북도,성주군나선거구,6471602,4716,성주군,용암면,선거일투표,1972,973,107,648,133,35,923,50,999
4700,경상북도,성주군나선거구,6471602,4716,성주군,수륜면,계,2600,1860,813,142,142,672,1769,91,740
4700,경상북도,성주군나선거구,6471602,4716,성주군,수륜면,관내사전투표,1107,1106,481,90,80,409,1060,46,1
4700,경상북도,성주군나선거구,6471602,4716,성주군,수륜면,선거일투표,1493,754,332,52,62,263,709,45,739
4700,경상북도,성주군나선거구,6471602,4716,성주군,대가면,계,2027,1520,315,163,749,190,1417,103,507
4700,경상북도,성주군나선거구,6471602,4716,성주군,대가면,관내사전투표,789,789,176,88,377,84,725,64,0
4700,경상북도,성주군나선거구,6471602,4716,성주군,대가면,선거일투표,1238,731,139,75,372,106,692,39,507
4700,경상북도,성주군나선거구,6471602,4716,성주군,잘못 투입·구분된 투표지,,0,2,0,1,0,1,2,0,-2
4700,경상북도,성주군다선거구,6471603,4716,성주군,합계,,10058,6825,2260,2074,2117,6451,374,3233
4700,경상북도,성주군다선거구,6471603,4716,성주군,거소투표,,65,55,16,15,11,42,13,10
4700,경상북도,성주군다선거구,6471603,4716,성주군,관외사전투표,,709,707,267,226,189,682,25,2
4700,경상북도,성주군다선거구,6471603,4716,성주군,가천면,계,1755,1135,354,373,335,1062,73,620
4700,경상북도,성주군다선거구,6471603,4716,성주군,가천면,관내사전투표,667,666,206,208,198,612,54,1
4700,경상북도,성주군다선거구,6471603,4716,성주군,가천면,선거일투표,1088,469,148,165,137,450,19,619
4700,경상북도,성주군다선거구,6471603,4716,성주군,금수면,계,970,632,225,219,156,600,32,338
4700,경상북도,성주군다선거구,6471603,4716,성주군,금수면,관내사전투표,345,345,122,126,81,329,16,0
4700,경상북도,성주군다선거구,6471603,4716,성주군,금수면,선거일투표,625,287,103,93,75,271,16,338
4700,경상북도,성주군다선거구,6471603,4716,성주군,벽진면,계,2696,1815,432,184,1110,1726,89,881
4700,경상북도,성주군다선거구,6471603,4716,성주군,벽진면,관내사전투표,984,983,231,84,609,924,59,1
4700,경상북도,성주군다선거구,6471603,4716,성주군,벽진면,선거일투표,1712,832,201,100,501,802,30,880
4700,경상북도,성주군다선거구,6471603,4716,성주군,초전면,계,3863,2478,966,1056,315,2337,141,1385
4700,경상북도,성주군다선거구,6471603,4716,성주군,초전면,관내사전투표,1195,1195,480,506,147,1133,62,0
4700,경상북도,성주군다선거구,6471603,4716,성주군,초전면,선거일투표,2668,1283,486,550,168,1204,79,1385
4700,경상북도,성주군다선거구,6471603,4716,성주군,잘못 투입·구분된 투표지,,0,3,0,1,1,2,1,-3
4700,경상북도,칠곡군가선거구,6471701,4717,칠곡군,검색된 결과가 없습니다.
4700,경상북도,칠곡군나선거구,6471702,4717,칠곡군,합계,,12249,6770,2398,2375,1595,6368,402,5479
4700,경상북도,칠곡군나선거구,6471702,4717,칠곡군,거소투표,,39,34,17,9,7,33,1,5
4700,경상북도,칠곡군나선거구,6471702,4717,칠곡군,관외사전투표,,656,654,255,230,139,624,30,2
4700,경상북도,칠곡군나선거구,6471702,4717,칠곡군,지천면,계,3691,1984,1242,430,189,1861,123,1707
4700,경상북도,칠곡군나선거구,6471702,4717,칠곡군,지천면,관내사전투표,820,820,543,137,89,769,51,0
4700,경상북도,칠곡군나선거구,6471702,4717,칠곡군,지천면,선거일투표,2871,1164,699,293,100,1092,72,1707
4700,경상북도,칠곡군나선거구,6471702,4717,칠곡군,동명면,계,4878,2603,383,1137,926,2446,157,2275
4700,경상북도,칠곡군나선거구,6471702,4717,칠곡군,동명면,관내사전투표,1018,1016,129,453,391,973,43,2
4700,경상북도,칠곡군나선거구,6471702,4717,칠곡군,동명면,선거일투표,3860,1587,254,684,535,1473,114,2273
4700,경상북도,칠곡군나선거구,6471702,4717,칠곡군,가산면,계,2985,1493,500,568,334,1402,91,1492
4700,경상북도,칠곡군나선거구,6471702,4717,칠곡군,가산면,관내사전투표,516,516,181,211,102,494,22,0
4700,경상북도,칠곡군나선거구,6471702,4717,칠곡군,가산면,선거일투표,2469,977,319,357,232,908,69,1492
4700,경상북도,칠곡군나선거구,6471702,4717,칠곡군,잘못 투입·구분된 투표지,,0,2,1,1,0,2,0,-2
4700,경상북도,칠곡군다선거구,6471703,4717,칠곡군,합계,,31757,15078,3159,4700,3269,1460,1812,258,14658,420,16679
4700,경상북도,칠곡군다선거구,6471703,4717,칠곡군,거소투표,,48,44,10,8,12,4,4,2,40,4,4
4700,경상북도,칠곡군다선거구,6471703,4717,칠곡군,관외사전투표,,1225,1225,341,392,240,108,80,25,1186,39,0
4700,경상북도,칠곡군다선거구,6471703,4717,칠곡군,북삼읍,계,19422,8270,1997,2801,886,908,1399,109,8100,170,11152
4700,경상북도,칠곡군다선거구,6471703,4717,칠곡군,북삼읍,관내사전투표,2979,2978,751,984,325,346,488,30,2924,54,1
4700,경상북도,칠곡군다선거구,6471703,4717,칠곡군,북삼읍,선거일투표,16443,5292,1246,1817,561,562,911,79,5176,116,11151
4700,경상북도,칠곡군다선거구,6471703,4717,칠곡군,약목면,계,8357,4093,554,1044,1747,315,243,59,3962,131,4264
4700,경상북도,칠곡군다선거구,6471703,4717,칠곡군,약목면,관내사전투표,1578,1578,216,386,714,110,91,13,1530,48,0
4700,경상북도,칠곡군다선거구,6471703,4717,칠곡군,약목면,선거일투표,6779,2515,338,658,1033,205,152,46,2432,83,4264
4700,경상북도,칠곡군다선거구,6471703,4717,칠곡군,기산면,계,2705,1446,257,455,384,125,86,63,1370,76,1259
4700,경상북도,칠곡군다선거구,6471703,4717,칠곡군,기산면,관내사전투표,546,546,98,177,145,44,35,19,518,28,0
4700,경상북도,칠곡군다선거구,6471703,4717,칠곡군,기산면,선거일투표,2159,900,159,278,239,81,51,44,852,48,1259
4700,경상북도,칠곡군다선거구,6471703,4717,칠곡군,잘못 투입·구분된 투표지,,0,0,0,0,0,0,0,0,0,0,0
4700,경상북도,칠곡군라선거구,6471704,4717,칠곡군,검색된 결과가 없습니다.
4700,경상북도,군위군가선거구,6471801,4718,군위군,합계,,13383,10653,2107,1805,1710,1861,2347,335,10165,488,2730
4700,경상북도,군위군가선거구,6471801,4718,군위군,거소투표,,71,62,7,6,10,11,26,1,61,1,9
4700,경상북도,군위군가선거구,6471801,4718,군위군,관외사전투표,,1365,1364,315,214,213,252,266,49,1309,55,1
4700,경상북도,군위군가선거구,6471801,4718,군위군,군위읍,계,6901,5343,1296,961,583,671,1471,134,5116,227,1558
4700,경상북도,군위군가선거구,6471801,4718,군위군,군위읍,관내사전투표,3433,3432,778,597,381,453,984,88,3281,151,1
4700,경상북도,군위군가선거구,6471801,4718,군위군,군위읍,선거일투표,3468,1911,518,364,202,218,487,46,1835,76,1557
4700,경상북도,군위군가선거구,6471801,4718,군위군,소보면,계,1920,1474,156,201,558,145,314,28,1402,72,446
4700,경상북도,군위군가선거구,6471801,4718,군위군,소보면,관내사전투표,891,891,99,111,323,101,198,13,845,46,0
4700,경상북도,군위군가선거구,6471801,4718,군위군,소보면,선거일투표,1029,583,57,90,235,44,116,15,557,26,446
4700,경상북도,군위군가선거구,6471801,4718,군위군,효령면,계,3126,2410,333,423,346,782,270,123,2277,133,716
4700,경상북도,군위군가선거구,6471801,4718,군위군,효령면,관내사전투표,1456,1456,178,251,198,508,152,82,1369,87,0
4700,경상북도,군위군가선거구,6471801,4718,군위군,효령면,선거일투표,1670,954,155,172,148,274,118,41,908,46,716
4700,경상북도,군위군가선거구,6471801,4718,군위군,잘못 투입·구분된 투표지,,0,0,0,0,0,0,0,0,0,0,0
4700,경상북도,군위군나선거구,6471802,4718,군위군,합계,,8671,7194,1160,1529,1401,787,642,443,894,6856,338,1477
4700,경상북도,군위군나선거구,6471802,4718,군위군,거소투표,,174,157,24,21,30,31,14,1,9,130,27,17
4700,경상북도,군위군나선거구,6471802,4718,군위군,관외사전투표,,1006,1006,214,231,192,73,93,47,110,960,46,0
4700,경상북도,군위군나선거구,6471802,4718,군위군,부계면,계,1799,1397,139,198,174,77,53,316,397,1354,43,402
4700,경상북도,군위군나선거구,6471802,4718,군위군,부계면,관내사전투표,642,642,70,86,78,29,32,143,180,618,24,0
4700,경상북도,군위군나선거구,6471802,4718,군위군,부계면,선거일투표,1157,755,69,112,96,48,21,173,217,736,19,402
4700,경상북도,군위군나선거구,6471802,4718,군위군,우보면,계,1611,1294,140,173,647,68,75,32,97,1232,62,317
4700,경상북도,군위군나선거구,6471802,4718,군위군,우보면,관내사전투표,784,784,79,91,405,45,44,21,54,739,45,0
4700,경상북도,군위군나선거구,6471802,4718,군위군,우보면,선거일투표,827,510,61,82,242,23,31,11,43,493,17,317
4700,경상북도,군위군나선거구,6471802,4718,군위군,의흥면,계,1978,1627,473,267,150,268,241,18,129,1546,81,351
4700,경상북도,군위군나선거구,6471802,4718,군위군,의흥면,관내사전투표,976,975,275,146,104,140,163,10,81,919,56,1
4700,경상북도,군위군나선거구,6471802,4718,군위군,의흥면,선거일투표,1002,652,198,121,46,128,78,8,48,627,25,350
4700,경상북도,군위군나선거구,6471802,4718,군위군,산성면,계,1052,857,115,265,150,52,137,17,75,811,46,195
4700,경상북도,군위군나선거구,6471802,4718,군위군,산성면,관내사전투표,524,524,83,150,90,34,80,8,43,488,36,0
4700,경상북도,군위군나선거구,6471802,4718,군위군,산성면,선거일투표,528,333,32,115,60,18,57,9,32,323,10,195
4700,경상북도,군위군나선거구,6471802,4718,군위군,삼국유사면,계,1051,856,55,374,58,218,29,12,77,823,33,195
4700,경상북도,군위군나선거구,6471802,4718,군위군,삼국유사면,관내사전투표,409,409,26,188,27,94,11,9,29,384,25,0
4700,경상북도,군위군나선거구,6471802,4718,군위군,삼국유사면,선거일투표,642,447,29,186,31,124,18,3,48,439,8,195
4700,경상북도,군위군나선거구,6471802,4718,군위군,잘못 투입·구분된 투표지,,0,0,0,0,0,0,0,0,0,0,0,0
4700,경상북도,의성군가선거구,6471901,4719,의성군,합계,,14592,10270,1239,2098,1808,1500,1218,840,1181,9884,386,4322
4700,경상북도,의성군가선거구,6471901,4719,의성군,거소투표,,104,88,4,19,23,12,13,8,2,81,7,16
4700,경상북도,의성군가선거구,6471901,4719,의성군,관외사전투표,,957,956,224,254,128,153,39,62,70,930,26,1
4700,경상북도,의성군가선거구,6471901,4719,의성군,의성읍,계,10513,6986,794,1371,1163,947,887,652,930,6744,242,3527
4700,경상북도,의성군가선거구,6471901,4719,의성군,의성읍,관내사전투표,3360,3360,382,690,618,449,330,315,450,3234,126,0
4700,경상북도,의성군가선거구,6471901,4719,의성군,의성읍,선거일투표,7153,3626,412,681,545,498,557,337,480,3510,116,3527
4700,경상북도,의성군가선거구,6471901,4719,의성군,점곡면,계,1457,1070,108,260,203,165,88,73,117,1014,56,387
4700,경상북도,의성군가선거구,6471901,4719,의성군,점곡면,관내사전투표,589,589,58,136,127,93,41,32,63,550,39,0
4700,경상북도,의성군가선거구,6471901,4719,의성군,점곡면,선거일투표,868,481,50,124,76,72,47,41,54,464,17,387
4700,경상북도,의성군가선거구,6471901,4719,의성군,옥산면,계,1561,1169,109,194,291,222,191,45,62,1114,55,392
4700,경상북도,의성군가선거구,6471901,4719,의성군,옥산면,관내사전투표,601,601,55,96,147,110,91,28,39,566,35,0
4700,경상북도,의성군가선거구,6471901,4719,의성군,옥산면,선거일투표,960,568,54,98,144,112,100,17,23,548,20,392
4700,경상북도,의성군가선거구,6471901,4719,의성군,잘못 투입·구분된 투표지,,0,1,0,0,0,1,0,0,0,1,0,-1
4700,경상북도,의성군나선거구,6471902,4719,의성군,합계,,8274,6096,1692,2408,1658,5758,338,2178
4700,경상북도,의성군나선거구,6471902,4719,의성군,거소투표,,158,139,34,70,22,126,13,19
4700,경상북도,의성군나선거구,6471902,4719,의성군,관외사전투표,,443,442,140,179,100,419,23,1
4700,경상북도,의성군나선거구,6471902,4719,의성군,사곡면,계,1368,1014,204,491,227,922,92,354
4700,경상북도,의성군나선거구,6471902,4719,의성군,사곡면,관내사전투표,554,553,108,262,114,484,69,1
4700,경상북도,의성군나선거구,6471902,4719,의성군,사곡면,선거일투표,814,461,96,229,113,438,23,353
4700,경상북도,의성군나선거구,6471902,4719,의성군,춘산면,계,1200,938,193,468,231,892,46,262
4700,경상북도,의성군나선거구,6471902,4719,의성군,춘산면,관내사전투표,555,555,123,271,134,528,27,0
4700,경상북도,의성군나선거구,6471902,4719,의성군,춘산면,선거일투표,645,383,70,197,97,364,19,262
4700,경상북도,의성군나선거구,6471902,4719,의성군,가음면,계,1367,1055,167,574,268,1009,46,312
4700,경상북도,의성군나선거구,6471902,4719,의성군,가음면,관내사전투표,632,631,115,338,152,605,26,1
4700,경상북도,의성군나선거구,6471902,4719,의성군,가음면,선거일투표,735,424,52,236,116,404,20,311
4700,경상북도,의성군나선거구,6471902,4719,의성군,금성면,계,3738,2503,954,621,810,2385,118,1235
4700,경상북도,의성군나선거구,6471902,4719,의성군,금성면,관내사전투표,1374,1374,547,357,407,1311,63,0
4700,경상북도,의성군나선거구,6471902,4719,의성군,금성면,선거일투표,2364,1129,407,264,403,1074,55,1235
4700,경상북도,의성군나선거구,6471902,4719,의성군,잘못 투입·구분된 투표지,,0,5,0,5,0,5,0,-5
4700,경상북도,의성군다선거구,6471903,4719,의성군,합계,,9116,6819,2417,1880,2163,6460,359,2297
4700,경상북도,의성군다선거구,6471903,4719,의성군,거소투표,,198,170,74,20,49,143,27,28
4700,경상북도,의성군다선거구,6471903,4719,의성군,관외사전투표,,648,648,259,193,170,622,26,0
4700,경상북도,의성군다선거구,6471903,4719,의성군,단촌면,계,1718,1234,501,442,221,1164,70,484
4700,경상북도,의성군다선거구,6471903,4719,의성군,단촌면,관내사전투표,663,663,257,247,118,622,41,0
4700,경상북도,의성군다선거구,6471903,4719,의성군,단촌면,선거일투표,1055,571,244,195,103,542,29,484
4700,경상북도,의성군다선거구,6471903,4719,의성군,봉양면,계,3350,2286,324,824,1062,2210,76,1064
4700,경상북도,의성군다선거구,6471903,4719,의성군,봉양면,관내사전투표,1224,1224,198,407,564,1169,55,0
4700,경상북도,의성군다선거구,6471903,4719,의성군,봉양면,선거일투표,2126,1062,126,417,498,1041,21,1064
4700,경상북도,의성군다선거구,6471903,4719,의성군,신평면,계,693,559,228,114,178,520,39,134
4700,경상북도,의성군다선거구,6471903,4719,의성군,신평면,관내사전투표,391,391,163,68,130,361,30,0
4700,경상북도,의성군다선거구,6471903,4719,의성군,신평면,선거일투표,302,168,65,46,48,159,9,134
4700,경상북도,의성군다선거구,6471903,4719,의성군,안평면,계,1822,1347,881,132,258,1271,76,475
4700,경상북도,의성군다선거구,6471903,4719,의성군,안평면,관내사전투표,805,805,513,77,150,740,65,0
4700,경상북도,의성군다선거구,6471903,4719,의성군,안평면,선거일투표,1017,542,368,55,108,531,11,475
4700,경상북도,의성군다선거구,6471903,4719,의성군,안사면,계,687,569,148,154,222,524,45,118
4700,경상북도,의성군다선거구,6471903,4719,의성군,안사면,관내사전투표,419,418,100,118,165,383,35,1
4700,경상북도,의성군다선거구,6471903,4719,의성군,안사면,선거일투표,268,151,48,36,57,141,10,117
4700,경상북도,의성군다선거구,6471903,4719,의성군,잘못 투입·구분된 투표지,,0,6,2,1,3,6,0,-6
4700,경상북도,의성군라선거구,6471904,4719,의성군,합계,,8256,6408,2176,1829,2046,6051,357,1848
4700,경상북도,의성군라선거구,6471904,4719,의성군,거소투표,,289,250,110,53,59,222,28,39
4700,경상북도,의성군라선거구,6471904,4719,의성군,관외사전투표,,695,695,240,195,227,662,33,0
4700,경상북도,의성군라선거구,6471904,4719,의성군,비안면,계,2142,1534,219,230,992,1441,93,608
4700,경상북도,의성군라선거구,6471904,4719,의성군,비안면,관내사전투표,965,962,128,127,633,888,74,3
4700,경상북도,의성군라선거구,6471904,4719,의성군,비안면,선거일투표,1177,572,91,103,359,553,19,605
4700,경상북도,의성군라선거구,6471904,4719,의성군,구천면,계,1390,1113,409,344,296,1049,64,277
4700,경상북도,의성군라선거구,6471904,4719,의성군,구천면,관내사전투표,753,753,283,217,203,703,50,0
4700,경상북도,의성군라선거구,6471904,4719,의성군,구천면,선거일투표,637,360,126,127,93,346,14,277
4700,경상북도,의성군라선거구,6471904,4719,의성군,안계면,계,3740,2808,1197,1003,470,2670,138,932
4700,경상북도,의성군라선거구,6471904,4719,의성군,안계면,관내사전투표,1782,1780,775,636,257,1668,112,2
4700,경상북도,의성군라선거구,6471904,4719,의성군,안계면,선거일투표,1958,1028,422,367,213,1002,26,930
4700,경상북도,의성군라선거구,6471904,4719,의성군,잘못 투입·구분된 투표지,,0,8,1,4,2,7,1,-8
4700,경상북도,의성군마선거구,6471905,4719,의성군,검색된 결과가 없습니다.
4700,경상북도,청송군가선거구,6472001,4720,청송군,합계,,11990,8808,1570,2048,2794,2170,8582,226,3182
4700,경상북도,청송군가선거구,6472001,4720,청송군,거소투표,,97,78,20,11,18,19,68,10,19
4700,경상북도,청송군가선거구,6472001,4720,청송군,관외사전투표,,606,606,161,198,141,90,590,16,0
4700,경상북도,청송군가선거구,6472001,4720,청송군,청송읍,계,4265,3105,926,1135,466,501,3028,77,1160
4700,경상북도,청송군가선거구,6472001,4720,청송군,청송읍,관내사전투표,1440,1437,424,543,234,189,1390,47,3
4700,경상북도,청송군가선거구,6472001,4720,청송군,청송읍,선거일투표,2825,1668,502,592,232,312,1638,30,1157
4700,경상북도,청송군가선거구,6472001,4720,청송군,파천면,계,1545,1167,180,315,289,344,1128,39,378
4700,경상북도,청송군가선거구,6472001,4720,청송군,파천면,관내사전투표,498,497,87,138,136,113,474,23,1
4700,경상북도,청송군가선거구,6472001,4720,청송군,파천면,선거일투표,1047,670,93,177,153,231,654,16,377
4700,경상북도,청송군가선거구,6472001,4720,청송군,진보면,계,5477,3847,282,387,1879,1215,3763,84,1630
4700,경상북도,청송군가선거구,6472001,4720,청송군,진보면,관내사전투표,1962,1960,151,194,919,644,1908,52,2
4700,경상북도,청송군가선거구,6472001,4720,청송군,진보면,선거일투표,3515,1887,131,193,960,571,1855,32,1628
4700,경상북도,청송군가선거구,6472001,4720,청송군,잘못 투입·구분된 투표지,,0,5,1,2,1,1,5,0,-5
4700,경상북도,청송군나선거구,6472002,4720,청송군,합계,,10800,8038,841,1852,2118,1471,1467,7749,289,2762
4700,경상북도,청송군나선거구,6472002,4720,청송군,거소투표,,116,101,8,28,31,5,12,84,17,15
4700,경상북도,청송군나선거구,6472002,4720,청송군,관외사전투표,,611,611,86,154,123,125,108,596,15,0
4700,경상북도,청송군나선거구,6472002,4720,청송군,주왕산면,계,1516,1112,57,189,243,300,289,1078,34,404
4700,경상북도,청송군나선거구,6472002,4720,청송군,주왕산면,관내사전투표,433,430,15,71,122,107,98,413,17,3
4700,경상북도,청송군나선거구,6472002,4720,청송군,주왕산면,선거일투표,1083,682,42,118,121,193,191,665,17,401
4700,경상북도,청송군나선거구,6472002,4720,청송군,부남면,계,2297,1677,79,264,261,350,658,1612,65,620
4700,경상북도,청송군나선거구,6472002,4720,청송군,부남면,관내사전투표,848,846,43,143,127,161,327,801,45,2
4700,경상북도,청송군나선거구,6472002,4720,청송군,부남면,선거일투표,1449,831,36,121,134,189,331,811,20,618
4700,경상북도,청송군나선거구,6472002,4720,청송군,현동면,계,1859,1357,63,719,258,171,96,1307,50,502
4700,경상북도,청송군나선거구,6472002,4720,청송군,현동면,관내사전투표,664,659,33,345,132,78,46,634,25,5
4700,경상북도,청송군나선거구,6472002,4720,청송군,현동면,선거일투표,1195,698,30,374,126,93,50,673,25,497
4700,경상북도,청송군나선거구,6472002,4720,청송군,현서면,계,2222,1584,444,303,258,332,196,1533,51,638
4700,경상북도,청송군나선거구,6472002,4720,청송군,현서면,관내사전투표,694,691,198,139,121,128,82,668,23,3
4700,경상북도,청송군나선거구,6472002,4720,청송군,현서면,선거일투표,1528,893,246,164,137,204,114,865,28,635
4700,경상북도,청송군나선거구,6472002,4720,청송군,안덕면,계,2179,1583,102,192,942,185,107,1528,55,596
4700,경상북도,청송군나선거구,6472002,4720,청송군,안덕면,관내사전투표,757,757,42,102,458,77,47,726,31,0
4700,경상북도,청송군나선거구,6472002,4720,청송군,안덕면,선거일투표,1422,826,60,90,484,108,60,802,24,596
4700,경상북도,청송군나선거구,6472002,4720,청송군,잘못 투입·구분된 투표지,,0,13,2,3,2,3,1,11,2,-13
4700,경상북도,영양군가선거구,6472101,4721,영양군,합계,,9460,7280,1238,1566,1223,1176,675,1187,7065,215,2180
4700,경상북도,영양군가선거구,6472101,4721,영양군,거소투표,,57,56,8,5,9,2,3,13,40,16,1
4700,경상북도,영양군가선거구,6472101,4721,영양군,관외사전투표,,655,655,149,139,129,99,52,70,638,17,0
4700,경상북도,영양군가선거구,6472101,4721,영양군,영양읍,계,5726,4238,637,1062,795,417,430,802,4143,95,1488
4700,경상북도,영양군가선거구,6472101,4721,영양군,영양읍,관내사전투표,2307,2307,350,566,500,228,222,393,2259,48,0
4700,경상북도,영양군가선거구,6472101,4721,영양군,영양읍,선거일투표,3419,1931,287,496,295,189,208,409,1884,47,1488
4700,경상북도,영양군가선거구,6472101,4721,영양군,일월면,계,1583,1223,238,181,127,357,113,169,1185,38,360
4700,경상북도,영양군가선거구,6472101,4721,영양군,일월면,관내사전투표,849,849,166,125,82,256,79,114,822,27,0
4700,경상북도,영양군가선거구,6472101,4721,영양군,일월면,선거일투표,734,374,72,56,45,101,34,55,363,11,360
4700,경상북도,영양군가선거구,6472101,4721,영양군,수비면,계,1439,1108,206,179,163,301,77,133,1059,49,331
4700,경상북도,영양군가선거구,6472101,4721,영양군,수비면,관내사전투표,666,666,105,116,105,191,39,75,631,35,0
4700,경상북도,영양군가선거구,6472101,4721,영양군,수비면,선거일투표,773,442,101,63,58,110,38,58,428,14,331
4700,경상북도,영양군가선거구,6472101,4721,영양군,잘못 투입·구분된 투표지,,0,0,0,0,0,0,0,0,0,0,0
4700,경상북도,영양군나선거구,6472102,4721,영양군,합계,,5460,4252,452,1066,1034,949,622,4123,129,1208
4700,경상북도,영양군나선거구,6472102,4721,영양군,거소투표,,31,30,4,1,8,9,4,26,4,1
4700,경상북도,영양군나선거구,6472102,4721,영양군,관외사전투표,,346,346,51,103,88,73,23,338,8,0
4700,경상북도,영양군나선거구,6472102,4721,영양군,입암면,계,1831,1420,54,91,121,755,367,1388,32,411
4700,경상북도,영양군나선거구,6472102,4721,영양군,입암면,관내사전투표,849,846,36,59,69,436,224,824,22,3
4700,경상북도,영양군나선거구,6472102,4721,영양군,입암면,선거일투표,982,574,18,32,52,319,143,564,10,408
4700,경상북도,영양군나선거구,6472102,4721,영양군,청기면,계,1478,1105,42,144,722,65,90,1063,42,373
4700,경상북도,영양군나선거구,6472102,4721,영양군,청기면,관내사전투표,577,577,23,89,369,30,41,552,25,0
4700,경상북도,영양군나선거구,6472102,4721,영양군,청기면,선거일투표,901,528,19,55,353,35,49,511,17,373
4700,경상북도,영양군나선거구,6472102,4721,영양군,석보면,계,1774,1347,301,727,94,44,138,1304,43,427
4700,경상북도,영양군나선거구,6472102,4721,영양군,석보면,관내사전투표,775,774,169,410,56,26,82,743,31,1
4700,경상북도,영양군나선거구,6472102,4721,영양군,석보면,선거일투표,999,573,132,317,38,18,56,561,12,426
4700,경상북도,영양군나선거구,6472102,4721,영양군,잘못 투입·구분된 투표지,,0,4,0,0,1,3,0,4,0,-4
4700,경상북도,영덕군가선거구,6472201,4722,영덕군,합계,,18122,11832,1818,3256,2506,2493,1318,11391,441,6290
4700,경상북도,영덕군가선거구,6472201,4722,영덕군,거소투표,,88,79,11,25,20,13,1,70,9,9
4700,경상북도,영덕군가선거구,6472201,4722,영덕군,관외사전투표,,819,819,165,272,109,163,86,795,24,0
4700,경상북도,영덕군가선거구,6472201,4722,영덕군,영덕읍,계,8828,5809,1027,1729,701,1269,902,5628,181,3019
4700,경상북도,영덕군가선거구,6472201,4722,영덕군,영덕읍,관내사전투표,2880,2874,524,796,361,696,406,2783,91,6
4700,경상북도,영덕군가선거구,6472201,4722,영덕군,영덕읍,선거일투표,5948,2935,503,933,340,573,496,2845,90,3013
4700,경상북도,영덕군가선거구,6472201,4722,영덕군,강구면,계,5284,3163,306,626,1337,572,202,3043,120,2121
4700,경상북도,영덕군가선거구,6472201,4722,영덕군,강구면,관내사전투표,1319,1316,122,232,580,233,89,1256,60,3
4700,경상북도,영덕군가선거구,6472201,4722,영덕군,강구면,선거일투표,3965,1847,184,394,757,339,113,1787,60,2118
4700,경상북도,영덕군가선거구,6472201,4722,영덕군,남정면,계,2099,1311,195,372,261,314,87,1229,82,788
4700,경상북도,영덕군가선거구,6472201,4722,영덕군,남정면,관내사전투표,649,644,88,194,117,156,40,595,49,5
4700,경상북도,영덕군가선거구,6472201,4722,영덕군,남정면,선거일투표,1450,667,107,178,144,158,47,634,33,783
4700,경상북도,영덕군가선거구,6472201,4722,영덕군,달산면,계,1004,644,114,228,78,160,40,620,24,360
4700,경상북도,영덕군가선거구,6472201,4722,영덕군,달산면,관내사전투표,265,265,46,79,34,79,16,254,11,0
4700,경상북도,영덕군가선거구,6472201,4722,영덕군,달산면,선거일투표,739,379,68,149,44,81,24,366,13,360
4700,경상북도,영덕군가선거구,6472201,4722,영덕군,잘못 투입·구분된 투표지,,0,7,0,4,0,2,0,6,1,-7
4700,경상북도,영덕군나선거구,6472202,4722,영덕군,합계,,14002,9726,1547,1975,1602,700,1503,1975,9302,424,4276
4700,경상북도,영덕군나선거구,6472202,4722,영덕군,거소투표,,136,114,23,10,22,6,25,25,111,3,22
4700,경상북도,영덕군나선거구,6472202,4722,영덕군,관외사전투표,,637,637,164,179,71,50,62,78,604,33,0
4700,경상북도,영덕군나선거구,6472202,4722,영덕군,지품면,계,1719,1194,189,445,131,67,134,169,1135,59,525
4700,경상북도,영덕군나선거구,6472202,4722,영덕군,지품면,관내사전투표,458,458,67,178,52,29,45,59,430,28,0
4700,경상북도,영덕군나선거구,6472202,4722,영덕군,지품면,선거일투표,1261,736,122,267,79,38,89,110,705,31,525
4700,경상북도,영덕군나선거구,6472202,4722,영덕군,축산면,계,2272,1562,182,561,139,72,202,337,1493,69,710
4700,경상북도,영덕군나선거구,6472202,4722,영덕군,축산면,관내사전투표,753,753,80,272,72,30,90,171,715,38,0
4700,경상북도,영덕군나선거구,6472202,4722,영덕군,축산면,선거일투표,1519,809,102,289,67,42,112,166,778,31,710
4700,경상북도,영덕군나선거구,6472202,4722,영덕군,영해면,계,5417,3686,584,379,699,328,737,823,3550,136,1731
4700,경상북도,영덕군나선거구,6472202,4722,영덕군,영해면,관내사전투표,1772,1772,314,195,293,142,372,380,1696,76,0
4700,경상북도,영덕군나선거구,6472202,4722,영덕군,영해면,선거일투표,3645,1914,270,184,406,186,365,443,1854,60,1731
4700,경상북도,영덕군나선거구,6472202,4722,영덕군,병곡면,계,2346,1535,227,272,361,91,190,326,1467,68,811
4700,경상북도,영덕군나선거구,6472202,4722,영덕군,병곡면,관내사전투표,717,717,125,139,166,47,90,116,683,34,0
4700,경상북도,영덕군나선거구,6472202,4722,영덕군,병곡면,선거일투표,1629,818,102,133,195,44,100,210,784,34,811
4700,경상북도,영덕군나선거구,6472202,4722,영덕군,창수면,계,1475,998,178,129,179,86,153,217,942,56,477
4700,경상북도,영덕군나선거구,6472202,4722,영덕군,창수면,관내사전투표,433,433,84,51,68,48,71,91,413,20,0
4700,경상북도,영덕군나선거구,6472202,4722,영덕군,창수면,선거일투표,1042,565,94,78,111,38,82,126,529,36,477
4700,경상북도,영덕군나선거구,6472202,4722,영덕군,잘못 투입·구분된 투표지,,0,0,0,0,0,0,0,0,0,0,0
4700,경상북도,봉화군가선거구,6472301,4723,봉화군,합계,,11250,7356,2411,2973,1687,7071,285,3894
4700,경상북도,봉화군가선거구,6472301,4723,봉화군,거소투표,,34,30,15,9,4,28,2,4
4700,경상북도,봉화군가선거구,6472301,4723,봉화군,관외사전투표,,635,635,205,262,149,616,19,0
4700,경상북도,봉화군가선거구,6472301,4723,봉화군,봉화읍,계,7947,5015,1661,2129,1022,4812,203,2932
4700,경상북도,봉화군가선거구,6472301,4723,봉화군,봉화읍,관내사전투표,2412,2406,794,1042,496,2332,74,6
4700,경상북도,봉화군가선거구,6472301,4723,봉화군,봉화읍,선거일투표,5535,2609,867,1087,526,2480,129,2926
4700,경상북도,봉화군가선거구,6472301,4723,봉화군,물야면,계,2634,1664,529,567,509,1605,59,970
4700,경상북도,봉화군가선거구,6472301,4723,봉화군,물야면,관내사전투표,594,592,188,205,174,567,25,2
4700,경상북도,봉화군가선거구,6472301,4723,봉화군,물야면,선거일투표,2040,1072,341,362,335,1038,34,968
4700,경상북도,봉화군가선거구,6472301,4723,봉화군,잘못 투입·구분된 투표지,,0,12,1,6,3,10,2,-12
4700,경상북도,봉화군나선거구,6472302,4723,봉화군,합계,,7081,4775,1703,1798,1017,4518,257,2306
4700,경상북도,봉화군나선거구,6472302,4723,봉화군,거소투표,,36,33,11,14,5,30,3,3
4700,경상북도,봉화군나선거구,6472302,4723,봉화군,관외사전투표,,614,614,222,219,149,590,24,0
4700,경상북도,봉화군나선거구,6472302,4723,봉화군,봉성면,계,1781,1216,175,615,369,1159,57,565
4700,경상북도,봉화군나선거구,6472302,4723,봉화군,봉성면,관내사전투표,379,379,54,219,90,363,16,0
4700,경상북도,봉화군나선거구,6472302,4723,봉화군,봉성면,선거일투표,1402,837,121,396,279,796,41,565
4700,경상북도,봉화군나선거구,6472302,4723,봉화군,재산면,계,1315,778,338,189,174,701,77,537
4700,경상북도,봉화군나선거구,6472302,4723,봉화군,재산면,관내사전투표,345,345,161,91,74,326,19,0
4700,경상북도,봉화군나선거구,6472302,4723,봉화군,재산면,선거일투표,970,433,177,98,100,375,58,537
4700,경상북도,봉화군나선거구,6472302,4723,봉화군,명호면,계,1818,1151,716,232,156,1104,47,667
4700,경상북도,봉화군나선거구,6472302,4723,봉화군,명호면,관내사전투표,458,458,290,86,62,438,20,0
4700,경상북도,봉화군나선거구,6472302,4723,봉화군,명호면,선거일투표,1360,693,426,146,94,666,27,667
4700,경상북도,봉화군나선거구,6472302,4723,봉화군,상운면,계,1517,983,241,529,164,934,49,534
4700,경상북도,봉화군나선거구,6472302,4723,봉화군,상운면,관내사전투표,463,463,110,251,76,437,26,0
4700,경상북도,봉화군나선거구,6472302,4723,봉화군,상운면,선거일투표,1054,520,131,278,88,497,23,534
4700,경상북도,봉화군나선거구,6472302,4723,봉화군,잘못 투입·구분된 투표지,,0,0,0,0,0,0,0,0
4700,경상북도,봉화군다선거구,6472303,4723,봉화군,합계,,9665,6751,612,1785,1483,832,663,1144,6519,232,2914
4700,경상북도,봉화군다선거구,6472303,4723,봉화군,거소투표,,40,40,6,8,12,4,2,4,36,4,0
4700,경상북도,봉화군다선거구,6472303,4723,봉화군,관외사전투표,,530,530,106,156,111,49,23,75,520,10,0
4700,경상북도,봉화군다선거구,6472303,4723,봉화군,법전면,계,1664,1143,57,688,157,99,37,68,1106,37,521
4700,경상북도,봉화군다선거구,6472303,4723,봉화군,법전면,관내사전투표,534,534,24,322,67,54,20,34,521,13,0
4700,경상북도,봉화군다선거구,6472303,4723,봉화군,법전면,선거일투표,1130,609,33,366,90,45,17,34,585,24,521
4700,경상북도,봉화군다선거구,6472303,4723,봉화군,춘양면,계,3965,2807,189,377,792,488,140,728,2714,93,1158
4700,경상북도,봉화군다선거구,6472303,4723,봉화군,춘양면,관내사전투표,1241,1241,88,210,369,220,66,262,1215,26,0
4700,경상북도,봉화군다선거구,6472303,4723,봉화군,춘양면,선거일투표,2724,1566,101,167,423,268,74,466,1499,67,1158
4700,경상북도,봉화군다선거구,6472303,4723,봉화군,소천면,계,1888,1248,181,370,228,113,107,200,1199,49,640
4700,경상북도,봉화군다선거구,6472303,4723,봉화군,소천면,관내사전투표,501,501,68,158,77,45,43,87,478,23,0
4700,경상북도,봉화군다선거구,6472303,4723,봉화군,소천면,선거일투표,1387,747,113,212,151,68,64,113,721,26,640
4700,경상북도,봉화군다선거구,6472303,4723,봉화군,석포면,계,1578,983,73,186,183,79,354,69,944,39,595
4700,경상북도,봉화군다선거구,6472303,4723,봉화군,석포면,관내사전투표,533,533,24,92,86,46,215,46,509,24,0
4700,경상북도,봉화군다선거구,6472303,4723,봉화군,석포면,선거일투표,1045,450,49,94,97,33,139,23,435,15,595
4700,경상북도,봉화군다선거구,6472303,4723,봉화군,잘못 투입·구분된 투표지,,0,0,0,0,0,0,0,0,0,0,0
4700,경상북도,울진군가선거구,6472401,4724,울진군,합계,,12749,8634,3640,2235,2390,8265,369,4115
4700,경상북도,울진군가선거구,6472401,4724,울진군,거소투표,,71,68,25,27,15,67,1,3
4700,경상북도,울진군가선거구,6472401,4724,울진군,관외사전투표,,1076,1076,421,306,297,1024,52,0
4700,경상북도,울진군가선거구,6472401,4724,울진군,울진읍,계,10481,6727,2873,1757,1845,6475,252,3754
4700,경상북도,울진군가선거구,6472401,4724,울진군,울진읍,관내사전투표,2692,2687,1162,646,759,2567,120,5
4700,경상북도,울진군가선거구,6472401,4724,울진군,울진읍,선거일투표,7789,4040,1711,1111,1086,3908,132,3749
4700,경상북도,울진군가선거구,6472401,4724,울진군,금강송면,계,1121,756,318,142,232,692,64,365
4700,경상북도,울진군가선거구,6472401,4724,울진군,금강송면,관내사전투표,341,340,169,59,89,317,23,1
4700,경상북도,울진군가선거구,6472401,4724,울진군,금강송면,선거일투표,780,416,149,83,143,375,41,364
4700,경상북도,울진군가선거구,6472401,4724,울진군,잘못 투입·구분된 투표지,,0,7,3,3,1,7,0,-7
4700,경상북도,울진군나선거구,6472402,4724,울진군,합계,,11893,7368,1916,1640,2126,1343,7025,343,4525
4700,경상북도,울진군나선거구,6472402,4724,울진군,거소투표,,79,66,13,16,26,6,61,5,13
4700,경상북도,울진군나선거구,6472402,4724,울진군,관외사전투표,,716,716,222,129,195,137,683,33,0
4700,경상북도,울진군나선거구,6472402,4724,울진군,북면,계,5765,3485,1226,321,1533,264,3344,141,2280
4700,경상북도,울진군나선거구,6472402,4724,울진군,북면,관내사전투표,1538,1534,555,124,680,117,1476,58,4
4700,경상북도,울진군나선거구,6472402,4724,울진군,북면,선거일투표,4227,1951,671,197,853,147,1868,83,2276
4700,경상북도,울진군나선거구,6472402,4724,울진군,죽변면,계,5333,3092,452,1173,369,935,2929,163,2241
4700,경상북도,울진군나선거구,6472402,4724,울진군,죽변면,관내사전투표,1449,1447,199,561,163,457,1380,67,2
4700,경상북도,울진군나선거구,6472402,4724,울진군,죽변면,선거일투표,3884,1645,253,612,206,478,1549,96,2239
4700,경상북도,울진군나선거구,6472402,4724,울진군,잘못 투입·구분된 투표지,,0,9,3,1,3,1,8,1,-9
4700,경상북도,울진군다선거구,6472403,4724,울진군,합계,,17421,12312,506,2560,1060,1844,1092,1418,101,954,1734,527,11796,516,5109
4700,경상북도,울진군다선거구,6472403,4724,울진군,거소투표,,237,214,5,45,7,31,9,43,3,7,48,5,203,11,23
4700,경상북도,울진군다선거구,6472403,4724,울진군,관외사전투표,,735,735,95,170,69,104,48,70,3,57,70,28,714,21,0
4700,경상북도,울진군다선거구,6472403,4724,울진군,평해읍,계,2465,1771,61,539,124,161,194,52,21,117,392,52,1713,58,694
4700,경상북도,울진군다선거구,6472403,4724,울진군,평해읍,관내사전투표,974,974,30,288,76,96,109,33,8,64,206,28,938,36,0
4700,경상북도,울진군다선거구,6472403,4724,울진군,평해읍,선거일투표,1491,797,31,251,48,65,85,19,13,53,186,24,775,22,694
4700,경상북도,울진군다선거구,6472403,4724,울진군,근남면,계,2334,1560,106,304,109,141,53,633,4,39,50,31,1470,90,774
4700,경상북도,울진군다선거구,6472403,4724,울진군,근남면,관내사전투표,791,791,49,137,58,76,25,335,2,21,23,14,740,51,0
4700,경상북도,울진군다선거구,6472403,4724,울진군,근남면,선거일투표,1543,769,57,167,51,65,28,298,2,18,27,17,730,39,774
4700,경상북도,울진군다선거구,6472403,4724,울진군,매화면,계,1733,1195,54,246,80,96,47,360,13,73,132,33,1134,61,538
4700,경상북도,울진군다선거구,6472403,4724,울진군,매화면,관내사전투표,693,693,27,150,55,52,26,210,9,48,64,18,659,34,0
4700,경상북도,울진군다선거구,6472403,4724,울진군,매화면,선거일투표,1040,502,27,96,25,44,21,150,4,25,68,15,475,27,538
4700,경상북도,울진군다선거구,6472403,4724,울진군,기성면,계,2092,1418,48,411,69,91,83,186,23,50,343,42,1346,72,674
4700,경상북도,울진군다선거구,6472403,4724,울진군,기성면,관내사전투표,791,791,28,241,38,41,49,95,15,28,185,22,742,49,0
4700,경상북도,울진군다선거구,6472403,4724,울진군,기성면,선거일투표,1301,627,20,170,31,50,34,91,8,22,158,20,604,23,674
4700,경상북도,울진군다선거구,6472403,4724,울진군,온정면,계,1444,1101,34,282,61,152,56,27,11,109,291,30,1053,48,343
4700,경상북도,울진군다선거구,6472403,4724,울진군,온정면,관내사전투표,525,525,13,133,28,84,28,14,5,41,138,18,502,23,0
4700,경상북도,울진군다선거구,6472403,4724,울진군,온정면,선거일투표,919,576,21,149,33,68,28,13,6,68,153,12,551,25,343
4700,경상북도,울진군다선거구,6472403,4724,울진군,후포면,계,6381,4317,103,562,541,1068,602,47,23,502,408,306,4162,155,2064
4700,경상북도,울진군다선거구,6472403,4724,울진군,후포면,관내사전투표,1958,1957,65,275,231,465,274,13,11,247,169,135,1885,72,1
4700,경상북도,울진군다선거구,6472403,4724,울진군,후포면,선거일투표,4423,2360,38,287,310,603,328,34,12,255,239,171,2277,83,2063
4700,경상북도,울진군다선거구,6472403,4724,울진군,잘못 투입·구분된 투표지,,0,1,0,1,0,0,0,0,0,0,0,0,1,0,-14800,경상남도,창원시가선거구,6482101,4821,창원시의창구,합계,,57295,29323,6901,3280,9082,5166,2580,746,27755,1568,27972
4800,경상남도,창원시가선거구,6482101,4821,창원시의창구,거소투표,,117,106,15,15,34,10,11,3,88,18,11
4800,경상남도,창원시가선거구,6482101,4821,창원시의창구,관외사전투표,,3075,3073,831,323,1065,472,153,62,2906,167,2
4800,경상남도,창원시가선거구,6482101,4821,창원시의창구,동읍,계,16252,8123,1592,1362,3095,456,1028,213,7746,377,8129
4800,경상남도,창원시가선거구,6482101,4821,창원시의창구,동읍,관내사전투표,2290,2287,458,461,865,112,217,50,2163,124,3
4800,경상남도,창원시가선거구,6482101,4821,창원시의창구,동읍,선거일투표,13962,5836,1134,901,2230,344,811,163,5583,253,8126
4800,경상남도,창원시가선거구,6482101,4821,창원시의창구,북면,계,31580,14942,3962,1195,3938,4029,759,237,14120,822,16638
4800,경상남도,창원시가선거구,6482101,4821,창원시의창구,북면,관내사전투표,4454,4453,1243,375,1157,1179,182,75,4211,242,1
4800,경상남도,창원시가선거구,6482101,4821,창원시의창구,북면,선거일투표,27126,10489,2719,820,2781,2850,577,162,9909,580,16637
4800,경상남도,창원시가선거구,6482101,4821,창원시의창구,대산면,계,6271,3057,496,384,942,197,625,231,2875,182,3214
4800,경상남도,창원시가선거구,6482101,4821,창원시의창구,대산면,관내사전투표,1083,1079,186,143,350,68,180,76,1003,76,4
4800,경상남도,창원시가선거구,6482101,4821,창원시의창구,대산면,선거일투표,5188,1978,310,241,592,129,445,155,1872,106,3210
4800,경상남도,창원시가선거구,6482101,4821,창원시의창구,잘못 투입·구분된 투표지,,0,22,5,1,8,2,4,0,20,2,-22
4800,경상남도,창원시나선거구,6482102,4821,창원시의창구,합계,,64496,33921,8832,13117,7162,3306,32417,1504,30575
4800,경상남도,창원시나선거구,6482102,4821,창원시의창구,거소투표,,125,115,28,51,27,4,110,5,10
4800,경상남도,창원시나선거구,6482102,4821,창원시의창구,관외사전투표,,3623,3620,1181,1377,669,272,3499,121,3
4800,경상남도,창원시나선거구,6482102,4821,창원시의창구,의창동,계,39600,19929,4739,7976,4359,1901,18975,954,19671
4800,경상남도,창원시나선거구,6482102,4821,창원시의창구,의창동,관내사전투표,4314,4308,1063,1816,863,397,4139,169,6
4800,경상남도,창원시나선거구,6482102,4821,창원시의창구,의창동,선거일투표,35286,15621,3676,6160,3496,1504,14836,785,19665
4800,경상남도,창원시나선거구,6482102,4821,창원시의창구,팔룡동,계,21148,10213,2873,3699,2100,1126,9798,415,10935
4800,경상남도,창원시나선거구,6482102,4821,창원시의창구,팔룡동,관내사전투표,3639,3627,1046,1297,782,382,3507,120,12
4800,경상남도,창원시나선거구,6482102,4821,창원시의창구,팔룡동,선거일투표,17509,6586,1827,2402,1318,744,6291,295,10923
4800,경상남도,창원시나선거구,6482102,4821,창원시의창구,잘못 투입·구분된 투표지,,0,44,11,14,7,3,35,9,-44
4800,경상남도,창원시다선거구,6482103,4821,창원시의창구,합계,,63393,31576,9399,14189,3647,2717,29952,1624,31817
4800,경상남도,창원시다선거구,6482103,4821,창원시의창구,거소투표,,142,136,48,61,8,6,123,13,6
4800,경상남도,창원시다선거구,6482103,4821,창원시의창구,관외사전투표,,3156,3150,1212,1357,246,220,3035,115,6
4800,경상남도,창원시다선거구,6482103,4821,창원시의창구,명곡동,계,34472,16436,4644,7554,2326,1103,15627,809,18036
4800,경상남도,창원시다선거구,6482103,4821,창원시의창구,명곡동,관내사전투표,4585,4575,1399,2020,705,313,4437,138,10
4800,경상남도,창원시다선거구,6482103,4821,창원시의창구,명곡동,선거일투표,29887,11861,3245,5534,1621,790,11190,671,18026
4800,경상남도,창원시다선거구,6482103,4821,창원시의창구,봉림동,계,25623,11803,3479,5196,1060,1387,11122,681,13820
4800,경상남도,창원시다선거구,6482103,4821,창원시의창구,봉림동,관내사전투표,3285,3274,1068,1366,316,438,3188,86,11
4800,경상남도,창원시다선거구,6482103,4821,창원시의창구,봉림동,선거일투표,22338,8529,2411,3830,744,949,7934,595,13809
4800,경상남도,창원시다선거구,6482103,4821,창원시의창구,잘못 투입·구분된 투표지,,0,51,16,21,7,1,45,6,-51
4800,경상남도,창원시라선거구,6482201,4822,창원시성산구,합계,,58608,32699,9991,16524,4714,31229,1470,25909
4800,경상남도,창원시라선거구,6482201,4822,창원시성산구,거소투표,,128,115,28,70,5,103,12,13
4800,경상남도,창원시라선거구,6482201,4822,창원시성산구,관외사전투표,,3500,3493,1192,1799,418,3409,84,7
4800,경상남도,창원시라선거구,6482201,4822,창원시성산구,반송동,계,31633,17823,5616,8382,3105,17103,720,13810
4800,경상남도,창원시라선거구,6482201,4822,창원시성산구,반송동,관내사전투표,4761,4759,1639,2058,986,4683,76,2
4800,경상남도,창원시라선거구,6482201,4822,창원시성산구,반송동,선거일투표,26872,13064,3977,6324,2119,12420,644,13808
4800,경상남도,창원시라선거구,6482201,4822,창원시성산구,용지동,계,23347,11247,3148,6262,1185,10595,652,12100
4800,경상남도,창원시라선거구,6482201,4822,창원시성산구,용지동,관내사전투표,2735,2734,807,1537,362,2706,28,1
4800,경상남도,창원시라선거구,6482201,4822,창원시성산구,용지동,선거일투표,20612,8513,2341,4725,823,7889,624,12099
4800,경상남도,창원시라선거구,6482201,4822,창원시성산구,잘못 투입·구분된 투표지,,0,21,7,11,1,19,2,-21
4800,경상남도,창원시마선거구,6482202,4822,창원시성산구,검색된 결과가 없습니다.
4800,경상남도,창원시바선거구,6482203,4822,창원시성산구,합계,,61679,32596,10611,13709,3547,3204,31071,1525,29083
4800,경상남도,창원시바선거구,6482203,4822,창원시성산구,거소투표,,122,111,34,51,9,9,103,8,11
4800,경상남도,창원시바선거구,6482203,4822,창원시성산구,관외사전투표,,3064,3064,1192,1287,237,276,2992,72,0
4800,경상남도,창원시바선거구,6482203,4822,창원시성산구,상남동,계,21977,11453,3730,4851,1320,1049,10950,503,10524
4800,경상남도,창원시바선거구,6482203,4822,창원시성산구,상남동,관내사전투표,4257,4255,1474,1722,548,418,4162,93,2
4800,경상남도,창원시바선거구,6482203,4822,창원시성산구,상남동,선거일투표,17720,7198,2256,3129,772,631,6788,410,10522
4800,경상남도,창원시바선거구,6482203,4822,창원시성산구,사파동,계,36516,17940,5649,7510,1980,1865,17004,936,18576
4800,경상남도,창원시바선거구,6482203,4822,창원시성산구,사파동,관내사전투표,4633,4628,1627,1884,534,479,4524,104,5
4800,경상남도,창원시바선거구,6482203,4822,창원시성산구,사파동,선거일투표,31883,13312,4022,5626,1446,1386,12480,832,18571
4800,경상남도,창원시바선거구,6482203,4822,창원시성산구,잘못 투입·구분된 투표지,,0,28,6,10,1,5,22,6,-28
4800,경상남도,창원시사선거구,6482301,4822,창원시성산구,검색된 결과가 없습니다.
4800,경상남도,창원시아선거구,6482302,4823,창원시마산합포구,합계,,33606,19025,5242,7334,5524,18100,925,14581
4800,경상남도,창원시아선거구,6482302,4823,창원시마산합포구,거소투표,,131,122,41,47,21,109,13,9
4800,경상남도,창원시아선거구,6482302,4823,창원시마산합포구,관외사전투표,,1787,1787,599,815,325,1739,48,0
4800,경상남도,창원시아선거구,6482302,4823,창원시마산합포구,구산면,계,3587,2063,535,1148,207,1890,173,1524
4800,경상남도,창원시아선거구,6482302,4823,창원시마산합포구,구산면,관내사전투표,550,548,157,307,57,521,27,2
4800,경상남도,창원시아선거구,6482302,4823,창원시마산합포구,구산면,선거일투표,3037,1515,378,841,150,1369,146,1522
4800,경상남도,창원시아선거구,6482302,4823,창원시마산합포구,진동면,계,9862,5142,1329,1516,2066,4911,231,4720
4800,경상남도,창원시아선거구,6482302,4823,창원시마산합포구,진동면,관내사전투표,1944,1939,537,546,802,1885,54,5
4800,경상남도,창원시아선거구,6482302,4823,창원시마산합포구,진동면,선거일투표,7918,3203,792,970,1264,3026,177,4715
4800,경상남도,창원시아선거구,6482302,4823,창원시마산합포구,진북면,계,2993,1596,295,625,589,1509,87,1397
4800,경상남도,창원시아선거구,6482302,4823,창원시마산합포구,진북면,관내사전투표,554,554,109,206,215,530,24,0
4800,경상남도,창원시아선거구,6482302,4823,창원시마산합포구,진북면,선거일투표,2439,1042,186,419,374,979,63,1397
4800,경상남도,창원시아선거구,6482302,4823,창원시마산합포구,진전면,계,3311,1971,336,812,658,1806,165,1340
4800,경상남도,창원시아선거구,6482302,4823,창원시마산합포구,진전면,관내사전투표,715,715,132,310,228,670,45,0
4800,경상남도,창원시아선거구,6482302,4823,창원시마산합포구,진전면,선거일투표,2596,1256,204,502,430,1136,120,1340
4800,경상남도,창원시아선거구,6482302,4823,창원시마산합포구,현동,계,10408,5674,1901,2057,1531,5489,185,4734
4800,경상남도,창원시아선거구,6482302,4823,창원시마산합포구,현동,관내사전투표,2268,2265,781,814,610,2205,60,3
4800,경상남도,창원시아선거구,6482302,4823,창원시마산합포구,현동,선거일투표,8140,3409,1120,1243,921,3284,125,4731
4800,경상남도,창원시아선거구,6482302,4823,창원시마산합포구,가포동,계,1527,653,203,306,121,630,23,874
4800,경상남도,창원시아선거구,6482302,4823,창원시마산합포구,가포동,관내사전투표,270,270,89,128,47,264,6,0
4800,경상남도,창원시아선거구,6482302,4823,창원시마산합포구,가포동,선거일투표,1257,383,114,178,74,366,17,874
4800,경상남도,창원시아선거구,6482302,4823,창원시마산합포구,잘못 투입·구분된 투표지,,0,17,3,8,6,17,0,-17
4800,경상남도,창원시자선거구,6482303,4823,창원시마산합포구,합계,,57826,29932,5548,2953,13140,4807,269,1130,27847,2085,27894
4800,경상남도,창원시자선거구,6482303,4823,창원시마산합포구,거소투표,,111,101,22,5,37,19,1,4,88,13,10
4800,경상남도,창원시자선거구,6482303,4823,창원시마산합포구,관외사전투표,,2636,2635,724,296,979,324,38,85,2446,189,1
4800,경상남도,창원시자선거구,6482303,4823,창원시마산합포구,자산동,계,8661,4436,745,440,1956,773,28,144,4086,350,4225
4800,경상남도,창원시자선거구,6482303,4823,창원시마산합포구,자산동,관내사전투표,1611,1610,258,152,728,273,11,47,1469,141,1
4800,경상남도,창원시자선거구,6482303,4823,창원시마산합포구,자산동,선거일투표,7050,2826,487,288,1228,500,17,97,2617,209,4224
4800,경상남도,창원시자선거구,6482303,4823,창원시마산합포구,오동동,계,16367,7585,1193,925,3279,1378,51,246,7072,513,8782
4800,경상남도,창원시자선거구,6482303,4823,창원시마산합포구,오동동,관내사전투표,2029,2027,313,270,836,397,9,61,1886,141,2
4800,경상남도,창원시자선거구,6482303,4823,창원시마산합포구,오동동,선거일투표,14338,5558,880,655,2443,981,42,185,5186,372,8780
4800,경상남도,창원시자선거구,6482303,4823,창원시마산합포구,교방동,계,13001,6854,1372,648,2781,1219,85,292,6397,457,6147
4800,경상남도,창원시자선거구,6482303,4823,창원시마산합포구,교방동,관내사전투표,2187,2184,428,198,908,374,22,98,2028,156,3
4800,경상남도,창원시자선거구,6482303,4823,창원시마산합포구,교방동,선거일투표,10814,4670,944,450,1873,845,63,194,4369,301,6144
4800,경상남도,창원시자선거구,6482303,4823,창원시마산합포구,합포동,계,6581,3259,591,276,1361,563,36,183,3010,249,3322
4800,경상남도,창원시자선거구,6482303,4823,창원시마산합포구,합포동,관내사전투표,1496,1495,299,119,585,270,16,82,1371,124,1
4800,경상남도,창원시자선거구,6482303,4823,창원시마산합포구,합포동,선거일투표,5085,1764,292,157,776,293,20,101,1639,125,3321
4800,경상남도,창원시자선거구,6482303,4823,창원시마산합포구,산호동,계,10469,5051,897,363,2743,529,30,175,4737,314,5418
4800,경상남도,창원시자선거구,6482303,4823,창원시마산합포구,산호동,관내사전투표,1776,1774,296,124,991,186,12,63,1672,102,2
4800,경상남도,창원시자선거구,6482303,4823,창원시마산합포구,산호동,선거일투표,8693,3277,601,239,1752,343,18,112,3065,212,5416
4800,경상남도,창원시자선거구,6482303,4823,창원시마산합포구,잘못 투입·구분된 투표지,,0,11,4,0,4,2,0,1,11,0,-11
4800,경상남도,창원시차선거구,6482304,4823,창원시마산합포구,합계,,65418,34948,10764,12533,8173,1969,33439,1509,30470
4800,경상남도,창원시차선거구,6482304,4823,창원시마산합포구,거소투표,,133,123,44,39,29,6,118,5,10
4800,경상남도,창원시차선거구,6482304,4823,창원시마산합포구,관외사전투표,,3366,3366,1335,1121,661,151,3268,98,0
4800,경상남도,창원시차선거구,6482304,4823,창원시마산합포구,월영동,계,32131,16129,5477,5160,3897,1016,15550,579,16002
4800,경상남도,창원시차선거구,6482304,4823,창원시마산합포구,월영동,관내사전투표,5284,5284,1800,1693,1317,346,5156,128,0
4800,경상남도,창원시차선거구,6482304,4823,창원시마산합포구,월영동,선거일투표,26847,10845,3677,3467,2580,670,10394,451,16002
4800,경상남도,창원시차선거구,6482304,4823,창원시마산합포구,문화동,계,10039,4994,1272,1815,1312,263,4662,332,5045
4800,경상남도,창원시차선거구,6482304,4823,창원시마산합포구,문화동,관내사전투표,2246,2244,574,823,661,108,2166,78,2
4800,경상남도,창원시차선거구,6482304,4823,창원시마산합포구,문화동,선거일투표,7793,2750,698,992,651,155,2496,254,5043
4800,경상남도,창원시차선거구,6482304,4823,창원시마산합포구,반월중앙동,계,11921,6363,1689,2547,1493,325,6054,309,5558
4800,경상남도,창원시차선거구,6482304,4823,창원시마산합포구,반월중앙동,관내사전투표,2014,2013,552,777,510,97,1936,77,1
4800,경상남도,창원시차선거구,6482304,4823,창원시마산합포구,반월중앙동,선거일투표,9907,4350,1137,1770,983,228,4118,232,5557
4800,경상남도,창원시차선거구,6482304,4823,창원시마산합포구,완월동,계,7828,3959,943,1849,775,208,3775,184,3869
4800,경상남도,창원시차선거구,6482304,4823,창원시마산합포구,완월동,관내사전투표,1377,1374,366,595,285,67,1313,61,3
4800,경상남도,창원시차선거구,6482304,4823,창원시마산합포구,완월동,선거일투표,6451,2585,577,1254,490,141,2462,123,3866
4800,경상남도,창원시차선거구,6482304,4823,창원시마산합포구,잘못 투입·구분된 투표지,,0,14,4,2,6,0,12,2,-14
4800,경상남도,창원시카선거구,6482401,4824,창원시마산회원구,합계,,52522,28206,10737,15385,814,26936,1270,24316
4800,경상남도,창원시카선거구,6482401,4824,창원시마산회원구,거소투표,,119,110,35,58,10,103,7,9
4800,경상남도,창원시카선거구,6482401,4824,창원시마산회원구,관외사전투표,,2881,2876,1207,1502,110,2819,57,5
4800,경상남도,창원시카선거구,6482401,4824,창원시마산회원구,내서읍,계,49522,25187,9481,13811,694,23986,1201,24335
4800,경상남도,창원시카선거구,6482401,4824,창원시마산회원구,내서읍,관내사전투표,5836,5830,2398,3190,149,5737,93,6
4800,경상남도,창원시카선거구,6482401,4824,창원시마산회원구,내서읍,선거일투표,43686,19357,7083,10621,545,18249,1108,24329
4800,경상남도,창원시카선거구,6482401,4824,창원시마산회원구,잘못 투입·구분된 투표지,,0,33,14,14,0,28,5,-33
4800,경상남도,창원시타선거구,6482402,4824,창원시마산회원구,검색된 결과가 없습니다.
4800,경상남도,창원시파선거구,6482403,4824,창원시마산회원구,합계,,61008,32751,10236,11321,3913,5438,30908,1843,28257
4800,경상남도,창원시파선거구,6482403,4824,창원시마산회원구,거소투표,,114,100,36,29,10,16,91,9,14
4800,경상남도,창원시파선거구,6482403,4824,창원시마산회원구,관외사전투표,,2732,2728,1012,1044,288,284,2628,100,4
4800,경상남도,창원시파선거구,6482403,4824,창원시마산회원구,양덕1동,계,9278,4449,1185,1351,435,1226,4197,252,4829
4800,경상남도,창원시파선거구,6482403,4824,창원시마산회원구,양덕1동,관내사전투표,1923,1918,539,594,178,544,1855,63,5
4800,경상남도,창원시파선거구,6482403,4824,창원시마산회원구,양덕1동,선거일투표,7355,2531,646,757,257,682,2342,189,4824
4800,경상남도,창원시파선거구,6482403,4824,창원시마산회원구,양덕2동,계,23594,12649,4279,4492,1721,1593,12085,564,10945
4800,경상남도,창원시파선거구,6482403,4824,창원시마산회원구,양덕2동,관내사전투표,3594,3594,1304,1138,519,535,3496,98,0
4800,경상남도,창원시파선거구,6482403,4824,창원시마산회원구,양덕2동,선거일투표,20000,9055,2975,3354,1202,1058,8589,466,10945
4800,경상남도,창원시파선거구,6482403,4824,창원시마산회원구,합성2동,계,6838,3423,891,1167,445,672,3175,248,3415
4800,경상남도,창원시파선거구,6482403,4824,창원시마산회원구,합성2동,관내사전투표,1460,1457,414,456,201,330,1401,56,3
4800,경상남도,창원시파선거구,6482403,4824,창원시마산회원구,합성2동,선거일투표,5378,1966,477,711,244,342,1774,192,3412
4800,경상남도,창원시파선거구,6482403,4824,창원시마산회원구,구암1동,계,7781,4094,1247,1417,458,718,3840,254,3687
4800,경상남도,창원시파선거구,6482403,4824,창원시마산회원구,구암1동,관내사전투표,1393,1393,432,490,161,269,1352,41,0
4800,경상남도,창원시파선거구,6482403,4824,창원시마산회원구,구암1동,선거일투표,6388,2701,815,927,297,449,2488,213,3687
4800,경상남도,창원시파선거구,6482403,4824,창원시마산회원구,구암2동,계,7760,3882,1202,1309,356,738,3605,277,3878
4800,경상남도,창원시파선거구,6482403,4824,창원시마산회원구,구암2동,관내사전투표,1180,1178,393,367,98,271,1129,49,2
4800,경상남도,창원시파선거구,6482403,4824,창원시마산회원구,구암2동,선거일투표,6580,2704,809,942,258,467,2476,228,3876
4800,경상남도,창원시파선거구,6482403,4824,창원시마산회원구,봉암동,계,2911,1398,380,502,197,185,1264,134,1513
4800,경상남도,창원시파선거구,6482403,4824,창원시마산회원구,봉암동,관내사전투표,545,543,174,190,72,87,523,20,2
4800,경상남도,창원시파선거구,6482403,4824,창원시마산회원구,봉암동,선거일투표,2366,855,206,312,125,98,741,114,1511
4800,경상남도,창원시파선거구,6482403,4824,창원시마산회원구,잘못 투입·구분된 투표지,,0,28,4,10,3,6,23,5,-28
4800,경상남도,창원시하선거구,6482501,4825,창원시진해구,합계,,25333,13391,3221,6890,2716,12827,564,11942
4800,경상남도,창원시하선거구,6482501,4825,창원시진해구,거소투표,,744,715,256,322,64,642,73,29
4800,경상남도,창원시하선거구,6482501,4825,창원시진해구,관외사전투표,,948,948,321,496,104,921,27,0
4800,경상남도,창원시하선거구,6482501,4825,창원시진해구,충무동,계,12938,6049,1502,3194,1073,5769,280,6889
4800,경상남도,창원시하선거구,6482501,4825,창원시진해구,충무동,관내사전투표,1684,1684,493,877,265,1635,49,0
4800,경상남도,창원시하선거구,6482501,4825,창원시진해구,충무동,선거일투표,11254,4365,1009,2317,808,4134,231,6889
4800,경상남도,창원시하선거구,6482501,4825,창원시진해구,여좌동,계,7265,3955,760,1802,1277,3839,116,3310
4800,경상남도,창원시하선거구,6482501,4825,창원시진해구,여좌동,관내사전투표,1412,1409,292,651,437,1380,29,3
4800,경상남도,창원시하선거구,6482501,4825,창원시진해구,여좌동,선거일투표,5853,2546,468,1151,840,2459,87,3307
4800,경상남도,창원시하선거구,6482501,4825,창원시진해구,태백동,계,3438,1716,381,1071,196,1648,68,1722
4800,경상남도,창원시하선거구,6482501,4825,창원시진해구,태백동,관내사전투표,636,636,147,406,79,632,4,0
4800,경상남도,창원시하선거구,6482501,4825,창원시진해구,태백동,선거일투표,2802,1080,234,665,117,1016,64,1722
4800,경상남도,창원시하선거구,6482501,4825,창원시진해구,잘못 투입·구분된 투표지,,0,8,1,5,2,8,0,-8
4800,경상남도,창원시거선거구,6482502,4825,창원시진해구,합계,,29793,15324,4978,6968,2874,14820,504,14469
4800,경상남도,창원시거선거구,6482502,4825,창원시진해구,거소투표,,278,269,82,111,41,234,35,9
4800,경상남도,창원시거선거구,6482502,4825,창원시진해구,관외사전투표,,1476,1476,569,628,235,1432,44,0
4800,경상남도,창원시거선거구,6482502,4825,창원시진해구,경화동,계,8910,4385,1289,2143,822,4254,131,4525
4800,경상남도,창원시거선거구,6482502,4825,창원시진해구,경화동,관내사전투표,1770,1770,576,805,345,1726,44,0
4800,경상남도,창원시거선거구,6482502,4825,창원시진해구,경화동,선거일투표,7140,2615,713,1338,477,2528,87,4525
4800,경상남도,창원시거선거구,6482502,4825,창원시진해구,병암동,계,6007,2876,769,1322,669,2760,116,3131
4800,경상남도,창원시거선거구,6482502,4825,창원시진해구,병암동,관내사전투표,1126,1126,354,493,244,1091,35,0
4800,경상남도,창원시거선거구,6482502,4825,창원시진해구,병암동,선거일투표,4881,1750,415,829,425,1669,81,3131
4800,경상남도,창원시거선거구,6482502,4825,창원시진해구,석동,계,13122,6311,2268,2762,1104,6134,177,6811
4800,경상남도,창원시거선거구,6482502,4825,창원시진해구,석동,관내사전투표,1986,1985,747,841,340,1928,57,1
4800,경상남도,창원시거선거구,6482502,4825,창원시진해구,석동,선거일투표,11136,4326,1521,1921,764,4206,120,6810
4800,경상남도,창원시거선거구,6482502,4825,창원시진해구,잘못 투입·구분된 투표지,,0,7,1,2,3,6,1,-7
4800,경상남도,창원시너선거구,6482503,4825,창원시진해구,합계,,52601,26800,9294,15319,1186,25799,1001,25801
4800,경상남도,창원시너선거구,6482503,4825,창원시진해구,거소투표,,803,754,244,394,63,701,53,49
4800,경상남도,창원시너선거구,6482503,4825,창원시진해구,관외사전투표,,2418,2417,980,1260,101,2341,76,1
4800,경상남도,창원시너선거구,6482503,4825,창원시진해구,이동,계,7359,3264,800,2101,168,3069,195,4095
4800,경상남도,창원시너선거구,6482503,4825,창원시진해구,이동,관내사전투표,980,980,278,629,53,960,20,0
4800,경상남도,창원시너선거구,6482503,4825,창원시진해구,이동,선거일투표,6379,2284,522,1472,115,2109,175,4095
4800,경상남도,창원시너선거구,6482503,4825,창원시진해구,자은동,계,15948,7686,2757,4381,292,7430,256,8262
4800,경상남도,창원시너선거구,6482503,4825,창원시진해구,자은동,관내사전투표,2212,2210,805,1304,81,2190,20,2
4800,경상남도,창원시너선거구,6482503,4825,창원시진해구,자은동,선거일투표,13736,5476,1952,3077,211,5240,236,8260
4800,경상남도,창원시너선거구,6482503,4825,창원시진해구,덕산동,계,7873,3636,1177,2091,202,3470,166,4237
4800,경상남도,창원시너선거구,6482503,4825,창원시진해구,덕산동,관내사전투표,1609,1609,568,914,100,1582,27,0
4800,경상남도,창원시너선거구,6482503,4825,창원시진해구,덕산동,선거일투표,6264,2027,609,1177,102,1888,139,4237
4800,경상남도,창원시너선거구,6482503,4825,창원시진해구,풍호동,계,18200,9028,3331,5084,360,8775,253,9172
4800,경상남도,창원시너선거구,6482503,4825,창원시진해구,풍호동,관내사전투표,2641,2640,1086,1403,109,2598,42,1
4800,경상남도,창원시너선거구,6482503,4825,창원시진해구,풍호동,선거일투표,15559,6388,2245,3681,251,6177,211,9171
4800,경상남도,창원시너선거구,6482503,4825,창원시진해구,잘못 투입·구분된 투표지,,0,15,5,8,0,13,2,-15
4800,경상남도,창원시더선거구,6482504,4825,창원시진해구,합계,,52003,19683,6642,1893,6913,2430,17878,1805,32320
4800,경상남도,창원시더선거구,6482504,4825,창원시진해구,거소투표,,291,276,93,30,98,26,247,29,15
4800,경상남도,창원시더선거구,6482504,4825,창원시진해구,관외사전투표,,1671,1670,509,234,622,150,1515,155,1
4800,경상남도,창원시더선거구,6482504,4825,창원시진해구,웅천동,계,9815,4192,1150,498,1541,535,3724,468,5623
4800,경상남도,창원시더선거구,6482504,4825,창원시진해구,웅천동,관내사전투표,1651,1648,447,180,617,218,1462,186,3
4800,경상남도,창원시더선거구,6482504,4825,창원시진해구,웅천동,선거일투표,8164,2544,703,318,924,317,2262,282,5620
4800,경상남도,창원시더선거구,6482504,4825,창원시진해구,웅동1동,계,6156,2439,698,200,983,336,2217,222,3717
4800,경상남도,창원시더선거구,6482504,4825,창원시진해구,웅동1동,관내사전투표,1020,1000,338,78,355,115,886,114,20
4800,경상남도,창원시더선거구,6482504,4825,창원시진해구,웅동1동,선거일투표,5136,1439,360,122,628,221,1331,108,3697
4800,경상남도,창원시더선거구,6482504,4825,창원시진해구,웅동2동,계,34070,11079,4184,928,3662,1379,10153,926,22991
4800,경상남도,창원시더선거구,6482504,4825,창원시진해구,웅동2동,관내사전투표,3273,3273,1264,263,1060,406,2993,280,0
4800,경상남도,창원시더선거구,6482504,4825,창원시진해구,웅동2동,선거일투표,30797,7806,2920,665,2602,973,7160,646,22991
4800,경상남도,창원시더선거구,6482504,4825,창원시진해구,잘못 투입·구분된 투표지,,0,27,8,3,7,4,22,5,-27
4800,경상남도,진주시가선거구,6480301,4803,진주시,합계,,43491,23078,7110,9301,4004,1574,21989,1089,20413
4800,경상남도,진주시가선거구,6480301,4803,진주시,거소투표,,65,61,14,23,6,4,47,14,4
4800,경상남도,진주시가선거구,6480301,4803,진주시,관외사전투표,,3094,3091,1106,1200,523,171,3000,91,3
4800,경상남도,진주시가선거구,6480301,4803,진주시,문산읍,계,6750,3320,750,1454,648,186,3038,282,3430
4800,경상남도,진주시가선거구,6480301,4803,진주시,문산읍,관내사전투표,1185,1184,338,458,252,86,1134,50,1
4800,경상남도,진주시가선거구,6480301,4803,진주시,문산읍,선거일투표,5565,2136,412,996,396,100,1904,232,3429
4800,경상남도,진주시가선거구,6480301,4803,진주시,내동면,계,3132,1844,434,908,340,81,1763,81,1288
4800,경상남도,진주시가선거구,6480301,4803,진주시,내동면,관내사전투표,830,828,192,393,174,40,799,29,2
4800,경상남도,진주시가선거구,6480301,4803,진주시,내동면,선거일투표,2302,1016,242,515,166,41,964,52,1286
4800,경상남도,진주시가선거구,6480301,4803,진주시,정촌면,계,6803,3185,792,1355,736,164,3047,138,3618
4800,경상남도,진주시가선거구,6480301,4803,진주시,정촌면,관내사전투표,1297,1296,319,557,336,52,1264,32,1
4800,경상남도,진주시가선거구,6480301,4803,진주시,정촌면,선거일투표,5506,1889,473,798,400,112,1783,106,3617
4800,경상남도,진주시가선거구,6480301,4803,진주시,금곡면,계,1968,1108,136,571,209,106,1022,86,860
4800,경상남도,진주시가선거구,6480301,4803,진주시,금곡면,관내사전투표,369,369,56,183,78,39,356,13,0
4800,경상남도,진주시가선거구,6480301,4803,진주시,금곡면,선거일투표,1599,739,80,388,131,67,666,73,860
4800,경상남도,진주시가선거구,6480301,4803,진주시,충무공동,계,21679,10441,3875,3775,1536,862,10048,393,11238
4800,경상남도,진주시가선거구,6480301,4803,진주시,충무공동,관내사전투표,3293,3291,1353,1122,489,245,3209,82,2
4800,경상남도,진주시가선거구,6480301,4803,진주시,충무공동,선거일투표,18386,7150,2522,2653,1047,617,6839,311,11236
4800,경상남도,진주시가선거구,6480301,4803,진주시,잘못 투입·구분된 투표지,,0,28,3,15,6,0,24,4,-28
4800,경상남도,진주시나선거구,6480302,4803,진주시,합계,,33147,18425,4861,7749,4830,17440,985,14722
4800,경상남도,진주시나선거구,6480302,4803,진주시,거소투표,,60,55,9,24,16,49,6,5
4800,경상남도,진주시나선거구,6480302,4803,진주시,관외사전투표,,2300,2297,749,928,551,2228,69,3
4800,경상남도,진주시나선거구,6480302,4803,진주시,명석면,계,3526,1893,318,814,585,1717,176,1633
4800,경상남도,진주시나선거구,6480302,4803,진주시,명석면,관내사전투표,881,879,163,386,276,825,54,2
4800,경상남도,진주시나선거구,6480302,4803,진주시,명석면,선거일투표,2645,1014,155,428,309,892,122,1631
4800,경상남도,진주시나선거구,6480302,4803,진주시,대평면,계,894,552,82,268,165,515,37,342
4800,경상남도,진주시나선거구,6480302,4803,진주시,대평면,관내사전투표,297,293,40,150,85,275,18,4
4800,경상남도,진주시나선거구,6480302,4803,진주시,대평면,선거일투표,597,259,42,118,80,240,19,338
4800,경상남도,진주시나선거구,6480302,4803,진주시,수곡면,계,1939,1067,210,542,247,999,68,872
4800,경상남도,진주시나선거구,6480302,4803,진주시,수곡면,관내사전투표,433,430,95,206,107,408,22,3
4800,경상남도,진주시나선거구,6480302,4803,진주시,수곡면,선거일투표,1506,637,115,336,140,591,46,869
4800,경상남도,진주시나선거구,6480302,4803,진주시,이현동,계,9418,4831,1073,1944,1541,4558,273,4587
4800,경상남도,진주시나선거구,6480302,4803,진주시,이현동,관내사전투표,1898,1897,442,766,638,1846,51,1
4800,경상남도,진주시나선거구,6480302,4803,진주시,이현동,선거일투표,7520,2934,631,1178,903,2712,222,4586
4800,경상남도,진주시나선거구,6480302,4803,진주시,판문동,계,15010,7703,2410,3221,1719,7350,353,7307
4800,경상남도,진주시나선거구,6480302,4803,진주시,판문동,관내사전투표,2539,2532,850,1017,603,2470,62,7
4800,경상남도,진주시나선거구,6480302,4803,진주시,판문동,선거일투표,12471,5171,1560,2204,1116,4880,291,7300
4800,경상남도,진주시나선거구,6480302,4803,진주시,잘못 투입·구분된 투표지,,0,27,10,8,6,24,3,-27
4800,경상남도,진주시다선거구,6480303,4803,진주시,합계,,32722,17339,4879,7527,3079,1091,16576,763,15383
4800,경상남도,진주시다선거구,6480303,4803,진주시,거소투표,,53,44,13,20,8,2,43,1,9
4800,경상남도,진주시다선거구,6480303,4803,진주시,관외사전투표,,2410,2409,869,989,337,154,2349,60,1
4800,경상남도,진주시다선거구,6480303,4803,진주시,평거동,계,20698,9863,2913,3985,1806,712,9416,447,10835
4800,경상남도,진주시다선거구,6480303,4803,진주시,평거동,관내사전투표,3390,3390,1034,1367,640,245,3286,104,0
4800,경상남도,진주시다선거구,6480303,4803,진주시,평거동,선거일투표,17308,6473,1879,2618,1166,467,6130,343,10835
4800,경상남도,진주시다선거구,6480303,4803,진주시,신안동,계,9561,5014,1080,2532,926,223,4761,253,4547
4800,경상남도,진주시다선거구,6480303,4803,진주시,신안동,관내사전투표,1678,1677,386,827,345,75,1633,44,1
4800,경상남도,진주시다선거구,6480303,4803,진주시,신안동,선거일투표,7883,3337,694,1705,581,148,3128,209,4546
4800,경상남도,진주시다선거구,6480303,4803,진주시,잘못 투입·구분된 투표지,,0,9,4,1,2,0,7,2,-9
4800,경상남도,진주시라선거구,6480304,4803,진주시,합계,,58325,29875,6911,12014,5212,4207,28344,1531,28450
4800,경상남도,진주시라선거구,6480304,4803,진주시,거소투표,,82,80,14,32,18,8,72,8,2
4800,경상남도,진주시라선거구,6480304,4803,진주시,관외사전투표,,3928,3922,1192,1571,571,465,3799,123,6
4800,경상남도,진주시라선거구,6480304,4803,진주시,천전동,계,22893,11594,2262,4888,2480,1418,11048,546,11299
4800,경상남도,진주시라선거구,6480304,4803,진주시,천전동,관내사전투표,3193,3180,643,1348,734,365,3090,90,13
4800,경상남도,진주시라선거구,6480304,4803,진주시,천전동,선거일투표,19700,8414,1619,3540,1746,1053,7958,456,11286
4800,경상남도,진주시라선거구,6480304,4803,진주시,성북동,계,8721,3740,617,1827,800,194,3438,302,4981
4800,경상남도,진주시라선거구,6480304,4803,진주시,성북동,관내사전투표,1073,1072,173,489,293,59,1014,58,1
4800,경상남도,진주시라선거구,6480304,4803,진주시,성북동,선거일투표,7648,2668,444,1338,507,135,2424,244,4980
4800,경상남도,진주시라선거구,6480304,4803,진주시,가호동,계,22701,10494,2816,3683,1335,2115,9949,545,12207
4800,경상남도,진주시라선거구,6480304,4803,진주시,가호동,관내사전투표,2341,2338,783,729,264,494,2270,68,3
4800,경상남도,진주시라선거구,6480304,4803,진주시,가호동,선거일투표,20360,8156,2033,2954,1071,1621,7679,477,12204
4800,경상남도,진주시라선거구,6480304,4803,진주시,잘못 투입·구분된 투표지,,0,45,10,13,8,7,38,7,-45
4800,경상남도,진주시마선거구,6480305,4803,진주시,합계,,24990,14004,3337,4880,3815,1564,13596,408,10986
4800,경상남도,진주시마선거구,6480305,4803,진주시,거소투표,,49,44,10,11,16,2,39,5,5
4800,경상남도,진주시마선거구,6480305,4803,진주시,관외사전투표,,1578,1576,481,633,306,115,1535,41,2
4800,경상남도,진주시마선거구,6480305,4803,진주시,진성면,계,1620,1003,190,183,535,44,952,51,617
4800,경상남도,진주시마선거구,6480305,4803,진주시,진성면,관내사전투표,413,413,84,68,219,17,388,25,0
4800,경상남도,진주시마선거구,6480305,4803,진주시,진성면,선거일투표,1207,590,106,115,316,27,564,26,617
4800,경상남도,진주시마선거구,6480305,4803,진주시,일반성면,계,2459,1614,195,352,471,518,1536,78,845
4800,경상남도,진주시마선거구,6480305,4803,진주시,일반성면,관내사전투표,861,859,104,199,261,238,802,57,2
4800,경상남도,진주시마선거구,6480305,4803,진주시,일반성면,선거일투표,1598,755,91,153,210,280,734,21,843
4800,경상남도,진주시마선거구,6480305,4803,진주시,이반성면,계,1403,813,136,221,241,167,765,48,590
4800,경상남도,진주시마선거구,6480305,4803,진주시,이반성면,관내사전투표,355,355,60,90,112,78,340,15,0
4800,경상남도,진주시마선거구,6480305,4803,진주시,이반성면,선거일투표,1048,458,76,131,129,89,425,33,590
4800,경상남도,진주시마선거구,6480305,4803,진주시,사봉면,계,1286,695,140,205,238,88,671,24,591
4800,경상남도,진주시마선거구,6480305,4803,진주시,사봉면,관내사전투표,322,316,71,94,98,42,305,11,6
4800,경상남도,진주시마선거구,6480305,4803,진주시,사봉면,선거일투표,964,379,69,111,140,46,366,13,585
4800,경상남도,진주시마선거구,6480305,4803,진주시,지수면,계,1222,659,142,179,195,113,629,30,563
4800,경상남도,진주시마선거구,6480305,4803,진주시,지수면,관내사전투표,285,284,50,83,89,47,269,15,1
4800,경상남도,진주시마선거구,6480305,4803,진주시,지수면,선거일투표,937,375,92,96,106,66,360,15,562
4800,경상남도,진주시마선거구,6480305,4803,진주시,금산면,계,15373,7576,2037,3086,1806,517,7446,130,7797
4800,경상남도,진주시마선거구,6480305,4803,진주시,금산면,관내사전투표,2786,2779,806,1072,655,191,2724,55,7
4800,경상남도,진주시마선거구,6480305,4803,진주시,금산면,선거일투표,12587,4797,1231,2014,1151,326,4722,75,7790
4800,경상남도,진주시마선거구,6480305,4803,진주시,잘못 투입·구분된 투표지,,0,24,6,10,7,0,23,1,-24
4800,경상남도,진주시바선거구,6480306,4803,진주시,합계,,48150,24285,5404,10761,5138,2168,23471,814,23865
4800,경상남도,진주시바선거구,6480306,4803,진주시,거소투표,,70,66,15,33,9,4,61,5,4
4800,경상남도,진주시바선거구,6480306,4803,진주시,관외사전투표,,2312,2308,714,1018,350,148,2230,78,4
4800,경상남도,진주시바선거구,6480306,4803,진주시,상대동,계,16305,7816,1561,3218,1967,747,7493,323,8489
4800,경상남도,진주시바선거구,6480306,4803,진주시,상대동,관내사전투표,2503,2503,560,1012,665,182,2419,84,0
4800,경상남도,진주시바선거구,6480306,4803,진주시,상대동,선거일투표,13802,5313,1001,2206,1302,565,5074,239,8489
4800,경상남도,진주시바선거구,6480306,4803,진주시,하대동,계,19972,9316,2102,4211,1949,783,9045,271,10656
4800,경상남도,진주시바선거구,6480306,4803,진주시,하대동,관내사전투표,3302,3296,754,1452,741,257,3204,92,6
4800,경상남도,진주시바선거구,6480306,4803,진주시,하대동,선거일투표,16670,6020,1348,2759,1208,526,5841,179,10650
4800,경상남도,진주시바선거구,6480306,4803,진주시,상평동,계,9491,4764,1005,2279,861,483,4628,136,4727
4800,경상남도,진주시바선거구,6480306,4803,진주시,상평동,관내사전투표,1850,1846,401,868,338,184,1791,55,4
4800,경상남도,진주시바선거구,6480306,4803,진주시,상평동,선거일투표,7641,2918,604,1411,523,299,2837,81,4723
4800,경상남도,진주시바선거구,6480306,4803,진주시,잘못 투입·구분된 투표지,,0,15,7,2,2,3,14,1,-15
4800,경상남도,진주시사선거구,6480307,4803,진주시,합계,,28844,16262,4810,5231,3042,2482,15565,697,12582
4800,경상남도,진주시사선거구,6480307,4803,진주시,거소투표,,46,43,15,11,10,3,39,4,3
4800,경상남도,진주시사선거구,6480307,4803,진주시,관외사전투표,,2091,2089,696,662,390,278,2026,63,2
4800,경상남도,진주시사선거구,6480307,4803,진주시,대곡면,계,2890,1620,218,395,322,565,1500,120,1270
4800,경상남도,진주시사선거구,6480307,4803,진주시,대곡면,관내사전투표,602,601,87,148,126,211,572,29,1
4800,경상남도,진주시사선거구,6480307,4803,진주시,대곡면,선거일투표,2288,1019,131,247,196,354,928,91,1269
4800,경상남도,진주시사선거구,6480307,4803,진주시,집현면,계,3715,1869,421,707,421,215,1764,105,1846
4800,경상남도,진주시사선거구,6480307,4803,진주시,집현면,관내사전투표,799,799,195,308,150,107,760,39,0
4800,경상남도,진주시사선거구,6480307,4803,진주시,집현면,선거일투표,2916,1070,226,399,271,108,1004,66,1846
4800,경상남도,진주시사선거구,6480307,4803,진주시,미천면,계,1343,724,69,396,129,72,666,58,619
4800,경상남도,진주시사선거구,6480307,4803,진주시,미천면,관내사전투표,238,237,29,120,39,28,216,21,1
4800,경상남도,진주시사선거구,6480307,4803,진주시,미천면,선거일투표,1105,487,40,276,90,44,450,37,618
4800,경상남도,진주시사선거구,6480307,4803,진주시,초장동,계,18759,9900,3389,3054,1766,1348,9557,343,8859
4800,경상남도,진주시사선거구,6480307,4803,진주시,초장동,관내사전투표,3185,3180,1088,1001,569,450,3108,72,5
4800,경상남도,진주시사선거구,6480307,4803,진주시,초장동,선거일투표,15574,6720,2301,2053,1197,898,6449,271,8854
4800,경상남도,진주시사선거구,6480307,4803,진주시,잘못 투입·구분된 투표지,,0,17,2,6,4,1,13,4,-17
4800,경상남도,진주시아선거구,6480308,4803,진주시,합계,,22499,11893,2202,5540,2715,728,11185,708,10606
4800,경상남도,진주시아선거구,6480308,4803,진주시,거소투표,,38,35,9,16,6,1,32,3,3
4800,경상남도,진주시아선거구,6480308,4803,진주시,관외사전투표,,1168,1168,369,501,181,68,1119,49,0
4800,경상남도,진주시아선거구,6480308,4803,진주시,중앙동,계,9463,4790,685,2357,1208,222,4472,318,4673
4800,경상남도,진주시아선거구,6480308,4803,진주시,중앙동,관내사전투표,1574,1572,219,839,367,69,1494,78,2
4800,경상남도,진주시아선거구,6480308,4803,진주시,중앙동,선거일투표,7889,3218,466,1518,841,153,2978,240,4671
4800,경상남도,진주시아선거구,6480308,4803,진주시,상봉동,계,11830,5892,1138,2664,1319,435,5556,336,5938
4800,경상남도,진주시아선거구,6480308,4803,진주시,상봉동,관내사전투표,2332,2332,455,1131,496,167,2249,83,0
4800,경상남도,진주시아선거구,6480308,4803,진주시,상봉동,선거일투표,9498,3560,683,1533,823,268,3307,253,5938
4800,경상남도,진주시아선거구,6480308,4803,진주시,잘못 투입·구분된 투표지,,0,8,1,2,1,2,6,2,-8
4800,경상남도,통영시가선거구,6480501,4805,통영시,합계,,36778,20402,5848,7462,2432,4179,19921,481,16376
4800,경상남도,통영시가선거구,6480501,4805,통영시,거소투표,,66,57,19,26,2,8,55,2,9
4800,경상남도,통영시가선거구,6480501,4805,통영시,관외사전투표,,2482,2482,911,891,262,347,2411,71,0
4800,경상남도,통영시가선거구,6480501,4805,통영시,용남면,계,9271,4859,906,1451,752,1653,4762,97,4412
4800,경상남도,통영시가선거구,6480501,4805,통영시,용남면,관내사전투표,1580,1580,333,444,243,533,1553,27,0
4800,경상남도,통영시가선거구,6480501,4805,통영시,용남면,선거일투표,7691,3279,573,1007,509,1120,3209,70,4412
4800,경상남도,통영시가선거구,6480501,4805,통영시,도산면,계,2575,1650,344,720,202,309,1575,75,925
4800,경상남도,통영시가선거구,6480501,4805,통영시,도산면,관내사전투표,624,623,178,232,67,112,589,34,1
4800,경상남도,통영시가선거구,6480501,4805,통영시,도산면,선거일투표,1951,1027,166,488,135,197,986,41,924
4800,경상남도,통영시가선거구,6480501,4805,통영시,광도면,계,22384,11345,3666,4369,1214,1861,11110,235,11039
4800,경상남도,통영시가선거구,6480501,4805,통영시,광도면,관내사전투표,4134,4132,1483,1461,419,688,4051,81,2
4800,경상남도,통영시가선거구,6480501,4805,통영시,광도면,선거일투표,18250,7213,2183,2908,795,1173,7059,154,11037
4800,경상남도,통영시가선거구,6480501,4805,통영시,잘못 투입·구분된 투표지,,0,9,2,5,0,1,8,1,-9
4800,경상남도,통영시나선거구,6480502,4805,통영시,합계,,27329,16505,2862,2650,4348,1398,1231,1131,236,334,1387,15577,928,10824
4800,경상남도,통영시나선거구,6480502,4805,통영시,거소투표,,72,66,4,10,11,6,6,11,1,2,6,57,9,6
4800,경상남도,통영시나선거구,6480502,4805,통영시,관외사전투표,,1837,1836,410,267,563,130,114,104,12,37,79,1716,120,1
4800,경상남도,통영시나선거구,6480502,4805,통영시,산양읍,계,3819,2238,602,118,760,84,85,300,65,43,56,2113,125,1581
4800,경상남도,통영시나선거구,6480502,4805,통영시,산양읍,관내사전투표,837,837,275,53,260,30,32,91,21,12,17,791,46,0
4800,경상남도,통영시나선거구,6480502,4805,통영시,산양읍,선거일투표,2982,1401,327,65,500,54,53,209,44,31,39,1322,79,1581
4800,경상남도,통영시나선거구,6480502,4805,통영시,욕지면,계,1619,1003,272,62,409,80,30,42,9,23,13,940,63,616
4800,경상남도,통영시나선거구,6480502,4805,통영시,욕지면,관내사전투표,407,407,127,25,150,33,9,19,4,7,6,380,27,0
4800,경상남도,통영시나선거구,6480502,4805,통영시,욕지면,선거일투표,1212,596,145,37,259,47,21,23,5,16,7,560,36,616
4800,경상남도,통영시나선거구,6480502,4805,통영시,한산면,계,1524,1038,221,141,362,40,39,56,12,47,33,951,87,486
4800,경상남도,통영시나선거구,6480502,4805,통영시,한산면,관내사전투표,480,480,126,49,151,19,16,30,6,19,19,435,45,0
4800,경상남도,통영시나선거구,6480502,4805,통영시,한산면,선거일투표,1044,558,95,92,211,21,23,26,6,28,14,516,42,486
4800,경상남도,통영시나선거구,6480502,4805,통영시,사량면,계,1248,856,258,38,280,22,36,135,2,9,9,789,67,392
4800,경상남도,통영시나선거구,6480502,4805,통영시,사량면,관내사전투표,506,506,168,21,154,16,17,79,1,6,5,467,39,0
4800,경상남도,통영시나선거구,6480502,4805,통영시,사량면,선거일투표,742,350,90,17,126,6,19,56,1,3,4,322,28,392
4800,경상남도,통영시나선거구,6480502,4805,통영시,미수동,계,8509,4698,617,871,955,466,686,262,65,78,493,4493,205,3811
4800,경상남도,통영시나선거구,6480502,4805,통영시,미수동,관내사전투표,1942,1942,246,396,375,188,265,110,28,32,210,1850,92,0
4800,경상남도,통영시나선거구,6480502,4805,통영시,미수동,선거일투표,6567,2756,371,475,580,278,421,152,37,46,283,2643,113,3811
4800,경상남도,통영시나선거구,6480502,4805,통영시,봉평동,계,8701,4770,478,1143,1008,570,235,221,70,95,698,4518,252,3931
4800,경상남도,통영시나선거구,6480502,4805,통영시,봉평동,관내사전투표,1763,1763,206,479,364,192,81,75,24,35,205,1661,102,0
4800,경상남도,통영시나선거구,6480502,4805,통영시,봉평동,선거일투표,6938,3007,272,664,644,378,154,146,46,60,493,2857,150,3931
4800,경상남도,통영시나선거구,6480502,4805,통영시,잘못 투입·구분된 투표지,,0,0,0,0,0,0,0,0,0,0,0,0,0,0
4800,경상남도,통영시다선거구,6480503,4805,통영시,합계,,13825,8182,1734,2466,2006,1669,7875,307,5643
4800,경상남도,통영시다선거구,6480503,4805,통영시,거소투표,,26,26,7,14,3,1,25,1,0
4800,경상남도,통영시다선거구,6480503,4805,통영시,관외사전투표,,795,793,285,236,124,115,760,33,2
4800,경상남도,통영시다선거구,6480503,4805,통영시,도천동,계,7086,3820,774,1321,953,629,3677,143,3266
4800,경상남도,통영시다선거구,6480503,4805,통영시,도천동,관내사전투표,986,983,220,301,255,164,940,43,3
4800,경상남도,통영시다선거구,6480503,4805,통영시,도천동,선거일투표,6100,2837,554,1020,698,465,2737,100,3263
4800,경상남도,통영시다선거구,6480503,4805,통영시,명정동,계,2649,1675,346,467,435,356,1604,71,974
4800,경상남도,통영시다선거구,6480503,4805,통영시,명정동,관내사전투표,851,848,179,229,219,177,804,44,3
4800,경상남도,통영시다선거구,6480503,4805,통영시,명정동,선거일투표,1798,827,167,238,216,179,800,27,971
4800,경상남도,통영시다선거구,6480503,4805,통영시,중앙동,계,3269,1856,320,422,489,566,1797,59,1413
4800,경상남도,통영시다선거구,6480503,4805,통영시,중앙동,관내사전투표,668,667,117,130,178,213,638,29,1
4800,경상남도,통영시다선거구,6480503,4805,통영시,중앙동,선거일투표,2601,1189,203,292,311,353,1159,30,1412
4800,경상남도,통영시다선거구,6480503,4805,통영시,잘못 투입·구분된 투표지,,0,12,2,6,2,2,12,0,-12
4800,경상남도,통영시라선거구,6480504,4805,통영시,합계,,28132,16152,4217,6916,4545,15678,474,11980
4800,경상남도,통영시라선거구,6480504,4805,통영시,거소투표,,55,53,18,19,7,44,9,2
4800,경상남도,통영시라선거구,6480504,4805,통영시,관외사전투표,,1671,1670,641,597,394,1632,38,1
4800,경상남도,통영시라선거구,6480504,4805,통영시,정량동,계,7443,4022,923,1874,1094,3891,131,3421
4800,경상남도,통영시라선거구,6480504,4805,통영시,정량동,관내사전투표,1495,1494,366,654,408,1428,66,1
4800,경상남도,통영시라선거구,6480504,4805,통영시,정량동,선거일투표,5948,2528,557,1220,686,2463,65,3420
4800,경상남도,통영시라선거구,6480504,4805,통영시,북신동,계,8132,4612,1035,2038,1393,4466,146,3520
4800,경상남도,통영시라선거구,6480504,4805,통영시,북신동,관내사전투표,1289,1289,324,501,408,1233,56,0
4800,경상남도,통영시라선거구,6480504,4805,통영시,북신동,선거일투표,6843,3323,711,1537,985,3233,90,3520
4800,경상남도,통영시라선거구,6480504,4805,통영시,무전동,계,10831,5788,1598,2385,1656,5639,149,5043
4800,경상남도,통영시라선거구,6480504,4805,통영시,무전동,관내사전투표,1870,1869,567,678,558,1803,66,1
4800,경상남도,통영시라선거구,6480504,4805,통영시,무전동,선거일투표,8961,3919,1031,1707,1098,3836,83,5042
4800,경상남도,통영시라선거구,6480504,4805,통영시,잘못 투입·구분된 투표지,,0,7,2,3,1,6,1,-7
4800,경상남도,고성군가선거구,6480601,4806,고성군,합계,,21678,14344,2558,2661,1290,1877,1422,2279,423,1101,242,13853,491,7334
4800,경상남도,고성군가선거구,6480601,4806,고성군,거소투표,,84,79,9,17,11,8,5,9,4,5,4,72,7,5
4800,경상남도,고성군가선거구,6480601,4806,고성군,관외사전투표,,1387,1387,366,247,152,130,95,231,31,86,14,1352,35,0
4800,경상남도,고성군가선거구,6480601,4806,고성군,고성읍,계,18638,11774,2006,2092,1019,1652,1247,1859,341,944,212,11372,402,6864
4800,경상남도,고성군가선거구,6480601,4806,고성군,고성읍,관내사전투표,4699,4696,928,776,375,628,447,832,113,379,73,4551,145,3
4800,경상남도,고성군가선거구,6480601,4806,고성군,고성읍,선거일투표,13939,7078,1078,1316,644,1024,800,1027,228,565,139,6821,257,6861
4800,경상남도,고성군가선거구,6480601,4806,고성군,대가면,계,1569,1104,177,305,108,87,75,180,47,66,12,1057,47,465
4800,경상남도,고성군가선거구,6480601,4806,고성군,대가면,관내사전투표,546,546,94,130,55,42,32,103,28,36,4,524,22,0
4800,경상남도,고성군가선거구,6480601,4806,고성군,대가면,선거일투표,1023,558,83,175,53,45,43,77,19,30,8,533,25,465
4800,경상남도,고성군가선거구,6480601,4806,고성군,잘못 투입·구분된 투표지,,0,0,0,0,0,0,0,0,0,0,0,0,0,0
4800,경상남도,고성군나선거구,6480602,4806,고성군,합계,,8158,6083,1301,2318,1449,744,5812,271,2075
4800,경상남도,고성군나선거구,6480602,4806,고성군,거소투표,,89,80,17,29,24,10,80,0,9
4800,경상남도,고성군나선거구,6480602,4806,고성군,관외사전투표,,780,771,233,295,143,71,742,29,9
4800,경상남도,고성군나선거구,6480602,4806,고성군,삼산면,계,1455,944,157,361,305,81,904,40,511
4800,경상남도,고성군나선거구,6480602,4806,고성군,삼산면,관내사전투표,469,467,94,154,160,35,443,24,2
4800,경상남도,고성군나선거구,6480602,4806,고성군,삼산면,선거일투표,986,477,63,207,145,46,461,16,509
4800,경상남도,고성군나선거구,6480602,4806,고성군,하일면,계,1528,1151,68,218,451,343,1080,71,377
4800,경상남도,고성군나선거구,6480602,4806,고성군,하일면,관내사전투표,631,630,31,126,247,180,584,46,1
4800,경상남도,고성군나선거구,6480602,4806,고성군,하일면,선거일투표,897,521,37,92,204,163,496,25,376
4800,경상남도,고성군나선거구,6480602,4806,고성군,하이면,계,2204,1581,615,507,278,131,1531,50,623
4800,경상남도,고성군나선거구,6480602,4806,고성군,하이면,관내사전투표,831,830,311,266,160,63,800,30,1
4800,경상남도,고성군나선거구,6480602,4806,고성군,하이면,선거일투표,1373,751,304,241,118,68,731,20,622
4800,경상남도,고성군나선거구,6480602,4806,고성군,상리면,계,1356,983,115,637,126,66,944,39,373
4800,경상남도,고성군나선거구,6480602,4806,고성군,상리면,관내사전투표,497,496,63,307,63,40,473,23,1
4800,경상남도,고성군나선거구,6480602,4806,고성군,상리면,선거일투표,859,487,52,330,63,26,471,16,372
4800,경상남도,고성군나선거구,6480602,4806,고성군,영현면,계,746,558,92,265,121,39,517,41,188
4800,경상남도,고성군나선거구,6480602,4806,고성군,영현면,관내사전투표,290,290,49,141,49,19,258,32,0
4800,경상남도,고성군나선거구,6480602,4806,고성군,영현면,선거일투표,456,268,43,124,72,20,259,9,188
4800,경상남도,고성군나선거구,6480602,4806,고성군,잘못 투입·구분된 투표지,,0,15,4,6,1,3,14,1,-15
4800,경상남도,고성군다선거구,6480603,4806,고성군,합계,,14909,9877,2065,3630,2304,1483,9482,395,5032
4800,경상남도,고성군다선거구,6480603,4806,고성군,거소투표,,183,174,42,83,20,9,154,20,9
4800,경상남도,고성군다선거구,6480603,4806,고성군,관외사전투표,,1006,1006,269,374,228,116,987,19,0
4800,경상남도,고성군다선거구,6480603,4806,고성군,영오면,계,1209,775,141,410,106,83,740,35,434
4800,경상남도,고성군다선거구,6480603,4806,고성군,영오면,관내사전투표,309,309,62,160,47,25,294,15,0
4800,경상남도,고성군다선거구,6480603,4806,고성군,영오면,선거일투표,900,466,79,250,59,58,446,20,434
4800,경상남도,고성군다선거구,6480603,4806,고성군,개천면,계,935,627,116,315,93,76,600,27,308
4800,경상남도,고성군다선거구,6480603,4806,고성군,개천면,관내사전투표,211,210,35,103,30,27,195,15,1
4800,경상남도,고성군다선거구,6480603,4806,고성군,개천면,선거일투표,724,417,81,212,63,49,405,12,307
4800,경상남도,고성군다선거구,6480603,4806,고성군,구만면,계,920,602,190,279,61,37,567,35,318
4800,경상남도,고성군다선거구,6480603,4806,고성군,구만면,관내사전투표,286,286,89,129,23,20,261,25,0
4800,경상남도,고성군다선거구,6480603,4806,고성군,구만면,선거일투표,634,316,101,150,38,17,306,10,318
4800,경상남도,고성군다선거구,6480603,4806,고성군,회화면,계,3035,2006,574,1084,168,116,1942,64,1029
4800,경상남도,고성군다선거구,6480603,4806,고성군,회화면,관내사전투표,979,979,296,528,81,51,956,23,0
4800,경상남도,고성군다선거구,6480603,4806,고성군,회화면,선거일투표,2056,1027,278,556,87,65,986,41,1029
4800,경상남도,고성군다선거구,6480603,4806,고성군,마암면,계,1411,862,246,376,108,85,815,47,549
4800,경상남도,고성군다선거구,6480603,4806,고성군,마암면,관내사전투표,338,338,93,152,42,34,321,17,0
4800,경상남도,고성군다선거구,6480603,4806,고성군,마암면,선거일투표,1073,524,153,224,66,51,494,30,549
4800,경상남도,고성군다선거구,6480603,4806,고성군,동해면,계,2538,1593,182,267,850,218,1517,76,945
4800,경상남도,고성군다선거구,6480603,4806,고성군,동해면,관내사전투표,564,562,61,104,300,68,533,29,2
4800,경상남도,고성군다선거구,6480603,4806,고성군,동해면,선거일투표,1974,1031,121,163,550,150,984,47,943
4800,경상남도,고성군다선거구,6480603,4806,고성군,거류면,계,3672,2228,305,442,669,743,2159,69,1444
4800,경상남도,고성군다선거구,6480603,4806,고성군,거류면,관내사전투표,736,736,117,156,251,188,712,24,0
4800,경상남도,고성군다선거구,6480603,4806,고성군,거류면,선거일투표,2936,1492,188,286,418,555,1447,45,1444
4800,경상남도,고성군다선거구,6480603,4806,고성군,잘못 투입·구분된 투표지,,0,4,0,0,1,0,1,3,-4
4800,경상남도,사천시가선거구,6480701,4807,사천시,합계,,26165,13662,3464,3600,2106,558,850,2721,13299,363,12503
4800,경상남도,사천시가선거구,6480701,4807,사천시,거소투표,,62,57,10,20,7,2,4,6,49,8,5
4800,경상남도,사천시가선거구,6480701,4807,사천시,관외사전투표,,1956,1955,656,540,233,74,141,251,1895,60,1
4800,경상남도,사천시가선거구,6480701,4807,사천시,사천읍,계,14574,7092,1743,1850,1220,273,402,1416,6904,188,7482
4800,경상남도,사천시가선거구,6480701,4807,사천시,사천읍,관내사전투표,2765,2760,775,653,435,140,156,536,2695,65,5
4800,경상남도,사천시가선거구,6480701,4807,사천시,사천읍,선거일투표,11809,4332,968,1197,785,133,246,880,4209,123,7477
4800,경상남도,사천시가선거구,6480701,4807,사천시,정동면,계,9573,4549,1053,1188,645,208,303,1045,4442,107,5024
4800,경상남도,사천시가선거구,6480701,4807,사천시,정동면,관내사전투표,1207,1204,304,305,144,50,65,290,1158,46,3
4800,경상남도,사천시가선거구,6480701,4807,사천시,정동면,선거일투표,8366,3345,749,883,501,158,238,755,3284,61,5021
4800,경상남도,사천시가선거구,6480701,4807,사천시,잘못 투입·구분된 투표지,,0,9,2,2,1,1,0,3,9,0,-9
4800,경상남도,사천시나선거구,6480702,4807,사천시,합계,,17998,9886,1841,4053,2216,1481,9591,295,8112
4800,경상남도,사천시나선거구,6480702,4807,사천시,거소투표,,46,42,7,12,11,6,36,6,4
4800,경상남도,사천시나선거구,6480702,4807,사천시,관외사전투표,,1346,1344,323,527,276,177,1303,41,2
4800,경상남도,사천시나선거구,6480702,4807,사천시,사남면,계,11106,5678,1113,1773,1516,1125,5527,151,5428
4800,경상남도,사천시나선거구,6480702,4807,사천시,사남면,관내사전투표,1964,1963,378,680,476,368,1902,61,1
4800,경상남도,사천시나선거구,6480702,4807,사천시,사남면,선거일투표,9142,3715,735,1093,1040,757,3625,90,5427
4800,경상남도,사천시나선거구,6480702,4807,사천시,용현면,계,5500,2818,397,1739,412,173,2721,97,2682
4800,경상남도,사천시나선거구,6480702,4807,사천시,용현면,관내사전투표,1225,1223,169,746,175,73,1163,60,2
4800,경상남도,사천시나선거구,6480702,4807,사천시,용현면,선거일투표,4275,1595,228,993,237,100,1558,37,2680
4800,경상남도,사천시나선거구,6480702,4807,사천시,잘못 투입·구분된 투표지,,0,4,1,2,1,0,4,0,-4
4800,경상남도,사천시다선거구,6480703,4807,사천시,합계,,10514,6948,1718,3059,1910,6687,261,3566
4800,경상남도,사천시다선거구,6480703,4807,사천시,거소투표,,25,25,9,7,3,19,6,0
4800,경상남도,사천시다선거구,6480703,4807,사천시,관외사전투표,,657,653,190,304,144,638,15,4
4800,경상남도,사천시다선거구,6480703,4807,사천시,축동면,계,1380,845,226,315,271,812,33,535
4800,경상남도,사천시다선거구,6480703,4807,사천시,축동면,관내사전투표,299,299,82,100,107,289,10,0
4800,경상남도,사천시다선거구,6480703,4807,사천시,축동면,선거일투표,1081,546,144,215,164,523,23,535
4800,경상남도,사천시다선거구,6480703,4807,사천시,곤양면,계,2995,1970,615,477,800,1892,78,1025
4800,경상남도,사천시다선거구,6480703,4807,사천시,곤양면,관내사전투표,802,801,235,212,308,755,46,1
4800,경상남도,사천시다선거구,6480703,4807,사천시,곤양면,선거일투표,2193,1169,380,265,492,1137,32,1024
4800,경상남도,사천시다선거구,6480703,4807,사천시,곤명면,계,2393,1505,376,540,522,1438,67,888
4800,경상남도,사천시다선거구,6480703,4807,사천시,곤명면,관내사전투표,524,523,133,170,189,492,31,1
4800,경상남도,사천시다선거구,6480703,4807,사천시,곤명면,선거일투표,1869,982,243,370,333,946,36,887
4800,경상남도,사천시다선거구,6480703,4807,사천시,서포면,계,3064,1943,299,1413,169,1881,62,1121
4800,경상남도,사천시다선거구,6480703,4807,사천시,서포면,관내사전투표,776,774,116,557,70,743,31,2
4800,경상남도,사천시다선거구,6480703,4807,사천시,서포면,선거일투표,2288,1169,183,856,99,1138,31,1119
4800,경상남도,사천시다선거구,6480703,4807,사천시,잘못 투입·구분된 투표지,,0,7,3,3,1,7,0,-7
4800,경상남도,사천시라선거구,6480704,4807,사천시,합계,,20101,12957,3050,4755,2227,2474,12506,451,7144
4800,경상남도,사천시라선거구,6480704,4807,사천시,거소투표,,76,74,14,35,15,5,69,5,2
4800,경상남도,사천시라선거구,6480704,4807,사천시,관외사전투표,,1123,1123,336,439,152,165,1092,31,0
4800,경상남도,사천시라선거구,6480704,4807,사천시,동서동,계,5293,3384,806,1319,471,647,3243,141,1909
4800,경상남도,사천시라선거구,6480704,4807,사천시,동서동,관내사전투표,1289,1287,293,533,160,227,1213,74,2
4800,경상남도,사천시라선거구,6480704,4807,사천시,동서동,선거일투표,4004,2097,513,786,311,420,2030,67,1907
4800,경상남도,사천시라선거구,6480704,4807,사천시,선구동,계,4280,2641,554,994,423,581,2552,89,1639
4800,경상남도,사천시라선거구,6480704,4807,사천시,선구동,관내사전투표,874,874,193,330,134,182,839,35,0
4800,경상남도,사천시라선거구,6480704,4807,사천시,선구동,선거일투표,3406,1767,361,664,289,399,1713,54,1639
4800,경상남도,사천시라선거구,6480704,4807,사천시,동서금동,계,5055,3020,560,1141,783,445,2929,91,2035
4800,경상남도,사천시라선거구,6480704,4807,사천시,동서금동,관내사전투표,1314,1313,207,502,332,226,1267,46,1
4800,경상남도,사천시라선거구,6480704,4807,사천시,동서금동,선거일투표,3741,1707,353,639,451,219,1662,45,2034
4800,경상남도,사천시라선거구,6480704,4807,사천시,남양동,계,4274,2710,778,825,383,630,2616,94,1564
4800,경상남도,사천시라선거구,6480704,4807,사천시,남양동,관내사전투표,1129,1127,340,342,160,243,1085,42,2
4800,경상남도,사천시라선거구,6480704,4807,사천시,남양동,선거일투표,3145,1583,438,483,223,387,1531,52,1562
4800,경상남도,사천시라선거구,6480704,4807,사천시,잘못 투입·구분된 투표지,,0,5,2,2,0,1,5,0,-5
4800,경상남도,사천시마선거구,6480705,4807,사천시,합계,,19168,12075,3251,5031,3440,11722,353,7093
4800,경상남도,사천시마선거구,6480705,4807,사천시,거소투표,,52,50,16,16,14,46,4,2
4800,경상남도,사천시마선거구,6480705,4807,사천시,관외사전투표,,1208,1207,412,493,258,1163,44,1
4800,경상남도,사천시마선거구,6480705,4807,사천시,벌용동,계,12358,7424,2041,3087,2103,7231,193,4934
4800,경상남도,사천시마선거구,6480705,4807,사천시,벌용동,관내사전투표,2839,2834,797,1108,859,2764,70,5
4800,경상남도,사천시마선거구,6480705,4807,사천시,벌용동,선거일투표,9519,4590,1244,1979,1244,4467,123,4929
4800,경상남도,사천시마선거구,6480705,4807,사천시,향촌동,계,5550,3387,779,1434,1063,3276,111,2163
4800,경상남도,사천시마선거구,6480705,4807,사천시,향촌동,관내사전투표,1609,1608,384,663,500,1547,61,1
4800,경상남도,사천시마선거구,6480705,4807,사천시,향촌동,선거일투표,3941,1779,395,771,563,1729,50,2162
4800,경상남도,사천시마선거구,6480705,4807,사천시,잘못 투입·구분된 투표지,,0,7,3,1,2,6,1,-7
4800,경상남도,김해시가선거구,6480801,4808,김해시,합계,,70462,33622,8206,7115,10124,4960,30405,3217,36840
4800,경상남도,김해시가선거구,6480801,4808,김해시,거소투표,,168,165,37,39,47,20,143,22,3
4800,경상남도,김해시가선거구,6480801,4808,김해시,관외사전투표,,4223,4217,1133,853,1349,537,3872,345,6
4800,경상남도,김해시가선거구,6480801,4808,김해시,생림면,계,3450,1794,333,310,634,307,1584,210,1656
4800,경상남도,김해시가선거구,6480801,4808,김해시,생림면,관내사전투표,708,706,153,140,237,111,641,65,2
4800,경상남도,김해시가선거구,6480801,4808,김해시,생림면,선거일투표,2742,1088,180,170,397,196,943,145,1654
4800,경상남도,김해시가선거구,6480801,4808,김해시,북부동,계,62621,27398,6694,5903,8077,4093,24767,2631,35223
4800,경상남도,김해시가선거구,6480801,4808,김해시,북부동,관내사전투표,7058,7037,1816,1697,1779,1110,6402,635,21
4800,경상남도,김해시가선거구,6480801,4808,김해시,북부동,선거일투표,55563,20361,4878,4206,6298,2983,18365,1996,35202
4800,경상남도,김해시가선거구,6480801,4808,김해시,잘못 투입·구분된 투표지,,0,48,9,10,17,3,39,9,-48
4800,경상남도,김해시나선거구,6480802,4808,김해시,합계,,43331,20591,4774,3943,4275,5357,18349,2242,22740
4800,경상남도,김해시나선거구,6480802,4808,김해시,거소투표,,90,83,22,18,15,13,68,15,7
4800,경상남도,김해시나선거구,6480802,4808,김해시,관외사전투표,,1761,1755,465,340,481,298,1584,171,6
4800,경상남도,김해시나선거구,6480802,4808,김해시,상동면,계,2741,1365,339,130,422,249,1140,225,1376
4800,경상남도,김해시나선거구,6480802,4808,김해시,상동면,관내사전투표,578,575,148,64,175,101,488,87,3
4800,경상남도,김해시나선거구,6480802,4808,김해시,상동면,선거일투표,2163,790,191,66,247,148,652,138,1373
4800,경상남도,김해시나선거구,6480802,4808,김해시,대동면,계,4938,2774,1034,281,631,545,2491,283,2164
4800,경상남도,김해시나선거구,6480802,4808,김해시,대동면,관내사전투표,802,802,346,98,161,135,740,62,0
4800,경상남도,김해시나선거구,6480802,4808,김해시,대동면,선거일투표,4136,1972,688,183,470,410,1751,221,2164
4800,경상남도,김해시나선거구,6480802,4808,김해시,삼안동,계,27659,11737,2286,2612,2149,3473,10520,1217,15922
4800,경상남도,김해시나선거구,6480802,4808,김해시,삼안동,관내사전투표,3526,3522,755,833,591,1076,3255,267,4
4800,경상남도,김해시나선거구,6480802,4808,김해시,삼안동,선거일투표,24133,8215,1531,1779,1558,2397,7265,950,15918
4800,경상남도,김해시나선거구,6480802,4808,김해시,불암동,계,6142,2847,624,557,570,776,2527,320,3295
4800,경상남도,김해시나선거구,6480802,4808,김해시,불암동,관내사전투표,1044,1042,231,215,217,273,936,106,2
4800,경상남도,김해시나선거구,6480802,4808,김해시,불암동,선거일투표,5098,1805,393,342,353,503,1591,214,3293
4800,경상남도,김해시나선거구,6480802,4808,김해시,잘못 투입·구분된 투표지,,0,30,4,5,7,3,19,11,-30
4800,경상남도,김해시다선거구,6480803,4808,김해시,합계,,51545,22640,6390,2518,7659,3240,1165,20972,1668,28905
4800,경상남도,김해시다선거구,6480803,4808,김해시,거소투표,,111,99,26,8,36,13,9,92,7,12
4800,경상남도,김해시다선거구,6480803,4808,김해시,관외사전투표,,2986,2982,910,336,1026,353,147,2772,210,4
4800,경상남도,김해시다선거구,6480803,4808,김해시,동상동,계,8145,3574,840,555,1254,508,151,3308,266,4571
4800,경상남도,김해시다선거구,6480803,4808,김해시,동상동,관내사전투표,1290,1290,326,220,414,181,53,1194,96,0
4800,경상남도,김해시다선거구,6480803,4808,김해시,동상동,선거일투표,6855,2284,514,335,840,327,98,2114,170,4571
4800,경상남도,김해시다선거구,6480803,4808,김해시,부원동,계,8333,3570,967,377,1266,569,145,3324,246,4763
4800,경상남도,김해시다선거구,6480803,4808,김해시,부원동,관내사전투표,1415,1415,386,156,477,231,59,1309,106,0
4800,경상남도,김해시다선거구,6480803,4808,김해시,부원동,선거일투표,6918,2155,581,221,789,338,86,2015,140,4763
4800,경상남도,김해시다선거구,6480803,4808,김해시,활천동,계,31970,12407,3644,1242,4073,1797,713,11469,938,19563
4800,경상남도,김해시다선거구,6480803,4808,김해시,활천동,관내사전투표,3199,3197,999,329,1006,448,158,2940,257,2
4800,경상남도,김해시다선거구,6480803,4808,김해시,활천동,선거일투표,28771,9210,2645,913,3067,1349,555,8529,681,19561
4800,경상남도,김해시다선거구,6480803,4808,김해시,잘못 투입·구분된 투표지,,0,8,3,0,4,0,0,7,1,-8
4800,경상남도,김해시라선거구,6480804,4808,김해시,합계,,51081,22949,7534,3550,5841,3820,20745,2204,28132
4800,경상남도,김해시라선거구,6480804,4808,김해시,거소투표,,91,86,21,8,34,11,74,12,5
4800,경상남도,김해시라선거구,6480804,4808,김해시,관외사전투표,,2069,2058,691,316,606,256,1869,189,11
4800,경상남도,김해시라선거구,6480804,4808,김해시,진영읍,계,42616,17742,6149,2491,4356,3145,16141,1601,24874
4800,경상남도,김해시라선거구,6480804,4808,김해시,진영읍,관내사전투표,5896,5888,2144,884,1286,1006,5320,568,8
4800,경상남도,김해시라선거구,6480804,4808,김해시,진영읍,선거일투표,36720,11854,4005,1607,3070,2139,10821,1033,24866
4800,경상남도,김해시라선거구,6480804,4808,김해시,한림면,계,6305,3021,659,728,837,402,2626,395,3284
4800,경상남도,김해시라선거구,6480804,4808,김해시,한림면,관내사전투표,1038,1030,231,297,257,128,913,117,8
4800,경상남도,김해시라선거구,6480804,4808,김해시,한림면,선거일투표,5267,1991,428,431,580,274,1713,278,3276
4800,경상남도,김해시라선거구,6480804,4808,김해시,잘못 투입·구분된 투표지,,0,42,14,7,8,6,35,7,-42
4800,경상남도,김해시마선거구,6480805,4808,김해시,검색된 결과가 없습니다.
4800,경상남도,김해시바선거구,6480806,4808,김해시,합계,,61554,28108,8273,5232,9098,3093,25696,2412,33446
4800,경상남도,김해시바선거구,6480806,4808,김해시,거소투표,,106,93,30,13,34,1,78,15,13
4800,경상남도,김해시바선거구,6480806,4808,김해시,관외사전투표,,3190,3190,1084,546,985,313,2928,262,0
4800,경상남도,김해시바선거구,6480806,4808,김해시,회현동,계,7485,3621,968,445,1298,501,3212,409,3864
4800,경상남도,김해시바선거구,6480806,4808,김해시,회현동,관내사전투표,1351,1349,377,164,470,198,1209,140,2
4800,경상남도,김해시바선거구,6480806,4808,김해시,회현동,선거일투표,6134,2272,591,281,828,303,2003,269,3862
4800,경상남도,김해시바선거구,6480806,4808,김해시,칠산서부동,계,8044,3571,1027,390,1312,440,3169,402,4473
4800,경상남도,김해시바선거구,6480806,4808,김해시,칠산서부동,관내사전투표,1277,1274,417,134,449,156,1156,118,3
4800,경상남도,김해시바선거구,6480806,4808,김해시,칠산서부동,선거일투표,6767,2297,610,256,863,284,2013,284,4470
4800,경상남도,김해시바선거구,6480806,4808,김해시,장유1동,계,42729,17598,5153,3833,5460,1838,16284,1314,25131
4800,경상남도,김해시바선거구,6480806,4808,김해시,장유1동,관내사전투표,4850,4847,1411,1200,1493,462,4566,281,3
4800,경상남도,김해시바선거구,6480806,4808,김해시,장유1동,선거일투표,37879,12751,3742,2633,3967,1376,11718,1033,25128
4800,경상남도,김해시바선거구,6480806,4808,김해시,잘못 투입·구분된 투표지,,0,35,11,5,9,0,25,10,-35
4800,경상남도,김해시사선거구,6480807,4808,김해시,합계,,63260,27863,8557,3181,7789,5321,1242,26090,1773,35397
4800,경상남도,김해시사선거구,6480807,4808,김해시,거소투표,,131,123,27,22,29,29,3,110,13,8
4800,경상남도,김해시사선거구,6480807,4808,김해시,관외사전투표,,3436,3435,1191,405,979,524,143,3242,193,1
4800,경상남도,김해시사선거구,6480807,4808,김해시,내외동,계,59693,24297,7337,2753,6777,4768,1096,22731,1566,35396
4800,경상남도,김해시사선거구,6480807,4808,김해시,내외동,관내사전투표,4948,4946,1614,547,1285,978,229,4653,293,2
4800,경상남도,김해시사선거구,6480807,4808,김해시,내외동,선거일투표,54745,19351,5723,2206,5492,3790,867,18078,1273,35394
4800,경상남도,김해시사선거구,6480807,4808,김해시,잘못 투입·구분된 투표지,,0,8,2,1,4,0,0,7,1,-8
4800,경상남도,김해시아선거구,6480808,4808,김해시,합계,,53660,24732,7760,3830,6619,4054,1134,23397,1335,28928
4800,경상남도,김해시아선거구,6480808,4808,김해시,거소투표,,94,89,32,14,19,15,3,83,6,5
4800,경상남도,김해시아선거구,6480808,4808,김해시,관외사전투표,,2535,2532,890,340,655,383,118,2386,146,3
4800,경상남도,김해시아선거구,6480808,4808,김해시,장유3동,계,51031,22093,6837,3468,5941,3652,1012,20910,1183,28938
4800,경상남도,김해시아선거구,6480808,4808,김해시,장유3동,관내사전투표,5946,5936,1929,1060,1423,942,264,5618,318,10
4800,경상남도,김해시아선거구,6480808,4808,김해시,장유3동,선거일투표,45085,16157,4908,2408,4518,2710,748,15292,865,28928
4800,경상남도,김해시아선거구,6480808,4808,김해시,잘못 투입·구분된 투표지,,0,18,1,8,4,4,1,18,0,-18
4800,경상남도,밀양시가선거구,6480901,4809,밀양시,합계,,18132,10363,2115,4233,3353,9701,662,7769
4800,경상남도,밀양시가선거구,6480901,4809,밀양시,거소투표,,34,27,5,8,10,23,4,7
4800,경상남도,밀양시가선거구,6480901,4809,밀양시,관외사전투표,,1411,1407,385,648,335,1368,39,4
4800,경상남도,밀양시가선거구,6480901,4809,밀양시,부북면,계,4370,2250,523,1162,420,2105,145,2120
4800,경상남도,밀양시가선거구,6480901,4809,밀양시,부북면,관내사전투표,824,819,196,412,160,768,51,5
4800,경상남도,밀양시가선거구,6480901,4809,밀양시,부북면,선거일투표,3546,1431,327,750,260,1337,94,2115
4800,경상남도,밀양시가선거구,6480901,4809,밀양시,상동면,계,2743,1497,318,568,499,1385,112,1246
4800,경상남도,밀양시가선거구,6480901,4809,밀양시,상동면,관내사전투표,600,597,128,218,218,564,33,3
4800,경상남도,밀양시가선거구,6480901,4809,밀양시,상동면,선거일투표,2143,900,190,350,281,821,79,1243
4800,경상남도,밀양시가선거구,6480901,4809,밀양시,산외면,계,2481,1365,246,494,533,1273,92,1116
4800,경상남도,밀양시가선거구,6480901,4809,밀양시,산외면,관내사전투표,579,578,120,206,223,549,29,1
4800,경상남도,밀양시가선거구,6480901,4809,밀양시,산외면,선거일투표,1902,787,126,288,310,724,63,1115
4800,경상남도,밀양시가선거구,6480901,4809,밀양시,산내면,계,3352,1760,329,704,600,1633,127,1592
4800,경상남도,밀양시가선거구,6480901,4809,밀양시,산내면,관내사전투표,522,522,124,212,161,497,25,0
4800,경상남도,밀양시가선거구,6480901,4809,밀양시,산내면,선거일투표,2830,1238,205,492,439,1136,102,1592
4800,경상남도,밀양시가선거구,6480901,4809,밀양시,단장면,계,3741,2036,307,642,949,1898,138,1705
4800,경상남도,밀양시가선거구,6480901,4809,밀양시,단장면,관내사전투표,677,675,101,215,319,635,40,2
4800,경상남도,밀양시가선거구,6480901,4809,밀양시,단장면,선거일투표,3064,1361,206,427,630,1263,98,1703
4800,경상남도,밀양시가선거구,6480901,4809,밀양시,잘못 투입·구분된 투표지,,0,21,2,7,7,16,5,-21
4800,경상남도,밀양시나선거구,6480902,4809,밀양시,합계,,18664,10009,2399,3306,2332,1626,9663,346,8655
4800,경상남도,밀양시나선거구,6480902,4809,밀양시,거소투표,,38,35,9,16,5,3,33,2,3
4800,경상남도,밀양시나선거구,6480902,4809,밀양시,관외사전투표,,1508,1506,479,446,304,244,1473,33,2
4800,경상남도,밀양시나선거구,6480902,4809,밀양시,내일동,계,2436,1296,186,560,316,176,1238,58,1140
4800,경상남도,밀양시나선거구,6480902,4809,밀양시,내일동,관내사전투표,555,554,84,241,145,62,532,22,1
4800,경상남도,밀양시나선거구,6480902,4809,밀양시,내일동,선거일투표,1881,742,102,319,171,114,706,36,1139
4800,경상남도,밀양시나선거구,6480902,4809,밀양시,삼문동,계,14682,7159,1723,2279,1706,1200,6908,251,7523
4800,경상남도,밀양시나선거구,6480902,4809,밀양시,삼문동,관내사전투표,2459,2456,626,813,564,402,2405,51,3
4800,경상남도,밀양시나선거구,6480902,4809,밀양시,삼문동,선거일투표,12223,4703,1097,1466,1142,798,4503,200,7520
4800,경상남도,밀양시나선거구,6480902,4809,밀양시,잘못 투입·구분된 투표지,,0,13,2,5,1,3,11,2,-13
4800,경상남도,밀양시다선거구,6480903,4809,밀양시,합계,,19138,9637,1747,3528,1964,552,1573,9364,273,9501
4800,경상남도,밀양시다선거구,6480903,4809,밀양시,거소투표,,31,27,7,9,7,2,1,26,1,4
4800,경상남도,밀양시다선거구,6480903,4809,밀양시,관외사전투표,,1623,1620,386,605,300,81,201,1573,47,3
4800,경상남도,밀양시다선거구,6480903,4809,밀양시,내이동,계,12039,4983,843,1731,1097,290,874,4835,148,7056
4800,경상남도,밀양시다선거구,6480903,4809,밀양시,내이동,관내사전투표,1449,1446,263,499,297,86,270,1415,31,3
4800,경상남도,밀양시다선거구,6480903,4809,밀양시,내이동,선거일투표,10590,3537,580,1232,800,204,604,3420,117,7053
4800,경상남도,밀양시다선거구,6480903,4809,밀양시,교동,계,5445,2997,510,1181,556,178,495,2920,77,2448
4800,경상남도,밀양시다선거구,6480903,4809,밀양시,교동,관내사전투표,1378,1374,255,500,248,95,245,1343,31,4
4800,경상남도,밀양시다선거구,6480903,4809,밀양시,교동,선거일투표,4067,1623,255,681,308,83,250,1577,46,2444
4800,경상남도,밀양시다선거구,6480903,4809,밀양시,잘못 투입·구분된 투표지,,0,10,1,2,4,1,2,10,0,-10
4800,경상남도,밀양시라선거구,6480904,4809,밀양시,합계,,20518,11445,1789,2727,1245,2083,1363,1727,10934,511,9073
4800,경상남도,밀양시라선거구,6480904,4809,밀양시,거소투표,,136,124,34,31,13,9,7,8,102,22,12
4800,경상남도,밀양시라선거구,6480904,4809,밀양시,관외사전투표,,1191,1190,321,367,68,165,74,160,1155,35,1
4800,경상남도,밀양시라선거구,6480904,4809,밀양시,삼랑진읍,계,5704,3043,291,547,900,326,702,127,2893,150,2661
4800,경상남도,밀양시라선거구,6480904,4809,밀양시,삼랑진읍,관내사전투표,952,950,115,165,267,69,252,43,911,39,2
4800,경상남도,밀양시라선거구,6480904,4809,밀양시,삼랑진읍,선거일투표,4752,2093,176,382,633,257,450,84,1982,111,2659
4800,경상남도,밀양시라선거구,6480904,4809,밀양시,상남면,계,6803,3613,403,961,118,753,203,1012,3450,163,3190
4800,경상남도,밀양시라선거구,6480904,4809,밀양시,상남면,관내사전투표,898,889,96,237,34,180,48,263,858,31,9
4800,경상남도,밀양시라선거구,6480904,4809,밀양시,상남면,선거일투표,5905,2724,307,724,84,573,155,749,2592,132,3181
4800,경상남도,밀양시라선거구,6480904,4809,밀양시,가곡동,계,6684,3445,736,815,144,824,374,414,3307,138,3239
4800,경상남도,밀양시라선거구,6480904,4809,밀양시,가곡동,관내사전투표,1259,1257,311,282,42,281,147,153,1216,41,2
4800,경상남도,밀양시라선거구,6480904,4809,밀양시,가곡동,선거일투표,5425,2188,425,533,102,543,227,261,2091,97,3237
4800,경상남도,밀양시라선거구,6480904,4809,밀양시,잘못 투입·구분된 투표지,,0,30,4,6,2,6,3,6,27,3,-30
4800,경상남도,밀양시마선거구,6480905,4809,밀양시,합계,,15967,9109,1961,3945,2789,8695,414,6858
4800,경상남도,밀양시마선거구,6480905,4809,밀양시,거소투표,,79,71,19,27,12,58,13,8
4800,경상남도,밀양시마선거구,6480905,4809,밀양시,관외사전투표,,836,836,226,401,187,814,22,0
4800,경상남도,밀양시마선거구,6480905,4809,밀양시,하남읍,계,6243,3330,968,1868,361,3197,133,2913
4800,경상남도,밀양시마선거구,6480905,4809,밀양시,하남읍,관내사전투표,1157,1137,341,611,129,1081,56,20
4800,경상남도,밀양시마선거구,6480905,4809,밀양시,하남읍,선거일투표,5086,2193,627,1257,232,2116,77,2893
4800,경상남도,밀양시마선거구,6480905,4809,밀양시,초동면,계,2911,1557,294,720,460,1474,83,1354
4800,경상남도,밀양시마선거구,6480905,4809,밀양시,초동면,관내사전투표,692,692,130,323,197,650,42,0
4800,경상남도,밀양시마선거구,6480905,4809,밀양시,초동면,선거일투표,2219,865,164,397,263,824,41,1354
4800,경상남도,밀양시마선거구,6480905,4809,밀양시,무안면,계,4273,2367,272,561,1426,2259,108,1906
4800,경상남도,밀양시마선거구,6480905,4809,밀양시,무안면,관내사전투표,1038,1037,126,245,594,965,72,1
4800,경상남도,밀양시마선거구,6480905,4809,밀양시,무안면,선거일투표,3235,1330,146,316,832,1294,36,1905
4800,경상남도,밀양시마선거구,6480905,4809,밀양시,청도면,계,1625,925,178,356,337,871,54,700
4800,경상남도,밀양시마선거구,6480905,4809,밀양시,청도면,관내사전투표,394,394,73,164,137,374,20,0
4800,경상남도,밀양시마선거구,6480905,4809,밀양시,청도면,선거일투표,1231,531,105,192,200,497,34,700
4800,경상남도,밀양시마선거구,6480905,4809,밀양시,잘못 투입·구분된 투표지,,0,23,4,12,6,22,1,-23
4800,경상남도,거제시가선거구,6481001,4810,거제시,합계,,24016,13815,3195,1739,5324,1542,1564,13364,451,10201
4800,경상남도,거제시가선거구,6481001,4810,거제시,거소투표,,112,104,59,6,20,10,6,101,3,8
4800,경상남도,거제시가선거구,6481001,4810,거제시,관외사전투표,,1550,1549,422,242,648,89,118,1519,30,1
4800,경상남도,거제시가선거구,6481001,4810,거제시,동부면,계,2645,1641,512,104,703,129,122,1570,71,1004
4800,경상남도,거제시가선거구,6481001,4810,거제시,동부면,관내사전투표,815,814,279,68,329,56,55,787,27,1
4800,경상남도,거제시가선거구,6481001,4810,거제시,동부면,선거일투표,1830,827,233,36,374,73,67,783,44,1003
4800,경상남도,거제시가선거구,6481001,4810,거제시,남부면,계,1347,787,244,52,331,108,27,762,25,560
4800,경상남도,거제시가선거구,6481001,4810,거제시,남부면,관내사전투표,377,377,117,21,152,64,13,367,10,0
4800,경상남도,거제시가선거구,6481001,4810,거제시,남부면,선거일투표,970,410,127,31,179,44,14,395,15,560
4800,경상남도,거제시가선거구,6481001,4810,거제시,거제면,계,6149,3380,1042,369,1336,309,200,3256,124,2769
4800,경상남도,거제시가선거구,6481001,4810,거제시,거제면,관내사전투표,1419,1417,456,182,533,109,93,1373,44,2
4800,경상남도,거제시가선거구,6481001,4810,거제시,거제면,선거일투표,4730,1963,586,187,803,200,107,1883,80,2767
4800,경상남도,거제시가선거구,6481001,4810,거제시,둔덕면,계,2548,1489,264,106,659,195,209,1433,56,1059
4800,경상남도,거제시가선거구,6481001,4810,거제시,둔덕면,관내사전투표,730,730,149,56,303,95,104,707,23,0
4800,경상남도,거제시가선거구,6481001,4810,거제시,둔덕면,선거일투표,1818,759,115,50,356,100,105,726,33,1059
4800,경상남도,거제시가선거구,6481001,4810,거제시,사등면,계,9665,4860,652,858,1624,702,882,4718,142,4805
4800,경상남도,거제시가선거구,6481001,4810,거제시,사등면,관내사전투표,1562,1561,263,291,510,202,258,1524,37,1
4800,경상남도,거제시가선거구,6481001,4810,거제시,사등면,선거일투표,8103,3299,389,567,1114,500,624,3194,105,4804
4800,경상남도,거제시가선거구,6481001,4810,거제시,잘못 투입·구분된 투표지,,0,5,0,2,3,0,0,5,0,-5
4800,경상남도,거제시나선거구,6481002,4810,거제시,합계,,44747,23061,7688,3164,7521,2436,1266,22075,986,21686
4800,경상남도,거제시나선거구,6481002,4810,거제시,거소투표,,192,179,58,25,32,19,13,147,32,13
4800,경상남도,거제시나선거구,6481002,4810,거제시,관외사전투표,,2605,2582,885,404,799,272,122,2482,100,23
4800,경상남도,거제시나선거구,6481002,4810,거제시,일운면,계,6671,3570,730,363,1973,228,86,3380,190,3101
4800,경상남도,거제시나선거구,6481002,4810,거제시,일운면,관내사전투표,1630,1628,325,163,915,96,42,1541,87,2
4800,경상남도,거제시나선거구,6481002,4810,거제시,일운면,선거일투표,5041,1942,405,200,1058,132,44,1839,103,3099
4800,경상남도,거제시나선거구,6481002,4810,거제시,장승포동,계,4945,2369,643,384,844,236,146,2253,116,2576
4800,경상남도,거제시나선거구,6481002,4810,거제시,장승포동,관내사전투표,1175,1175,332,219,403,94,76,1124,51,0
4800,경상남도,거제시나선거구,6481002,4810,거제시,장승포동,선거일투표,3770,1194,311,165,441,142,70,1129,65,2576
4800,경상남도,거제시나선거구,6481002,4810,거제시,능포동,계,7502,3844,976,741,1329,338,290,3674,170,3658
4800,경상남도,거제시나선거구,6481002,4810,거제시,능포동,관내사전투표,1484,1484,411,315,495,103,96,1420,64,0
4800,경상남도,거제시나선거구,6481002,4810,거제시,능포동,선거일투표,6018,2360,565,426,834,235,194,2254,106,3658
4800,경상남도,거제시나선거구,6481002,4810,거제시,상문동,계,22832,10514,4394,1247,2543,1343,609,10136,378,12318
4800,경상남도,거제시나선거구,6481002,4810,거제시,상문동,관내사전투표,3351,3351,1430,452,806,370,172,3230,121,0
4800,경상남도,거제시나선거구,6481002,4810,거제시,상문동,선거일투표,19481,7163,2964,795,1737,973,437,6906,257,12318
4800,경상남도,거제시나선거구,6481002,4810,거제시,잘못 투입·구분된 투표지,,0,3,2,0,1,0,0,3,0,-3
4800,경상남도,거제시다선거구,6481003,4810,거제시,합계,,42506,21567,5517,5125,2480,3087,1467,252,2920,20848,719,20939
4800,경상남도,거제시다선거구,6481003,4810,거제시,거소투표,,74,71,24,14,9,7,2,2,8,66,5,3
4800,경상남도,거제시다선거구,6481003,4810,거제시,관외사전투표,,1949,1949,642,503,196,221,76,23,212,1873,76,0
4800,경상남도,거제시다선거구,6481003,4810,거제시,연초면,계,6518,2995,579,654,362,738,114,34,392,2873,122,3523
4800,경상남도,거제시다선거구,6481003,4810,거제시,연초면,관내사전투표,1017,1017,210,209,117,243,34,9,157,979,38,0
4800,경상남도,거제시다선거구,6481003,4810,거제시,연초면,선거일투표,5501,1978,369,445,245,495,80,25,235,1894,84,3523
4800,경상남도,거제시다선거구,6481003,4810,거제시,하청면,계,3872,2114,277,498,523,353,38,141,206,2036,78,1758
4800,경상남도,거제시다선거구,6481003,4810,거제시,하청면,관내사전투표,943,921,133,202,213,169,20,65,86,888,33,22
4800,경상남도,거제시다선거구,6481003,4810,거제시,하청면,선거일투표,2929,1193,144,296,310,184,18,76,120,1148,45,1736
4800,경상남도,거제시다선거구,6481003,4810,거제시,장목면,계,3936,2116,199,533,300,478,41,9,442,2002,114,1820
4800,경상남도,거제시다선거구,6481003,4810,거제시,장목면,관내사전투표,808,808,89,204,107,153,19,4,179,755,53,0
4800,경상남도,거제시다선거구,6481003,4810,거제시,장목면,선거일투표,3128,1308,110,329,193,325,22,5,263,1247,61,1820
4800,경상남도,거제시다선거구,6481003,4810,거제시,옥포1동,계,6357,3241,1034,848,263,306,248,10,434,3143,98,3116
4800,경상남도,거제시다선거구,6481003,4810,거제시,옥포1동,관내사전투표,1764,1764,611,459,116,173,127,7,226,1719,45,0
4800,경상남도,거제시다선거구,6481003,4810,거제시,옥포1동,선거일투표,4593,1477,423,389,147,133,121,3,208,1424,53,3116
4800,경상남도,거제시다선거구,6481003,4810,거제시,옥포2동,계,19800,9059,2759,2071,823,981,947,31,1223,8835,224,10741
4800,경상남도,거제시다선거구,6481003,4810,거제시,옥포2동,관내사전투표,2785,2785,940,620,202,265,304,7,387,2725,60,0
4800,경상남도,거제시다선거구,6481003,4810,거제시,옥포2동,선거일투표,17015,6274,1819,1451,621,716,643,24,836,6110,164,10741
4800,경상남도,거제시다선거구,6481003,4810,거제시,잘못 투입·구분된 투표지,,0,22,3,4,4,3,1,2,3,20,2,-22
4800,경상남도,거제시라선거구,6481004,4810,거제시,합계,,19654,9198,4127,2862,1971,8960,238,10456
4800,경상남도,거제시라선거구,6481004,4810,거제시,거소투표,,32,31,13,11,3,27,4,1
4800,경상남도,거제시라선거구,6481004,4810,거제시,관외사전투표,,973,972,427,366,154,947,25,1
4800,경상남도,거제시라선거구,6481004,4810,거제시,아주동,계,18649,8188,3683,2484,1813,7980,208,10461
4800,경상남도,거제시라선거구,6481004,4810,거제시,아주동,관내사전투표,2124,2121,970,613,502,2085,36,3
4800,경상남도,거제시라선거구,6481004,4810,거제시,아주동,선거일투표,16525,6067,2713,1871,1311,5895,172,10458
4800,경상남도,거제시라선거구,6481004,4810,거제시,잘못 투입·구분된 투표지,,0,7,4,1,1,6,1,-7
4800,경상남도,거제시마선거구,6481005,4810,거제시,합계,,62446,31650,4985,3735,3562,6564,1623,1884,3607,1201,2952,30113,1537,30796
4800,경상남도,거제시마선거구,6481005,4810,거제시,거소투표,,83,78,14,11,5,17,6,2,9,1,2,67,11,5
4800,경상남도,거제시마선거구,6481005,4810,거제시,관외사전투표,,3026,3026,553,401,341,687,156,153,299,95,165,2850,176,0
4800,경상남도,거제시마선거구,6481005,4810,거제시,장평동,계,16966,7370,909,960,778,1439,410,345,758,143,1289,7031,339,9596
4800,경상남도,거제시마선거구,6481005,4810,거제시,장평동,관내사전투표,3110,3110,411,429,315,587,149,147,301,51,546,2936,174,0
4800,경상남도,거제시마선거구,6481005,4810,거제시,장평동,선거일투표,13856,4260,498,531,463,852,261,198,457,92,743,4095,165,9596
4800,경상남도,거제시마선거구,6481005,4810,거제시,고현동,계,25864,12277,1731,1304,1385,2738,712,727,1681,398,955,11631,646,13587
4800,경상남도,거제시마선거구,6481005,4810,거제시,고현동,관내사전투표,3190,3190,460,331,378,718,167,167,431,116,228,2996,194,0
4800,경상남도,거제시마선거구,6481005,4810,거제시,고현동,선거일투표,22674,9087,1271,973,1007,2020,545,560,1250,282,727,8635,452,13587
4800,경상남도,거제시마선거구,6481005,4810,거제시,수양동,계,16507,8899,1778,1059,1053,1683,339,657,860,564,541,8534,365,7608
4800,경상남도,거제시마선거구,6481005,4810,거제시,수양동,관내사전투표,3677,3677,802,468,432,655,117,266,356,220,207,3523,154,0
4800,경상남도,거제시마선거구,6481005,4810,거제시,수양동,선거일투표,12830,5222,976,591,621,1028,222,391,504,344,334,5011,211,7608
4800,경상남도,거제시마선거구,6481005,4810,거제시,잘못 투입·구분된 투표지,,0,0,0,0,0,0,0,0,0,0,0,0,0,0
4800,경상남도,의령군가선거구,6481101,4811,의령군,합계,,9588,7106,579,748,830,1102,448,211,1013,835,1148,6914,192,2482
4800,경상남도,의령군가선거구,6481101,4811,의령군,거소투표,,41,39,3,8,2,6,4,1,1,2,11,38,1,2
4800,경상남도,의령군가선거구,6481101,4811,의령군,관외사전투표,,894,894,131,126,97,158,38,24,135,78,76,863,31,0
4800,경상남도,의령군가선거구,6481101,4811,의령군,의령읍,계,7326,5230,380,523,443,826,368,163,749,689,969,5110,120,2096
4800,경상남도,의령군가선거구,6481101,4811,의령군,의령읍,관내사전투표,2229,2229,184,202,183,380,160,64,328,305,369,2175,54,0
4800,경상남도,의령군가선거구,6481101,4811,의령군,의령읍,선거일투표,5097,3001,196,321,260,446,208,99,421,384,600,2935,66,2096
4800,경상남도,의령군가선거구,6481101,4811,의령군,용덕면,계,1327,943,65,91,288,112,38,23,128,66,92,903,40,384
4800,경상남도,의령군가선거구,6481101,4811,의령군,용덕면,관내사전투표,315,315,20,37,103,28,12,4,47,22,28,301,14,0
4800,경상남도,의령군가선거구,6481101,4811,의령군,용덕면,선거일투표,1012,628,45,54,185,84,26,19,81,44,64,602,26,384
4800,경상남도,의령군가선거구,6481101,4811,의령군,잘못 투입·구분된 투표지,,0,0,0,0,0,0,0,0,0,0,0,0,0,0
4800,경상남도,의령군나선거구,6481102,4811,의령군,합계,,5138,3829,1435,1296,906,3637,192,1309
4800,경상남도,의령군나선거구,6481102,4811,의령군,거소투표,,16,15,3,7,4,14,1,1
4800,경상남도,의령군나선거구,6481102,4811,의령군,관외사전투표,,510,508,196,183,115,494,14,2
4800,경상남도,의령군나선거구,6481102,4811,의령군,가례면,계,1495,1051,495,145,329,969,82,444
4800,경상남도,의령군나선거구,6481102,4811,의령군,가례면,관내사전투표,579,579,276,81,163,520,59,0
4800,경상남도,의령군나선거구,6481102,4811,의령군,가례면,선거일투표,916,472,219,64,166,449,23,444
4800,경상남도,의령군나선거구,6481102,4811,의령군,칠곡면,계,1015,723,293,194,203,690,33,292
4800,경상남도,의령군나선거구,6481102,4811,의령군,칠곡면,관내사전투표,312,312,108,89,96,293,19,0
4800,경상남도,의령군나선거구,6481102,4811,의령군,칠곡면,선거일투표,703,411,185,105,107,397,14,292
4800,경상남도,의령군나선거구,6481102,4811,의령군,대의면,계,871,615,222,190,173,585,30,256
4800,경상남도,의령군나선거구,6481102,4811,의령군,대의면,관내사전투표,250,250,102,76,58,236,14,0
4800,경상남도,의령군나선거구,6481102,4811,의령군,대의면,선거일투표,621,365,120,114,115,349,16,256
4800,경상남도,의령군나선거구,6481102,4811,의령군,화정면,계,1231,915,225,576,82,883,32,316
4800,경상남도,의령군나선거구,6481102,4811,의령군,화정면,관내사전투표,387,387,80,255,32,367,20,0
4800,경상남도,의령군나선거구,6481102,4811,의령군,화정면,선거일투표,844,528,145,321,50,516,12,316
4800,경상남도,의령군나선거구,6481102,4811,의령군,잘못 투입·구분된 투표지,,0,2,1,1,0,2,0,-2
4800,경상남도,의령군다선거구,6481103,4811,의령군,합계,,5321,3969,1138,1408,1227,3773,196,1352
4800,경상남도,의령군다선거구,6481103,4811,의령군,거소투표,,44,41,11,11,15,37,4,3
4800,경상남도,의령군다선거구,6481103,4811,의령군,관외사전투표,,521,520,167,173,164,504,16,1
4800,경상남도,의령군다선거구,6481103,4811,의령군,정곡면,계,1203,852,480,152,173,805,47,351
4800,경상남도,의령군다선거구,6481103,4811,의령군,정곡면,관내사전투표,402,402,229,74,72,375,27,0
4800,경상남도,의령군다선거구,6481103,4811,의령군,정곡면,선거일투표,801,450,251,78,101,430,20,351
4800,경상남도,의령군다선거구,6481103,4811,의령군,지정면,계,1577,1156,132,512,470,1114,42,421
4800,경상남도,의령군다선거구,6481103,4811,의령군,지정면,관내사전투표,454,453,57,189,183,429,24,1
4800,경상남도,의령군다선거구,6481103,4811,의령군,지정면,선거일투표,1123,703,75,323,287,685,18,420
4800,경상남도,의령군다선거구,6481103,4811,의령군,궁류면,계,984,665,147,288,180,615,50,319
4800,경상남도,의령군다선거구,6481103,4811,의령군,궁류면,관내사전투표,346,346,78,153,84,315,31,0
4800,경상남도,의령군다선거구,6481103,4811,의령군,궁류면,선거일투표,638,319,69,135,96,300,19,319
4800,경상남도,의령군다선거구,6481103,4811,의령군,유곡면,계,992,732,201,271,223,695,37,260
4800,경상남도,의령군다선거구,6481103,4811,의령군,유곡면,관내사전투표,202,202,53,77,61,191,11,0
4800,경상남도,의령군다선거구,6481103,4811,의령군,유곡면,선거일투표,790,530,148,194,162,504,26,260
4800,경상남도,의령군다선거구,6481103,4811,의령군,잘못 투입·구분된 투표지,,0,3,0,1,2,3,0,-3
4800,경상남도,의령군라선거구,6481104,4811,의령군,합계,,4244,3326,536,738,877,1008,3159,167,918
4800,경상남도,의령군라선거구,6481104,4811,의령군,거소투표,,18,17,2,3,5,3,13,4,1
4800,경상남도,의령군라선거구,6481104,4811,의령군,관외사전투표,,330,330,73,109,78,60,320,10,0
4800,경상남도,의령군라선거구,6481104,4811,의령군,낙서면,계,644,509,52,98,134,192,476,33,135
4800,경상남도,의령군라선거구,6481104,4811,의령군,낙서면,관내사전투표,209,209,27,38,60,70,195,14,0
4800,경상남도,의령군라선거구,6481104,4811,의령군,낙서면,선거일투표,435,300,25,60,74,122,281,19,135
4800,경상남도,의령군라선거구,6481104,4811,의령군,부림면,계,2489,1929,199,445,587,603,1834,95,560
4800,경상남도,의령군라선거구,6481104,4811,의령군,부림면,관내사전투표,998,998,101,234,299,302,936,62,0
4800,경상남도,의령군라선거구,6481104,4811,의령군,부림면,선거일투표,1491,931,98,211,288,301,898,33,560
4800,경상남도,의령군라선거구,6481104,4811,의령군,봉수면,계,763,541,210,83,73,150,516,25,222
4800,경상남도,의령군라선거구,6481104,4811,의령군,봉수면,관내사전투표,243,243,103,33,28,64,228,15,0
4800,경상남도,의령군라선거구,6481104,4811,의령군,봉수면,선거일투표,520,298,107,50,45,86,288,10,222
4800,경상남도,의령군라선거구,6481104,4811,의령군,잘못 투입·구분된 투표지,,0,0,0,0,0,0,0,0,0
4800,경상남도,함안군가선거구,6481201,4812,함안군,합계,,18494,10950,2513,2376,2214,1531,1991,10625,325,7544
4800,경상남도,함안군가선거구,6481201,4812,함안군,거소투표,,52,46,7,19,5,5,8,44,2,6
4800,경상남도,함안군가선거구,6481201,4812,함안군,관외사전투표,,1646,1644,492,345,290,205,282,1614,30,2
4800,경상남도,함안군가선거구,6481201,4812,함안군,가야읍,계,13757,7277,1516,1539,1609,1155,1244,7063,214,6480
4800,경상남도,함안군가선거구,6481201,4812,함안군,가야읍,관내사전투표,2612,2602,646,526,499,428,453,2552,50,10
4800,경상남도,함안군가선거구,6481201,4812,함안군,가야읍,선거일투표,11145,4675,870,1013,1110,727,791,4511,164,6470
4800,경상남도,함안군가선거구,6481201,4812,함안군,함안면,계,2172,1360,317,311,206,109,359,1302,58,812
4800,경상남도,함안군가선거구,6481201,4812,함안군,함안면,관내사전투표,609,606,169,126,84,41,173,593,13,3
4800,경상남도,함안군가선거구,6481201,4812,함안군,함안면,선거일투표,1563,754,148,185,122,68,186,709,45,809
4800,경상남도,함안군가선거구,6481201,4812,함안군,여항면,계,867,608,178,160,103,55,92,588,20,259
4800,경상남도,함안군가선거구,6481201,4812,함안군,여항면,관내사전투표,359,359,108,90,56,35,59,348,11,0
4800,경상남도,함안군가선거구,6481201,4812,함안군,여항면,선거일투표,508,249,70,70,47,20,33,240,9,259
4800,경상남도,함안군가선거구,6481201,4812,함안군,잘못 투입·구분된 투표지,,0,15,3,2,1,2,6,14,1,-15
4800,경상남도,함안군나선거구,6481202,4812,함안군,합계,,8265,5032,742,1656,980,1434,4812,220,3233
4800,경상남도,함안군나선거구,6481202,4812,함안군,거소투표,,51,45,4,9,20,7,40,5,6
4800,경상남도,함안군나선거구,6481202,4812,함안군,관외사전투표,,573,571,151,245,94,69,559,12,2
4800,경상남도,함안군나선거구,6481202,4812,함안군,군북면,계,5156,2985,448,541,717,1153,2859,126,2171
4800,경상남도,함안군나선거구,6481202,4812,함안군,군북면,관내사전투표,1092,1090,203,196,243,407,1049,41,2
4800,경상남도,함안군나선거구,6481202,4812,함안군,군북면,선거일투표,4064,1895,245,345,474,746,1810,85,2169
4800,경상남도,함안군나선거구,6481202,4812,함안군,법수면,계,2485,1425,139,859,146,204,1348,77,1060
4800,경상남도,함안군나선거구,6481202,4812,함안군,법수면,관내사전투표,640,638,65,389,73,82,609,29,2
4800,경상남도,함안군나선거구,6481202,4812,함안군,법수면,선거일투표,1845,787,74,470,73,122,739,48,1058
4800,경상남도,함안군나선거구,6481202,4812,함안군,잘못 투입·구분된 투표지,,0,6,0,2,3,1,6,0,-6
4800,경상남도,함안군다선거구,6481203,4812,함안군,합계,,27366,16085,2301,1844,4573,1870,1987,1063,1595,15233,852,11281
4800,경상남도,함안군다선거구,6481203,4812,함안군,거소투표,,162,150,12,12,33,14,20,21,19,131,19,12
4800,경상남도,함안군다선거구,6481203,4812,함안군,관외사전투표,,1409,1409,281,143,502,122,103,69,97,1317,92,0
4800,경상남도,함안군다선거구,6481203,4812,함안군,칠원읍,계,14351,7797,1446,609,2743,505,1384,298,464,7449,348,6554
4800,경상남도,함안군다선거구,6481203,4812,함안군,칠원읍,관내사전투표,2174,2174,405,175,706,180,408,71,107,2052,122,0
4800,경상남도,함안군다선거구,6481203,4812,함안군,칠원읍,선거일투표,12177,5623,1041,434,2037,325,976,227,357,5397,226,6554
4800,경상남도,함안군다선거구,6481203,4812,함안군,대산면,계,3005,1821,117,594,189,122,71,434,172,1699,122,1184
4800,경상남도,함안군다선거구,6481203,4812,함안군,대산면,관내사전투표,770,770,59,243,78,52,39,182,67,720,50,0
4800,경상남도,함안군다선거구,6481203,4812,함안군,대산면,선거일투표,2235,1051,58,351,111,70,32,252,105,979,72,1184
4800,경상남도,함안군다선거구,6481203,4812,함안군,칠서면,계,4275,2258,183,296,361,804,149,146,205,2144,114,2017
4800,경상남도,함안군다선거구,6481203,4812,함안군,칠서면,관내사전투표,535,535,47,60,78,204,40,23,51,503,32,0
4800,경상남도,함안군다선거구,6481203,4812,함안군,칠서면,선거일투표,3740,1723,136,236,283,600,109,123,154,1641,82,2017
4800,경상남도,함안군다선거구,6481203,4812,함안군,칠북면,계,1755,1100,101,66,476,85,208,33,55,1024,76,655
4800,경상남도,함안군다선거구,6481203,4812,함안군,칠북면,관내사전투표,402,402,50,32,173,27,65,11,21,379,23,0
4800,경상남도,함안군다선거구,6481203,4812,함안군,칠북면,선거일투표,1353,698,51,34,303,58,143,22,34,645,53,655
4800,경상남도,함안군다선거구,6481203,4812,함안군,산인면,계,2409,1550,161,124,269,218,52,62,583,1469,81,859
4800,경상남도,함안군다선거구,6481203,4812,함안군,산인면,관내사전투표,779,779,86,68,128,115,29,29,290,745,34,0
4800,경상남도,함안군다선거구,6481203,4812,함안군,산인면,선거일투표,1630,771,75,56,141,103,23,33,293,724,47,859
4800,경상남도,함안군다선거구,6481203,4812,함안군,잘못 투입·구분된 투표지,,0,0,0,0,0,0,0,0,0,0,0,0
4800,경상남도,창녕군가선거구,6481301,4813,창녕군,합계,,18056,11766,1748,2539,1584,2050,2080,1449,11450,316,6290
4800,경상남도,창녕군가선거구,6481301,4813,창녕군,거소투표,,75,66,15,24,7,4,5,6,61,5,9
4800,경상남도,창녕군가선거구,6481301,4813,창녕군,관외사전투표,,1156,1156,296,303,169,107,158,97,1130,26,0
4800,경상남도,창녕군가선거구,6481301,4813,창녕군,창녕읍,계,12938,8010,1067,1490,1198,1564,1625,871,7815,195,4928
4800,경상남도,창녕군가선거구,6481301,4813,창녕군,창녕읍,관내사전투표,2736,2736,402,482,425,494,556,306,2665,71,0
4800,경상남도,창녕군가선거구,6481301,4813,창녕군,창녕읍,선거일투표,10202,5274,665,1008,773,1070,1069,565,5150,124,4928
4800,경상남도,창녕군가선거구,6481301,4813,창녕군,유어면,계,1605,1036,115,201,71,126,118,358,989,47,569
4800,경상남도,창녕군가선거구,6481301,4813,창녕군,유어면,관내사전투표,384,384,63,56,36,45,45,121,366,18,0
4800,경상남도,창녕군가선거구,6481301,4813,창녕군,유어면,선거일투표,1221,652,52,145,35,81,73,237,623,29,569
4800,경상남도,창녕군가선거구,6481301,4813,창녕군,대지면,계,2282,1497,255,521,138,249,174,117,1454,43,785
4800,경상남도,창녕군가선거구,6481301,4813,창녕군,대지면,관내사전투표,638,638,118,193,66,114,85,47,623,15,0
4800,경상남도,창녕군가선거구,6481301,4813,창녕군,대지면,선거일투표,1644,859,137,328,72,135,89,70,831,28,785
4800,경상남도,창녕군가선거구,6481301,4813,창녕군,잘못 투입·구분된 투표지,,0,1,0,0,1,0,0,0,1,0,-1
4800,경상남도,창녕군나선거구,6481302,4813,창녕군,합계,,9077,5693,2408,1991,1018,5417,276,3384
4800,경상남도,창녕군나선거구,6481302,4813,창녕군,거소투표,,32,29,16,10,2,28,1,3
4800,경상남도,창녕군나선거구,6481302,4813,창녕군,관외사전투표,,756,756,317,255,140,712,44,0
4800,경상남도,창녕군나선거구,6481302,4813,창녕군,고암면,계,1593,1023,314,340,306,960,63,570
4800,경상남도,창녕군나선거구,6481302,4813,창녕군,고암면,관내사전투표,459,458,128,151,144,423,35,1
4800,경상남도,창녕군나선거구,6481302,4813,창녕군,고암면,선거일투표,1134,565,186,189,162,537,28,569
4800,경상남도,창녕군나선거구,6481302,4813,창녕군,성산면,계,1401,777,465,171,116,752,25,624
4800,경상남도,창녕군나선거구,6481302,4813,창녕군,성산면,관내사전투표,310,310,179,61,53,293,17,0
4800,경상남도,창녕군나선거구,6481302,4813,창녕군,성산면,선거일투표,1091,467,286,110,63,459,8,624
4800,경상남도,창녕군나선거구,6481302,4813,창녕군,대합면,계,3317,1885,1068,435,294,1797,88,1432
4800,경상남도,창녕군나선거구,6481302,4813,창녕군,대합면,관내사전투표,820,820,437,194,134,765,55,0
4800,경상남도,창녕군나선거구,6481302,4813,창녕군,대합면,선거일투표,2497,1065,631,241,160,1032,33,1432
4800,경상남도,창녕군나선거구,6481302,4813,창녕군,이방면,계,1978,1222,227,780,160,1167,55,756
4800,경상남도,창녕군나선거구,6481302,4813,창녕군,이방면,관내사전투표,447,446,79,294,51,424,22,1
4800,경상남도,창녕군나선거구,6481302,4813,창녕군,이방면,선거일투표,1531,776,148,486,109,743,33,755
4800,경상남도,창녕군나선거구,6481302,4813,창녕군,잘못 투입·구분된 투표지,,0,1,1,0,0,1,0,-1
4800,경상남도,창녕군다선거구,6481303,4813,창녕군,합계,,15103,9608,1390,2710,2412,1493,1243,9248,360,5495
4800,경상남도,창녕군다선거구,6481303,4813,창녕군,거소투표,,43,37,5,13,6,10,3,37,0,6
4800,경상남도,창녕군다선거구,6481303,4813,창녕군,관외사전투표,,792,792,192,272,143,77,85,769,23,0
4800,경상남도,창녕군다선거구,6481303,4813,창녕군,남지읍,계,9792,5867,798,1648,1851,300,1027,5624,243,3925
4800,경상남도,창녕군다선거구,6481303,4813,창녕군,남지읍,관내사전투표,2397,2395,373,630,780,109,410,2302,93,2
4800,경상남도,창녕군다선거구,6481303,4813,창녕군,남지읍,선거일투표,7395,3472,425,1018,1071,191,617,3322,150,3923
4800,경상남도,창녕군다선거구,6481303,4813,창녕군,길곡면,계,1328,901,156,281,177,188,62,864,37,427
4800,경상남도,창녕군다선거구,6481303,4813,창녕군,길곡면,관내사전투표,384,384,69,140,67,67,29,372,12,0
4800,경상남도,창녕군다선거구,6481303,4813,창녕군,길곡면,선거일투표,944,517,87,141,110,121,33,492,25,427
4800,경상남도,창녕군다선거구,6481303,4813,창녕군,부곡면,계,3148,2009,239,494,235,918,66,1952,57,1139
4800,경상남도,창녕군다선거구,6481303,4813,창녕군,부곡면,관내사전투표,994,993,135,230,105,451,42,963,30,1
4800,경상남도,창녕군다선거구,6481303,4813,창녕군,부곡면,선거일투표,2154,1016,104,264,130,467,24,989,27,1138
4800,경상남도,창녕군다선거구,6481303,4813,창녕군,잘못 투입·구분된 투표지,,0,2,0,2,0,0,0,2,0,-2
4800,경상남도,창녕군라선거구,6481304,4813,창녕군,합계,,11380,7321,2892,2579,1282,6753,568,4059
4800,경상남도,창녕군라선거구,6481304,4813,창녕군,거소투표,,33,28,11,8,5,24,4,5
4800,경상남도,창녕군라선거구,6481304,4813,창녕군,관외사전투표,,789,786,289,293,172,754,32,3
4800,경상남도,창녕군라선거구,6481304,4813,창녕군,계성면,계,2042,1253,344,622,202,1168,85,789
4800,경상남도,창녕군라선거구,6481304,4813,창녕군,계성면,관내사전투표,476,474,129,221,84,434,40,2
4800,경상남도,창녕군라선거구,6481304,4813,창녕군,계성면,선거일투표,1566,779,215,401,118,734,45,787
4800,경상남도,창녕군라선거구,6481304,4813,창녕군,영산면,계,4543,2797,1520,618,479,2617,180,1746
4800,경상남도,창녕군라선거구,6481304,4813,창녕군,영산면,관내사전투표,1037,1035,607,203,178,988,47,2
4800,경상남도,창녕군라선거구,6481304,4813,창녕군,영산면,선거일투표,3506,1762,913,415,301,1629,133,1744
4800,경상남도,창녕군라선거구,6481304,4813,창녕군,장마면,계,1644,1019,214,528,149,891,128,625
4800,경상남도,창녕군라선거구,6481304,4813,창녕군,장마면,관내사전투표,385,384,100,203,57,360,24,1
4800,경상남도,창녕군라선거구,6481304,4813,창녕군,장마면,선거일투표,1259,635,114,325,92,531,104,624
4800,경상남도,창녕군라선거구,6481304,4813,창녕군,도천면,계,2329,1430,511,507,274,1292,138,899
4800,경상남도,창녕군라선거구,6481304,4813,창녕군,도천면,관내사전투표,624,624,214,237,114,565,59,0
4800,경상남도,창녕군라선거구,6481304,4813,창녕군,도천면,선거일투표,1705,806,297,270,160,727,79,899
4800,경상남도,창녕군라선거구,6481304,4813,창녕군,잘못 투입·구분된 투표지,,0,8,3,3,1,7,1,-8
4800,경상남도,양산시가선거구,6481401,4814,양산시,합계,,44672,20835,7469,7733,5136,20338,497,23837
4800,경상남도,양산시가선거구,6481401,4814,양산시,거소투표,,71,66,15,26,12,53,13,5
4800,경상남도,양산시가선거구,6481401,4814,양산시,관외사전투표,,2403,2403,971,899,470,2340,63,0
4800,경상남도,양산시가선거구,6481401,4814,양산시,물금읍,계,42198,18302,6463,6781,4638,17882,420,23896
4800,경상남도,양산시가선거구,6481401,4814,양산시,물금읍,관내사전투표,2335,2274,851,793,569,2213,61,61
4800,경상남도,양산시가선거구,6481401,4814,양산시,물금읍,선거일투표,39863,16028,5612,5988,4069,15669,359,23835
4800,경상남도,양산시가선거구,6481401,4814,양산시,잘못 투입·구분된 투표지,,0,64,20,27,16,63,1,-64
4800,경상남도,양산시나선거구,6481402,4814,양산시,합계,,52740,23729,6324,3150,7109,5406,21989,1740,29011
4800,경상남도,양산시나선거구,6481402,4814,양산시,거소투표,,56,49,16,7,10,10,43,6,7
4800,경상남도,양산시나선거구,6481402,4814,양산시,관외사전투표,,2301,2300,589,315,725,503,2132,168,1
4800,경상남도,양산시나선거구,6481402,4814,양산시,물금읍,계,47517,19743,5536,2645,5779,4334,18294,1449,27774
4800,경상남도,양산시나선거구,6481402,4814,양산시,물금읍,관내사전투표,4969,4962,1408,697,1343,1087,4535,427,7
4800,경상남도,양산시나선거구,6481402,4814,양산시,물금읍,선거일투표,42548,14781,4128,1948,4436,3247,13759,1022,27767
4800,경상남도,양산시나선거구,6481402,4814,양산시,원동면,계,2866,1620,179,180,591,555,1505,115,1246
4800,경상남도,양산시나선거구,6481402,4814,양산시,원동면,관내사전투표,384,384,33,57,148,118,356,28,0
4800,경상남도,양산시나선거구,6481402,4814,양산시,원동면,선거일투표,2482,1236,146,123,443,437,1149,87,1246
4800,경상남도,양산시나선거구,6481402,4814,양산시,잘못 투입·구분된 투표지,,0,17,4,3,4,4,15,2,-17
4800,경상남도,양산시다선거구,6481403,4814,양산시,합계,,26566,13627,3401,7590,1898,327,13216,411,12939
4800,경상남도,양산시다선거구,6481403,4814,양산시,거소투표,,135,126,39,56,15,4,114,12,9
4800,경상남도,양산시다선거구,6481403,4814,양산시,관외사전투표,,1249,1248,428,615,132,36,1211,37,1
4800,경상남도,양산시다선거구,6481403,4814,양산시,상북면,계,11015,5538,1263,3075,913,96,5347,191,5477
4800,경상남도,양산시다선거구,6481403,4814,양산시,상북면,관내사전투표,1926,1923,391,1088,338,24,1841,82,3
4800,경상남도,양산시다선거구,6481403,4814,양산시,상북면,선거일투표,9089,3615,872,1987,575,72,3506,109,5474
4800,경상남도,양산시다선거구,6481403,4814,양산시,하북면,계,7199,3689,648,2425,466,55,3594,95,3510
4800,경상남도,양산시다선거구,6481403,4814,양산시,하북면,관내사전투표,1446,1446,299,904,182,17,1402,44,0
4800,경상남도,양산시다선거구,6481403,4814,양산시,하북면,선거일투표,5753,2243,349,1521,284,38,2192,51,3510
4800,경상남도,양산시다선거구,6481403,4814,양산시,강서동,계,6968,3014,1019,1412,371,136,2938,76,3954
4800,경상남도,양산시다선거구,6481403,4814,양산시,강서동,관내사전투표,611,609,206,290,75,18,589,20,2
4800,경상남도,양산시다선거구,6481403,4814,양산시,강서동,선거일투표,6357,2405,813,1122,296,118,2349,56,3952
4800,경상남도,양산시다선거구,6481403,4814,양산시,잘못 투입·구분된 투표지,,0,12,4,7,1,0,12,0,-12
4800,경상남도,양산시라선거구,6481404,4814,양산시,합계,,29767,13177,3586,6995,1527,680,12788,389,16590
4800,경상남도,양산시라선거구,6481404,4814,양산시,거소투표,,54,47,15,24,5,2,46,1,7
4800,경상남도,양산시라선거구,6481404,4814,양산시,관외사전투표,,1085,1085,396,491,124,38,1049,36,0
4800,경상남도,양산시라선거구,6481404,4814,양산시,중앙동,계,10384,4494,1147,2333,681,168,4329,165,5890
4800,경상남도,양산시라선거구,6481404,4814,양산시,중앙동,관내사전투표,1686,1685,488,828,245,60,1621,64,1
4800,경상남도,양산시라선거구,6481404,4814,양산시,중앙동,선거일투표,8698,2809,659,1505,436,108,2708,101,5889
4800,경상남도,양산시라선거구,6481404,4814,양산시,삼성동,계,18244,7548,2028,4145,717,472,7362,186,10696
4800,경상남도,양산시라선거구,6481404,4814,양산시,삼성동,관내사전투표,2129,2128,609,1181,204,83,2077,51,1
4800,경상남도,양산시라선거구,6481404,4814,양산시,삼성동,선거일투표,16115,5420,1419,2964,513,389,5285,135,10695
4800,경상남도,양산시라선거구,6481404,4814,양산시,잘못 투입·구분된 투표지,,0,3,0,2,0,0,2,1,-3
4800,경상남도,양산시마선거구,6481405,4814,양산시,합계,,58175,28991,7938,4641,5991,6784,2096,27450,1541,29184
4800,경상남도,양산시마선거구,6481405,4814,양산시,거소투표,,93,86,18,17,15,21,4,75,11,7
4800,경상남도,양산시마선거구,6481405,4814,양산시,관외사전투표,,2630,2628,770,448,524,589,151,2482,146,2
4800,경상남도,양산시마선거구,6481405,4814,양산시,동면,계,28671,11995,3889,1586,2553,2801,501,11330,665,16676
4800,경상남도,양산시마선거구,6481405,4814,양산시,동면,관내사전투표,1565,1565,482,233,333,379,42,1469,96,0
4800,경상남도,양산시마선거구,6481405,4814,양산시,동면,선거일투표,27106,10430,3407,1353,2220,2422,459,9861,569,16676
4800,경상남도,양산시마선거구,6481405,4814,양산시,양주동,계,26781,14269,3259,2586,2896,3369,1440,13550,719,12512
4800,경상남도,양산시마선거구,6481405,4814,양산시,양주동,관내사전투표,4181,4173,967,777,866,927,409,3946,227,8
4800,경상남도,양산시마선거구,6481405,4814,양산시,양주동,선거일투표,22600,10096,2292,1809,2030,2442,1031,9604,492,12504
4800,경상남도,양산시마선거구,6481405,4814,양산시,잘못 투입·구분된 투표지,,0,13,2,4,3,4,0,13,0,-13
4800,경상남도,양산시바선거구,6481406,4814,양산시,합계,,41255,18646,5722,7321,5118,18161,485,22609
4800,경상남도,양산시바선거구,6481406,4814,양산시,거소투표,,90,85,24,35,22,81,4,5
4800,경상남도,양산시바선거구,6481406,4814,양산시,관외사전투표,,1370,1370,590,487,250,1327,43,0
4800,경상남도,양산시바선거구,6481406,4814,양산시,서창동,계,23010,9873,2917,3969,2771,9657,216,13137
4800,경상남도,양산시바선거구,6481406,4814,양산시,서창동,관내사전투표,3198,3195,960,1307,858,3125,70,3
4800,경상남도,양산시바선거구,6481406,4814,양산시,서창동,선거일투표,19812,6678,1957,2662,1913,6532,146,13134
4800,경상남도,양산시바선거구,6481406,4814,양산시,소주동,계,16785,7303,2184,2826,2071,7081,222,9482
4800,경상남도,양산시바선거구,6481406,4814,양산시,소주동,관내사전투표,2241,2240,731,841,597,2169,71,1
4800,경상남도,양산시바선거구,6481406,4814,양산시,소주동,선거일투표,14544,5063,1453,1985,1474,4912,151,9481
4800,경상남도,양산시바선거구,6481406,4814,양산시,잘못 투입·구분된 투표지,,0,15,7,4,4,15,0,-15
4800,경상남도,양산시사선거구,6481407,4814,양산시,합계,,41236,19356,5577,2516,6743,3187,18023,1333,21880
4800,경상남도,양산시사선거구,6481407,4814,양산시,거소투표,,67,61,14,12,14,14,54,7,6
4800,경상남도,양산시사선거구,6481407,4814,양산시,관외사전투표,,1311,1310,423,175,420,188,1206,104,1
4800,경상남도,양산시사선거구,6481407,4814,양산시,평산동,계,24144,10117,2860,1250,3517,1733,9360,757,14027
4800,경상남도,양산시사선거구,6481407,4814,양산시,평산동,관내사전투표,2870,2865,851,362,944,440,2597,268,5
4800,경상남도,양산시사선거구,6481407,4814,양산시,평산동,선거일투표,21274,7252,2009,888,2573,1293,6763,489,14022
4800,경상남도,양산시사선거구,6481407,4814,양산시,덕계동,계,15714,7859,2277,1077,2789,1251,7394,465,7855
4800,경상남도,양산시사선거구,6481407,4814,양산시,덕계동,관내사전투표,3320,3318,1014,421,1140,531,3106,212,2
4800,경상남도,양산시사선거구,6481407,4814,양산시,덕계동,선거일투표,12394,4541,1263,656,1649,720,4288,253,7853
4800,경상남도,양산시사선거구,6481407,4814,양산시,잘못 투입·구분된 투표지,,0,9,3,2,3,1,9,0,-9
4800,경상남도,하동군가선거구,6481501,4815,하동군,합계,,7836,5858,1557,1714,1476,878,5625,233,1978
4800,경상남도,하동군가선거구,6481501,4815,하동군,거소투표,,103,93,17,34,24,12,87,6,10
4800,경상남도,하동군가선거구,6481501,4815,하동군,관외사전투표,,747,747,260,226,148,93,727,20,0
4800,경상남도,하동군가선거구,6481501,4815,하동군,화개면,계,2505,1833,714,201,798,67,1780,53,672
4800,경상남도,하동군가선거구,6481501,4815,하동군,화개면,관내사전투표,1052,1052,403,120,454,37,1014,38,0
4800,경상남도,하동군가선거구,6481501,4815,하동군,화개면,선거일투표,1453,781,311,81,344,30,766,15,672
4800,경상남도,하동군가선거구,6481501,4815,하동군,악양면,계,2925,2109,314,794,328,577,2013,96,816
4800,경상남도,하동군가선거구,6481501,4815,하동군,악양면,관내사전투표,1325,1324,192,529,179,355,1255,69,1
4800,경상남도,하동군가선거구,6481501,4815,하동군,악양면,선거일투표,1600,785,122,265,149,222,758,27,815
4800,경상남도,하동군가선거구,6481501,4815,하동군,적량면,계,1556,1072,251,458,176,129,1014,58,484
4800,경상남도,하동군가선거구,6481501,4815,하동군,적량면,관내사전투표,640,640,151,286,87,77,601,39,0
4800,경상남도,하동군가선거구,6481501,4815,하동군,적량면,선거일투표,916,432,100,172,89,52,413,19,484
4800,경상남도,하동군가선거구,6481501,4815,하동군,잘못 투입·구분된 투표지,,0,4,1,1,2,0,4,0,-4
4800,경상남도,하동군나선거구,6481502,4815,하동군,합계,,12195,9049,1923,2062,1622,1425,1721,8753,296,3146
4800,경상남도,하동군나선거구,6481502,4815,하동군,거소투표,,161,146,29,27,26,9,30,121,25,15
4800,경상남도,하동군나선거구,6481502,4815,하동군,관외사전투표,,1004,1004,305,235,168,119,153,980,24,0
4800,경상남도,하동군나선거구,6481502,4815,하동군,하동읍,계,7693,5507,1243,881,1102,1019,1115,5360,147,2186
4800,경상남도,하동군나선거구,6481502,4815,하동군,하동읍,관내사전투표,2690,2684,626,403,530,445,607,2611,73,6
4800,경상남도,하동군나선거구,6481502,4815,하동군,하동읍,선거일투표,5003,2823,617,478,572,574,508,2749,74,2180
4800,경상남도,하동군나선거구,6481502,4815,하동군,횡천면,계,1576,1163,189,272,213,180,263,1117,46,413
4800,경상남도,하동군나선거구,6481502,4815,하동군,횡천면,관내사전투표,574,570,107,112,103,88,142,552,18,4
4800,경상남도,하동군나선거구,6481502,4815,하동군,횡천면,선거일투표,1002,593,82,160,110,92,121,565,28,409
4800,경상남도,하동군나선거구,6481502,4815,하동군,고전면,계,1761,1218,154,645,112,96,158,1165,53,543
4800,경상남도,하동군나선거구,6481502,4815,하동군,고전면,관내사전투표,574,573,72,295,52,44,75,538,35,1
4800,경상남도,하동군나선거구,6481502,4815,하동군,고전면,선거일투표,1187,645,82,350,60,52,83,627,18,542
4800,경상남도,하동군나선거구,6481502,4815,하동군,잘못 투입·구분된 투표지,,0,11,3,2,1,2,2,10,1,-11
4800,경상남도,하동군다선거구,6481503,4815,하동군,합계,,11059,7964,2262,3522,1840,7624,340,3095
4800,경상남도,하동군다선거구,6481503,4815,하동군,거소투표,,129,120,27,41,38,106,14,9
4800,경상남도,하동군다선거구,6481503,4815,하동군,관외사전투표,,872,871,269,387,196,852,19,1
4800,경상남도,하동군다선거구,6481503,4815,하동군,금남면,계,2709,1839,315,789,686,1790,49,870
4800,경상남도,하동군다선거구,6481503,4815,하동군,금남면,관내사전투표,953,953,154,417,351,922,31,0
4800,경상남도,하동군다선거구,6481503,4815,하동군,금남면,선거일투표,1756,886,161,372,335,868,18,870
4800,경상남도,하동군다선거구,6481503,4815,하동군,금성면,계,2374,1593,218,991,300,1509,84,781
4800,경상남도,하동군다선거구,6481503,4815,하동군,금성면,관내사전투표,887,887,118,563,154,835,52,0
4800,경상남도,하동군다선거구,6481503,4815,하동군,금성면,선거일투표,1487,706,100,428,146,674,32,781
4800,경상남도,하동군다선거구,6481503,4815,하동군,진교면,계,4975,3541,1433,1314,620,3367,174,1434
4800,경상남도,하동군다선거구,6481503,4815,하동군,진교면,관내사전투표,2171,2171,885,813,350,2048,123,0
4800,경상남도,하동군다선거구,6481503,4815,하동군,진교면,선거일투표,2804,1370,548,501,270,1319,51,1434
4800,경상남도,하동군다선거구,6481503,4815,하동군,잘못 투입·구분된 투표지,,0,0,0,0,0,0,0,0
4800,경상남도,하동군라선거구,6481504,4815,하동군,합계,,8338,6242,583,2282,873,2193,5931,311,2096
4800,경상남도,하동군라선거구,6481504,4815,하동군,거소투표,,93,88,19,35,9,21,84,4,5
4800,경상남도,하동군라선거구,6481504,4815,하동군,관외사전투표,,728,727,116,319,79,191,705,22,1
4800,경상남도,하동군라선거구,6481504,4815,하동군,양보면,계,1447,1029,107,346,205,311,969,60,418
4800,경상남도,하동군라선거구,6481504,4815,하동군,양보면,관내사전투표,529,527,62,173,100,153,488,39,2
4800,경상남도,하동군라선거구,6481504,4815,하동군,양보면,선거일투표,918,502,45,173,105,158,481,21,416
4800,경상남도,하동군라선거구,6481504,4815,하동군,북천면,계,1405,982,72,333,244,277,926,56,423
4800,경상남도,하동군라선거구,6481504,4815,하동군,북천면,관내사전투표,623,614,46,179,171,183,579,35,9
4800,경상남도,하동군라선거구,6481504,4815,하동군,북천면,선거일투표,782,368,26,154,73,94,347,21,414
4800,경상남도,하동군라선거구,6481504,4815,하동군,청암면,계,1133,783,97,264,181,194,736,47,350
4800,경상남도,하동군라선거구,6481504,4815,하동군,청암면,관내사전투표,407,407,46,134,85,112,377,30,0
4800,경상남도,하동군라선거구,6481504,4815,하동군,청암면,선거일투표,726,376,51,130,96,82,359,17,350
4800,경상남도,하동군라선거구,6481504,4815,하동군,옥종면,계,3532,2621,171,983,155,1193,2502,119,911
4800,경상남도,하동군라선거구,6481504,4815,하동군,옥종면,관내사전투표,1384,1384,102,507,78,627,1314,70,0
4800,경상남도,하동군라선거구,6481504,4815,하동군,옥종면,선거일투표,2148,1237,69,476,77,566,1188,49,911
4800,경상남도,하동군라선거구,6481504,4815,하동군,잘못 투입·구분된 투표지,,0,12,1,2,0,6,9,3,-12
4800,경상남도,남해군가선거구,6481601,4816,남해군,합계,,13670,9751,3070,2924,1248,2153,9395,356,3919
4800,경상남도,남해군가선거구,6481601,4816,남해군,거소투표,,45,43,12,17,5,6,40,3,2
4800,경상남도,남해군가선거구,6481601,4816,남해군,관외사전투표,,962,962,424,256,101,156,937,25,0
4800,경상남도,남해군가선거구,6481601,4816,남해군,남해읍,계,10407,7135,2358,2287,1069,1185,6899,236,3272
4800,경상남도,남해군가선거구,6481601,4816,남해군,남해읍,관내사전투표,3576,3569,1265,1020,531,623,3439,130,7
4800,경상남도,남해군가선거구,6481601,4816,남해군,남해읍,선거일투표,6831,3566,1093,1267,538,562,3460,106,3265
4800,경상남도,남해군가선거구,6481601,4816,남해군,서면,계,2256,1604,276,360,72,804,1512,92,652
4800,경상남도,남해군가선거구,6481601,4816,남해군,서면,관내사전투표,763,763,129,135,28,411,703,60,0
4800,경상남도,남해군가선거구,6481601,4816,남해군,서면,선거일투표,1493,841,147,225,44,393,809,32,652
4800,경상남도,남해군가선거구,6481601,4816,남해군,잘못 투입·구분된 투표지,,0,7,0,4,1,2,7,0,-7
4800,경상남도,남해군나선거구,6481602,4816,남해군,합계,,5887,4377,1595,1467,1174,4236,141,1510
4800,경상남도,남해군나선거구,6481602,4816,남해군,거소투표,,45,45,15,20,6,41,4,0
4800,경상남도,남해군나선거구,6481602,4816,남해군,관외사전투표,,521,521,227,171,107,505,16,0
4800,경상남도,남해군나선거구,6481602,4816,남해군,고현면,계,2941,2113,1037,849,161,2047,66,828
4800,경상남도,남해군나선거구,6481602,4816,남해군,고현면,관내사전투표,984,983,468,405,75,948,35,1
4800,경상남도,남해군나선거구,6481602,4816,남해군,고현면,선거일투표,1957,1130,569,444,86,1099,31,827
4800,경상남도,남해군나선거구,6481602,4816,남해군,설천면,계,2380,1695,316,426,898,1640,55,685
4800,경상남도,남해군나선거구,6481602,4816,남해군,설천면,관내사전투표,581,580,107,148,307,562,18,1
4800,경상남도,남해군나선거구,6481602,4816,남해군,설천면,선거일투표,1799,1115,209,278,591,1078,37,684
4800,경상남도,남해군나선거구,6481602,4816,남해군,잘못 투입·구분된 투표지,,0,3,0,1,2,3,0,-3
4800,경상남도,남해군다선거구,6481603,4816,남해군,합계,,8174,5757,1505,2099,1826,5430,327,2417
4800,경상남도,남해군다선거구,6481603,4816,남해군,거소투표,,57,54,14,23,15,52,2,3
4800,경상남도,남해군다선거구,6481603,4816,남해군,관외사전투표,,496,496,163,180,130,473,23,0
4800,경상남도,남해군다선거구,6481603,4816,남해군,이동면,계,3166,2265,627,853,676,2156,109,901
4800,경상남도,남해군다선거구,6481603,4816,남해군,이동면,관내사전투표,836,836,257,298,237,792,44,0
4800,경상남도,남해군다선거구,6481603,4816,남해군,이동면,선거일투표,2330,1429,370,555,439,1364,65,901
4800,경상남도,남해군다선거구,6481603,4816,남해군,상주면,계,1375,952,235,196,478,909,43,423
4800,경상남도,남해군다선거구,6481603,4816,남해군,상주면,관내사전투표,533,532,129,109,267,505,27,1
4800,경상남도,남해군다선거구,6481603,4816,남해군,상주면,선거일투표,842,420,106,87,211,404,16,422
4800,경상남도,남해군다선거구,6481603,4816,남해군,남면,계,3080,1987,466,846,525,1837,150,1093
4800,경상남도,남해군다선거구,6481603,4816,남해군,남면,관내사전투표,1086,1085,252,429,294,975,110,1
4800,경상남도,남해군다선거구,6481603,4816,남해군,남면,선거일투표,1994,902,214,417,231,862,40,1092
4800,경상남도,남해군다선거구,6481603,4816,남해군,잘못 투입·구분된 투표지,,0,3,0,1,2,3,0,-3
4800,경상남도,남해군라선거구,6481604,4816,남해군,합계,,10807,7333,1875,2616,2064,361,6916,417,3474
4800,경상남도,남해군라선거구,6481604,4816,남해군,거소투표,,39,35,12,12,10,1,35,0,4
4800,경상남도,남해군라선거구,6481604,4816,남해군,관외사전투표,,573,573,179,234,109,32,554,19,0
4800,경상남도,남해군라선거구,6481604,4816,남해군,삼동면,계,3373,2202,800,967,271,59,2097,105,1171
4800,경상남도,남해군라선거구,6481604,4816,남해군,삼동면,관내사전투표,888,888,324,393,88,27,832,56,0
4800,경상남도,남해군라선거구,6481604,4816,남해군,삼동면,선거일투표,2485,1314,476,574,183,32,1265,49,1171
4800,경상남도,남해군라선거구,6481604,4816,남해군,미조면,계,1962,1294,397,409,202,204,1212,82,668
4800,경상남도,남해군라선거구,6481604,4816,남해군,미조면,관내사전투표,625,623,208,166,103,89,566,57,2
4800,경상남도,남해군라선거구,6481604,4816,남해군,미조면,선거일투표,1337,671,189,243,99,115,646,25,666
4800,경상남도,남해군라선거구,6481604,4816,남해군,창선면,계,4860,3227,486,994,1472,64,3016,211,1633
4800,경상남도,남해군라선거구,6481604,4816,남해군,창선면,관내사전투표,1456,1456,241,418,660,32,1351,105,0
4800,경상남도,남해군라선거구,6481604,4816,남해군,창선면,선거일투표,3404,1771,245,576,812,32,1665,106,1633
4800,경상남도,남해군라선거구,6481604,4816,남해군,잘못 투입·구분된 투표지,,0,2,1,0,0,1,2,0,-2
4800,경상남도,함양군가선거구,6481701,4817,함양군,합계,,18182,13693,1545,2343,1811,1840,1581,556,168,967,538,1703,144,13196,497,4489
4800,경상남도,함양군가선거구,6481701,4817,함양군,거소투표,,62,57,4,14,8,1,12,2,1,3,3,7,0,55,2,5
4800,경상남도,함양군가선거구,6481701,4817,함양군,관외사전투표,,1640,1640,269,275,231,254,197,37,30,78,62,137,14,1584,56,0
4800,경상남도,함양군가선거구,6481701,4817,함양군,함양읍,계,13875,10045,1060,1718,1355,1420,1163,345,81,798,409,1248,115,9712,333,3830
4800,경상남도,함양군가선거구,6481701,4817,함양군,함양읍,관내사전투표,4782,4779,496,809,672,647,572,173,32,368,204,592,51,4616,163,3
4800,경상남도,함양군가선거구,6481701,4817,함양군,함양읍,선거일투표,9093,5266,564,909,683,773,591,172,49,430,205,656,64,5096,170,3827
4800,경상남도,함양군가선거구,6481701,4817,함양군,백전면,계,1322,951,116,188,91,78,99,45,12,35,36,199,6,905,46,371
4800,경상남도,함양군가선거구,6481701,4817,함양군,백전면,관내사전투표,504,504,62,101,58,38,60,19,6,17,11,88,6,466,38,0
4800,경상남도,함양군가선거구,6481701,4817,함양군,백전면,선거일투표,818,447,54,87,33,40,39,26,6,18,25,111,0,439,8,371
4800,경상남도,함양군가선거구,6481701,4817,함양군,병곡면,계,1283,999,96,148,126,87,110,126,44,53,28,112,9,939,60,284
4800,경상남도,함양군가선거구,6481701,4817,함양군,병곡면,관내사전투표,658,658,69,90,85,57,89,80,24,32,16,64,6,612,46,0
4800,경상남도,함양군가선거구,6481701,4817,함양군,병곡면,선거일투표,625,341,27,58,41,30,21,46,20,21,12,48,3,327,14,284
4800,경상남도,함양군가선거구,6481701,4817,함양군,잘못 투입·구분된 투표지,,0,1,0,0,0,0,0,1,0,0,0,0,0,1,0,-1
4800,경상남도,함양군나선거구,6481702,4817,함양군,합계,,7196,5415,1190,1445,1115,837,472,138,5197,218,1781
4800,경상남도,함양군나선거구,6481702,4817,함양군,거소투표,,59,44,9,13,4,7,8,2,43,1,15
4800,경상남도,함양군나선거구,6481702,4817,함양군,관외사전투표,,708,708,192,207,119,93,56,19,686,22,0
4800,경상남도,함양군나선거구,6481702,4817,함양군,마천면,계,1850,1379,144,561,392,32,185,12,1326,53,471
4800,경상남도,함양군나선거구,6481702,4817,함양군,마천면,관내사전투표,697,694,78,274,198,13,98,7,668,26,3
4800,경상남도,함양군나선거구,6481702,4817,함양군,마천면,선거일투표,1153,685,66,287,194,19,87,5,658,27,468
4800,경상남도,함양군나선거구,6481702,4817,함양군,휴천면,계,1271,885,166,290,194,100,81,21,852,33,386
4800,경상남도,함양군나선거구,6481702,4817,함양군,휴천면,관내사전투표,465,462,88,148,96,56,44,12,444,18,3
4800,경상남도,함양군나선거구,6481702,4817,함양군,휴천면,선거일투표,806,423,78,142,98,44,37,9,408,15,383
4800,경상남도,함양군나선거구,6481702,4817,함양군,유림면,계,1306,895,104,152,141,337,62,55,851,44,411
4800,경상남도,함양군나선거구,6481702,4817,함양군,유림면,관내사전투표,486,485,59,73,77,197,28,26,460,25,1
4800,경상남도,함양군나선거구,6481702,4817,함양군,유림면,선거일투표,820,410,45,79,64,140,34,29,391,19,410
4800,경상남도,함양군나선거구,6481702,4817,함양군,수동면,계,2002,1495,572,218,264,267,80,29,1430,65,507
4800,경상남도,함양군나선거구,6481702,4817,함양군,수동면,관내사전투표,745,744,304,113,117,124,36,15,709,35,1
4800,경상남도,함양군나선거구,6481702,4817,함양군,수동면,선거일투표,1257,751,268,105,147,143,44,14,721,30,506
4800,경상남도,함양군나선거구,6481702,4817,함양군,잘못 투입·구분된 투표지,,0,9,3,4,1,1,0,0,9,0,-9
4800,경상남도,함양군다선거구,6481703,4817,함양군,합계,,9021,6909,1005,1616,1077,987,1139,795,6619,290,2112
4800,경상남도,함양군다선거구,6481703,4817,함양군,거소투표,,50,47,7,22,4,3,6,5,47,0,3
4800,경상남도,함양군다선거구,6481703,4817,함양군,관외사전투표,,586,586,148,159,82,49,74,56,568,18,0
4800,경상남도,함양군다선거구,6481703,4817,함양군,지곡면,계,1728,1318,113,213,172,129,76,543,1246,72,410
4800,경상남도,함양군다선거구,6481703,4817,함양군,지곡면,관내사전투표,665,663,62,110,89,64,42,263,630,33,2
4800,경상남도,함양군다선거구,6481703,4817,함양군,지곡면,선거일투표,1063,655,51,103,83,65,34,280,616,39,408
4800,경상남도,함양군다선거구,6481703,4817,함양군,안의면,계,3909,2866,242,1000,335,222,841,106,2746,120,1043
4800,경상남도,함양군다선거구,6481703,4817,함양군,안의면,관내사전투표,1595,1594,127,562,177,120,466,58,1510,84,1
4800,경상남도,함양군다선거구,6481703,4817,함양군,안의면,선거일투표,2314,1272,115,438,158,102,375,48,1236,36,1042
4800,경상남도,함양군다선거구,6481703,4817,함양군,서하면,계,1167,875,130,116,216,247,93,43,845,30,292
4800,경상남도,함양군다선거구,6481703,4817,함양군,서하면,관내사전투표,495,495,72,62,113,147,51,29,474,21,0
4800,경상남도,함양군다선거구,6481703,4817,함양군,서하면,선거일투표,672,380,58,54,103,100,42,14,371,9,292
4800,경상남도,함양군다선거구,6481703,4817,함양군,서상면,계,1581,1213,365,103,268,337,49,42,1164,49,368
4800,경상남도,함양군다선거구,6481703,4817,함양군,서상면,관내사전투표,539,538,165,55,107,151,25,15,518,20,1
4800,경상남도,함양군다선거구,6481703,4817,함양군,서상면,선거일투표,1042,675,200,48,161,186,24,27,646,29,367
4800,경상남도,함양군다선거구,6481703,4817,함양군,잘못 투입·구분된 투표지,,0,4,0,3,0,0,0,0,3,1,-4
4800,경상남도,산청군가선거구,6481801,4818,산청군,합계,,7233,5152,722,1946,1174,1124,4966,186,2081
4800,경상남도,산청군가선거구,6481801,4818,산청군,거소투표,,91,83,9,35,13,21,78,5,8
4800,경상남도,산청군가선거구,6481801,4818,산청군,관외사전투표,,715,715,143,275,148,129,695,20,0
4800,경상남도,산청군가선거구,6481801,4818,산청군,산청읍,계,5206,3472,418,1435,657,840,3350,122,1734
4800,경상남도,산청군가선거구,6481801,4818,산청군,산청읍,관내사전투표,1827,1825,249,724,340,436,1749,76,2
4800,경상남도,산청군가선거구,6481801,4818,산청군,산청읍,선거일투표,3379,1647,169,711,317,404,1601,46,1732
4800,경상남도,산청군가선거구,6481801,4818,산청군,차황면,계,1221,880,151,201,355,134,841,39,341
4800,경상남도,산청군가선거구,6481801,4818,산청군,차황면,관내사전투표,453,453,85,113,160,73,431,22,0
4800,경상남도,산청군가선거구,6481801,4818,산청군,차황면,선거일투표,768,427,66,88,195,61,410,17,341
4800,경상남도,산청군가선거구,6481801,4818,산청군,잘못 투입·구분된 투표지,,0,2,1,0,1,0,2,0,-2
4800,경상남도,산청군나선거구,6481802,4818,산청군,합계,,5516,3800,1317,1507,821,3645,155,1716
4800,경상남도,산청군나선거구,6481802,4818,산청군,거소투표,,33,32,10,13,6,29,3,1
4800,경상남도,산청군나선거구,6481802,4818,산청군,관외사전투표,,572,572,175,220,153,548,24,0
4800,경상남도,산청군나선거구,6481802,4818,산청군,오부면,계,856,566,166,218,152,536,30,290
4800,경상남도,산청군나선거구,6481802,4818,산청군,오부면,관내사전투표,243,243,63,94,72,229,14,0
4800,경상남도,산청군나선거구,6481802,4818,산청군,오부면,선거일투표,613,323,103,124,80,307,16,290
4800,경상남도,산청군나선거구,6481802,4818,산청군,생초면,계,1742,1149,746,230,140,1116,33,593
4800,경상남도,산청군나선거구,6481802,4818,산청군,생초면,관내사전투표,467,467,322,78,49,449,18,0
4800,경상남도,산청군나선거구,6481802,4818,산청군,생초면,선거일투표,1275,682,424,152,91,667,15,593
4800,경상남도,산청군나선거구,6481802,4818,산청군,금서면,계,2313,1481,220,826,370,1416,65,832
4800,경상남도,산청군나선거구,6481802,4818,산청군,금서면,관내사전투표,573,573,85,315,140,540,33,0
4800,경상남도,산청군나선거구,6481802,4818,산청군,금서면,선거일투표,1740,908,135,511,230,876,32,832
4800,경상남도,산청군나선거구,6481802,4818,산청군,잘못 투입·구분된 투표지,,0,0,0,0,0,0,0,0
4800,경상남도,산청군다선거구,6481803,4818,산청군,합계,,10820,7392,1685,1865,1282,1627,715,7174,218,3428
4800,경상남도,산청군다선거구,6481803,4818,산청군,거소투표,,30,29,7,3,6,4,6,26,3,1
4800,경상남도,산청군다선거구,6481803,4818,산청군,관외사전투표,,944,944,251,314,123,157,79,924,20,0
4800,경상남도,산청군다선거구,6481803,4818,산청군,삼장면,계,1563,1122,260,146,144,473,69,1092,30,441
4800,경상남도,산청군다선거구,6481803,4818,산청군,삼장면,관내사전투표,561,558,142,75,69,214,40,540,18,3
4800,경상남도,산청군다선거구,6481803,4818,산청군,삼장면,선거일투표,1002,564,118,71,75,259,29,552,12,438
4800,경상남도,산청군다선거구,6481803,4818,산청군,시천면,계,3504,2385,792,193,754,471,103,2313,72,1119
4800,경상남도,산청군다선거구,6481803,4818,산청군,시천면,관내사전투표,1131,1127,412,97,317,204,56,1086,41,4
4800,경상남도,산청군다선거구,6481803,4818,산청군,시천면,선거일투표,2373,1258,380,96,437,267,47,1227,31,1115
4800,경상남도,산청군다선거구,6481803,4818,산청군,단성면,계,4779,2902,374,1208,254,515,458,2809,93,1877
4800,경상남도,산청군다선거구,6481803,4818,산청군,단성면,관내사전투표,1222,1220,133,546,82,196,216,1173,47,2
4800,경상남도,산청군다선거구,6481803,4818,산청군,단성면,선거일투표,3557,1682,241,662,172,319,242,1636,46,1875
4800,경상남도,산청군다선거구,6481803,4818,산청군,잘못 투입·구분된 투표지,,0,10,1,1,1,7,0,10,0,-10
4800,경상남도,산청군라선거구,6481804,4818,산청군,합계,,7919,5587,2006,853,83,787,914,726,5369,218,2332
4800,경상남도,산청군라선거구,6481804,4818,산청군,거소투표,,20,17,7,3,1,2,3,1,17,0,3
4800,경상남도,산청군라선거구,6481804,4818,산청군,관외사전투표,,613,613,209,129,31,88,77,55,589,24,0
4800,경상남도,산청군라선거구,6481804,4818,산청군,신안면,계,4357,2913,829,467,22,566,589,326,2799,114,1444
4800,경상남도,산청군라선거구,6481804,4818,산청군,신안면,관내사전투표,1311,1308,330,194,10,280,288,140,1242,66,3
4800,경상남도,산청군라선거구,6481804,4818,산청군,신안면,선거일투표,3046,1605,499,273,12,286,301,186,1557,48,1441
4800,경상남도,산청군라선거구,6481804,4818,산청군,생비량면,계,1025,724,211,95,6,40,83,264,699,25,301
4800,경상남도,산청군라선거구,6481804,4818,산청군,생비량면,관내사전투표,367,367,112,46,4,25,50,113,350,17,0
4800,경상남도,산청군라선거구,6481804,4818,산청군,생비량면,선거일투표,658,357,99,49,2,15,33,151,349,8,301
4800,경상남도,산청군라선거구,6481804,4818,산청군,신등면,계,1904,1314,747,159,23,91,161,79,1260,54,590
4800,경상남도,산청군라선거구,6481804,4818,산청군,신등면,관내사전투표,708,705,393,89,12,46,81,46,667,38,3
4800,경상남도,산청군라선거구,6481804,4818,산청군,신등면,선거일투표,1196,609,354,70,11,45,80,33,593,16,587
4800,경상남도,산청군라선거구,6481804,4818,산청군,잘못 투입·구분된 투표지,,0,6,3,0,0,0,1,1,5,1,-6
4800,경상남도,거창군가선거구,6481901,4819,거창군,합계,,27345,16682,2293,1836,4578,3022,1212,826,2179,15946,736,10663
4800,경상남도,거창군가선거구,6481901,4819,거창군,거소투표,,39,39,8,4,9,6,6,0,2,35,4,0
4800,경상남도,거창군가선거구,6481901,4819,거창군,관외사전투표,,2349,2348,392,339,597,346,158,124,293,2249,99,1
4800,경상남도,거창군가선거구,6481901,4819,거창군,거창읍,계,24957,14293,1893,1493,3971,2670,1048,702,1884,13661,632,10664
4800,경상남도,거창군가선거구,6481901,4819,거창군,거창읍,관내사전투표,4476,4476,643,519,1211,796,317,178,610,4274,202,0
4800,경상남도,거창군가선거구,6481901,4819,거창군,거창읍,선거일투표,20481,9817,1250,974,2760,1874,731,524,1274,9387,430,10664
4800,경상남도,거창군가선거구,6481901,4819,거창군,잘못 투입·구분된 투표지,,0,2,0,0,1,0,0,0,0,1,1,-2
4800,경상남도,거창군나선거구,6481902,4819,거창군,합계,,15735,10942,1838,2846,2430,2124,1273,10511,431,4793
4800,경상남도,거창군나선거구,6481902,4819,거창군,거소투표,,44,44,6,10,14,10,3,43,1,0
4800,경상남도,거창군나선거구,6481902,4819,거창군,관외사전투표,,1266,1266,310,348,234,222,115,1229,37,0
4800,경상남도,거창군나선거구,6481902,4819,거창군,거창읍,계,5526,3403,794,813,583,712,412,3314,89,2123
4800,경상남도,거창군나선거구,6481902,4819,거창군,거창읍,관내사전투표,1522,1521,370,341,256,326,186,1479,42,1
4800,경상남도,거창군나선거구,6481902,4819,거창군,거창읍,선거일투표,4004,1882,424,472,327,386,226,1835,47,2122
4800,경상남도,거창군나선거구,6481902,4819,거창군,주상면,계,1303,948,74,100,238,452,30,894,54,355
4800,경상남도,거창군나선거구,6481902,4819,거창군,주상면,관내사전투표,429,429,35,50,117,187,14,403,26,0
4800,경상남도,거창군나선거구,6481902,4819,거창군,주상면,선거일투표,874,519,39,50,121,265,16,491,28,355
4800,경상남도,거창군나선거구,6481902,4819,거창군,웅양면,계,1615,1139,118,142,641,170,26,1097,42,476
4800,경상남도,거창군나선거구,6481902,4819,거창군,웅양면,관내사전투표,646,644,57,74,379,93,10,613,31,2
4800,경상남도,거창군나선거구,6481902,4819,거창군,웅양면,선거일투표,969,495,61,68,262,77,16,484,11,474
4800,경상남도,거창군나선거구,6481902,4819,거창군,고제면,계,1236,874,110,141,309,243,29,832,42,362
4800,경상남도,거창군나선거구,6481902,4819,거창군,고제면,관내사전투표,447,443,56,60,161,126,15,418,25,4
4800,경상남도,거창군나선거구,6481902,4819,거창군,고제면,선거일투표,789,431,54,81,148,117,14,414,17,358
4800,경상남도,거창군나선거구,6481902,4819,거창군,북상면,계,1320,915,123,431,51,35,226,866,49,405
4800,경상남도,거창군나선거구,6481902,4819,거창군,북상면,관내사전투표,559,559,73,271,25,13,145,527,32,0
4800,경상남도,거창군나선거구,6481902,4819,거창군,북상면,선거일투표,761,356,50,160,26,22,81,339,17,405
4800,경상남도,거창군나선거구,6481902,4819,거창군,위천면,계,1651,1156,162,410,178,105,238,1093,63,495
4800,경상남도,거창군나선거구,6481902,4819,거창군,위천면,관내사전투표,621,619,85,220,91,54,133,583,36,2
4800,경상남도,거창군나선거구,6481902,4819,거창군,위천면,선거일투표,1030,537,77,190,87,51,105,510,27,493
4800,경상남도,거창군나선거구,6481902,4819,거창군,마리면,계,1774,1186,138,448,181,173,192,1132,54,588
4800,경상남도,거창군나선거구,6481902,4819,거창군,마리면,관내사전투표,636,633,64,257,97,74,107,599,34,3
4800,경상남도,거창군나선거구,6481902,4819,거창군,마리면,선거일투표,1138,553,74,191,84,99,85,533,20,585
4800,경상남도,거창군나선거구,6481902,4819,거창군,잘못 투입·구분된 투표지,,0,11,3,3,1,2,2,11,0,-11
4800,경상남도,거창군다선거구,6481903,4819,거창군,합계,,9723,7129,1865,2412,2428,6705,424,2594
4800,경상남도,거창군다선거구,6481903,4819,거창군,거소투표,,53,48,13,23,11,47,1,5
4800,경상남도,거창군다선거구,6481903,4819,거창군,관외사전투표,,532,532,185,151,169,505,27,0
4800,경상남도,거창군다선거구,6481903,4819,거창군,남상면,계,2060,1429,198,974,168,1340,89,631
4800,경상남도,거창군다선거구,6481903,4819,거창군,남상면,관내사전투표,816,816,97,567,80,744,72,0
4800,경상남도,거창군다선거구,6481903,4819,거창군,남상면,선거일투표,1244,613,101,407,88,596,17,631
4800,경상남도,거창군다선거구,6481903,4819,거창군,남하면,계,1247,868,219,361,245,825,43,379
4800,경상남도,거창군다선거구,6481903,4819,거창군,남하면,관내사전투표,478,477,116,202,133,451,26,1
4800,경상남도,거창군다선거구,6481903,4819,거창군,남하면,선거일투표,769,391,103,159,112,374,17,378
4800,경상남도,거창군다선거구,6481903,4819,거창군,신원면,계,1320,926,241,307,303,851,75,394
4800,경상남도,거창군다선거구,6481903,4819,거창군,신원면,관내사전투표,520,517,123,159,182,464,53,3
4800,경상남도,거창군다선거구,6481903,4819,거창군,신원면,선거일투표,800,409,118,148,121,387,22,391
4800,경상남도,거창군다선거구,6481903,4819,거창군,가조면,계,3345,2469,799,335,1218,2352,117,876
4800,경상남도,거창군다선거구,6481903,4819,거창군,가조면,관내사전투표,1340,1337,424,169,665,1258,79,3
4800,경상남도,거창군다선거구,6481903,4819,거창군,가조면,선거일투표,2005,1132,375,166,553,1094,38,873
4800,경상남도,거창군다선거구,6481903,4819,거창군,가북면,계,1166,850,208,259,313,780,70,316
4800,경상남도,거창군다선거구,6481903,4819,거창군,가북면,관내사전투표,492,492,120,153,172,445,47,0
4800,경상남도,거창군다선거구,6481903,4819,거창군,가북면,선거일투표,674,358,88,106,141,335,23,316
4800,경상남도,거창군다선거구,6481903,4819,거창군,잘못 투입·구분된 투표지,,0,7,2,2,1,5,2,-7
4800,경상남도,합천군가선거구,6482001,4820,합천군,합계,,15581,10701,1439,1741,1329,1329,541,1104,467,661,1662,10273,428,4880
4800,경상남도,합천군가선거구,6482001,4820,합천군,거소투표,,122,117,9,30,9,16,14,9,5,7,11,110,7,5
4800,경상남도,합천군가선거구,6482001,4820,합천군,관외사전투표,,907,907,223,214,117,100,34,45,21,33,89,876,31,0
4800,경상남도,합천군가선거구,6482001,4820,합천군,합천읍,계,8861,6085,619,986,863,670,166,675,231,451,1226,5887,198,2776
4800,경상남도,합천군가선거구,6482001,4820,합천군,합천읍,관내사전투표,2821,2821,322,465,422,324,76,293,93,194,534,2723,98,0
4800,경상남도,합천군가선거구,6482001,4820,합천군,합천읍,선거일투표,6040,3264,297,521,441,346,90,382,138,257,692,3164,100,2776
4800,경상남도,합천군가선거구,6482001,4820,합천군,율곡면,계,1953,1247,78,160,147,93,280,41,159,44,186,1188,59,706
4800,경상남도,합천군가선거구,6482001,4820,합천군,율곡면,관내사전투표,482,482,42,62,66,50,75,20,58,15,70,458,24,0
4800,경상남도,합천군가선거구,6482001,4820,합천군,율곡면,선거일투표,1471,765,36,98,81,43,205,21,101,29,116,730,35,706
4800,경상남도,합천군가선거구,6482001,4820,합천군,대병면,계,1763,1082,351,211,95,119,8,67,18,76,72,1017,65,681
4800,경상남도,합천군가선거구,6482001,4820,합천군,대병면,관내사전투표,523,523,189,95,52,43,6,32,8,37,38,500,23,0
4800,경상남도,합천군가선거구,6482001,4820,합천군,대병면,선거일투표,1240,559,162,116,43,76,2,35,10,39,34,517,42,681
4800,경상남도,합천군가선거구,6482001,4820,합천군,용주면,계,1975,1263,159,140,98,331,39,267,33,50,78,1195,68,712
4800,경상남도,합천군가선거구,6482001,4820,합천군,용주면,관내사전투표,605,605,89,66,47,175,19,110,11,25,24,566,39,0
4800,경상남도,합천군가선거구,6482001,4820,합천군,용주면,선거일투표,1370,658,70,74,51,156,20,157,22,25,54,629,29,712
4800,경상남도,합천군가선거구,6482001,4820,합천군,잘못 투입·구분된 투표지,,0,0,0,0,0,0,0,0,0,0,0,0,0,0
4800,경상남도,합천군나선거구,6482002,4820,합천군,합계,,8888,6194,1436,2033,1750,635,5854,340,2694
4800,경상남도,합천군나선거구,6482002,4820,합천군,거소투표,,72,68,18,23,11,13,65,3,4
4800,경상남도,합천군나선거구,6482002,4820,합천군,관외사전투표,,528,528,161,171,128,46,506,22,0
4800,경상남도,합천군나선거구,6482002,4820,합천군,봉산면,계,1223,785,144,241,253,81,719,66,438
4800,경상남도,합천군나선거구,6482002,4820,합천군,봉산면,관내사전투표,391,391,74,121,123,42,360,31,0
4800,경상남도,합천군나선거구,6482002,4820,합천군,봉산면,선거일투표,832,394,70,120,130,39,359,35,438
4800,경상남도,합천군나선거구,6482002,4820,합천군,묘산면,계,1366,904,176,269,340,66,851,53,462
4800,경상남도,합천군나선거구,6482002,4820,합천군,묘산면,관내사전투표,397,397,76,124,153,21,374,23,0
4800,경상남도,합천군나선거구,6482002,4820,합천군,묘산면,선거일투표,969,507,100,145,187,45,477,30,462
4800,경상남도,합천군나선거구,6482002,4820,합천군,가야면,계,3639,2496,233,1060,745,343,2381,115,1143
4800,경상남도,합천군나선거구,6482002,4820,합천군,가야면,관내사전투표,830,830,90,364,235,104,793,37,0
4800,경상남도,합천군나선거구,6482002,4820,합천군,가야면,선거일투표,2809,1666,143,696,510,239,1588,78,1143
4800,경상남도,합천군나선거구,6482002,4820,합천군,야로면,계,2060,1413,704,269,273,86,1332,81,647
4800,경상남도,합천군나선거구,6482002,4820,합천군,야로면,관내사전투표,683,683,333,118,145,41,637,46,0
4800,경상남도,합천군나선거구,6482002,4820,합천군,야로면,선거일투표,1377,730,371,151,128,45,695,35,647
4800,경상남도,합천군나선거구,6482002,4820,합천군,잘못 투입·구분된 투표지,,0,0,0,0,0,0,0,0,0
4800,경상남도,합천군다선거구,6482003,4820,합천군,합계,,7043,4973,382,1382,1433,1301,222,4720,253,2070
4800,경상남도,합천군다선거구,6482003,4820,합천군,거소투표,,77,74,8,14,27,6,9,64,10,3
4800,경상남도,합천군다선거구,6482003,4820,합천군,관외사전투표,,400,399,63,145,105,64,15,392,7,1
4800,경상남도,합천군다선거구,6482003,4820,합천군,초계면,계,2095,1456,76,228,359,672,47,1382,74,639
4800,경상남도,합천군다선거구,6482003,4820,합천군,초계면,관내사전투표,632,627,39,85,165,285,24,598,29,5
4800,경상남도,합천군다선거구,6482003,4820,합천군,초계면,선거일투표,1463,829,37,143,194,387,23,784,45,634
4800,경상남도,합천군다선거구,6482003,4820,합천군,쌍책면,계,1113,837,70,153,446,113,13,795,42,276
4800,경상남도,합천군다선거구,6482003,4820,합천군,쌍책면,관내사전투표,297,296,24,66,159,29,5,283,13,1
4800,경상남도,합천군다선거구,6482003,4820,합천군,쌍책면,선거일투표,816,541,46,87,287,84,8,512,29,275
4800,경상남도,합천군다선거구,6482003,4820,합천군,덕곡면,계,773,509,64,192,154,55,24,489,20,264
4800,경상남도,합천군다선거구,6482003,4820,합천군,덕곡면,관내사전투표,210,210,25,75,70,19,11,200,10,0
4800,경상남도,합천군다선거구,6482003,4820,합천군,덕곡면,선거일투표,563,299,39,117,84,36,13,289,10,264
4800,경상남도,합천군다선거구,6482003,4820,합천군,청덕면,계,1400,862,58,303,221,205,29,816,46,538
4800,경상남도,합천군다선거구,6482003,4820,합천군,청덕면,관내사전투표,265,265,21,90,73,59,11,254,11,0
4800,경상남도,합천군다선거구,6482003,4820,합천군,청덕면,선거일투표,1135,597,37,213,148,146,18,562,35,538
4800,경상남도,합천군다선거구,6482003,4820,합천군,적중면,계,1185,827,43,346,118,182,85,774,53,358
4800,경상남도,합천군다선거구,6482003,4820,합천군,적중면,관내사전투표,290,289,18,112,40,64,32,266,23,1
4800,경상남도,합천군다선거구,6482003,4820,합천군,적중면,선거일투표,895,538,25,234,78,118,53,508,30,357
4800,경상남도,합천군다선거구,6482003,4820,합천군,잘못 투입·구분된 투표지,,0,9,0,1,3,4,0,8,1,-9
4800,경상남도,합천군라선거구,6482004,4820,합천군,합계,,7923,5498,1646,1964,1149,464,5223,275,2425
4800,경상남도,합천군라선거구,6482004,4820,합천군,거소투표,,59,53,12,10,24,5,51,2,6
4800,경상남도,합천군라선거구,6482004,4820,합천군,관외사전투표,,607,607,206,259,95,32,592,15,0
4800,경상남도,합천군라선거구,6482004,4820,합천군,대양면,계,1404,842,148,349,246,62,805,37,562
4800,경상남도,합천군라선거구,6482004,4820,합천군,대양면,관내사전투표,322,322,64,126,96,22,308,14,0
4800,경상남도,합천군라선거구,6482004,4820,합천군,대양면,선거일투표,1082,520,84,223,150,40,497,23,562
4800,경상남도,합천군라선거구,6482004,4820,합천군,쌍백면,계,1530,1059,146,472,246,131,995,64,471
4800,경상남도,합천군라선거구,6482004,4820,합천군,쌍백면,관내사전투표,437,437,61,180,110,57,408,29,0
4800,경상남도,합천군라선거구,6482004,4820,합천군,쌍백면,선거일투표,1093,622,85,292,136,74,587,35,471
4800,경상남도,합천군라선거구,6482004,4820,합천군,삼가면,계,2864,1948,866,476,341,168,1851,97,916
4800,경상남도,합천군라선거구,6482004,4820,합천군,삼가면,관내사전투표,707,706,317,178,120,48,663,43,1
4800,경상남도,합천군라선거구,6482004,4820,합천군,삼가면,선거일투표,2157,1242,549,298,221,120,1188,54,915
4800,경상남도,합천군라선거구,6482004,4820,합천군,가회면,계,1459,988,267,398,197,66,928,60,471
4800,경상남도,합천군라선거구,6482004,4820,합천군,가회면,관내사전투표,447,447,131,173,83,25,412,35,0
4800,경상남도,합천군라선거구,6482004,4820,합천군,가회면,선거일투표,1012,541,136,225,114,41,516,25,471
4800,경상남도,합천군라선거구,6482004,4820,합천군,잘못 투입·구분된 투표지,,0,1,1,0,0,0,1,0,-1